V350256906L1C001R00100199380	chr1	1044247	50M	165	1044412	1044248	1044413	V350256906L1C001R00100199380_chr1_1044247	65	55	ccat	AGAC
V350256906L1C001R00100273182	chr1	1068003	50M	171	1068174	1068004	1068175	V350256906L1C001R00100273182_chr1_1068003	5	10	CGTC	cgcc
V350256906L1C001R00100387811	chr1	958780	50M	218	958998	958781	958999	V350256906L1C001R00100387811_chr1_958780	0	0	CCCA	CCTC
V350256906L1C001R00101062499	chr1	325338	50M	170	325508	325339	325509	V350256906L1C001R00101062499_chr1_325338	47	23	CTGT	AGGC
V350256906L1C001R00101335518	chr1	717923	50M	212	718135	717924	718136	V350256906L1C001R00101335518_chr1_717923	39	141	TACA	catc
V350256906L1C001R00200317695	chr1	542383	50M	191	542574	542384	542575	V350256906L1C001R00200317695_chr1_542383	0	10	GACA	CAAT
V350256906L1C001R00200924742	chr1	725085	34M16S	168	725253	725086	725254	V350256906L1C001R00200924742_chr1_725085	115	16	tgga	ccat
V350256906L1C001R00201275670	chr1	571562	50M	247	571809	571563	571810	V350256906L1C001R00201275670_chr1_571562	52	6	gtta	ccta
V350256906L1C001R00201309539	chr1	1036650	50M	171	1036821	1036651	1036822	V350256906L1C001R00201309539_chr1_1036650	78	0	gcca	taca
V350256906L1C001R00300097137	chr1	1395163	50M	177	1395340	1395164	1395341	V350256906L1C001R00300097137_chr1_1395163	0	0	ACCG	CGTC
V350256906L1C001R00300160197	chr1	882957	50M	171	883128	882958	883129	V350256906L1C001R00300160197_chr1_882957	16	0	AACA	GGCA
V350256906L1C001R00300601460	chr1	48965	50M	180	49145	48966	49146	V350256906L1C001R00300601460_chr1_48965	75	53	aaaa	ccac
V350256906L1C001R00400211612	chr1	1383922	50M	183	1384105	1383923	1384106	V350256906L1C001R00400211612_chr1_1383922	53	68	ctca	CCCA
V350256906L1C001R00400863503	chr1	16199	50M	169	16368	16200	16369	V350256906L1C001R00400863503_chr1_16199	23	123	GGAC	AACC
V350256906L1C001R00400970621	chr1	166782	50M	165	166947	166783	166948	V350256906L1C001R00400970621_chr1_166782	0	0	ACAT	CCTA
V350256906L1C001R00401073567	chr1	65237	50M	158	65395	65238	65396	V350256906L1C001R00401073567_chr1_65237	116	57	GCTG	CTGA
V350256906L1C001R00401236034	chr1	253054	50M	190	253244	253055	253245	V350256906L1C001R00401236034_chr1_253054	0	0	CCAG	TTAA
V350256906L1C001R00500587702	chr1	459792	50M	156	459948	459793	459949	V350256906L1C001R00500587702_chr1_459792	0	122	CTGA	CCAA
V350256906L1C001R00500653349	chr1	470139	50M	215	470354	470140	470355	V350256906L1C001R00500653349_chr1_470139	120	54	catg	TATA
V350256906L1C001R00500680456	chr1	975386	50M	158	975544	975387	975545	V350256906L1C001R00500680456_chr1_975386	275	433	CCAC	CAGC
V350256906L1C001R00500731010	chr1	872246	50M	177	872423	872247	872424	V350256906L1C001R00500731010_chr1_872246	54	94	CCAC	GCAC
V350256906L1C001R00500764478	chr1	1054710	50M	173	1054883	1054711	1054884	V350256906L1C001R00500764478_chr1_1054710	0	8	GGGA	cccg
V350256906L1C001R00501279061	chr1	454744	50M	115	454859	454745	454860	V350256906L1C001R00501279061_chr1_454744	174	59	ACAC	CCAC
V350256906L1C001R00600208593	chr1	685407	50M	179	685586	685408	685587	V350256906L1C001R00600208593_chr1_685407	0	1	AGAA	GATC
V350256906L1C001R00600375038	chr1	235091	50M	167	235258	235092	235259	V350256906L1C001R00600375038_chr1_235091	220	95	ggag	cctc
V350256906L1C001R00600397413	chr1	131257	50M	142	131399	131258	131400	V350256906L1C001R00600397413_chr1_131257	0	19	AACC	CCTG
V350256906L1C001R00600428194	chr1	457897	50M	182	458079	457898	458080	V350256906L1C001R00600428194_chr1_457897	24	46	tatt	cttg
V350256906L1C001R00600570453	chr1	61851	50M	147	61998	61852	61999	V350256906L1C001R00600570453_chr1_61851	67	184	taat	ccca
V350256906L1C001R00601046355	chr1	21345	50M	161	21506	21346	21507	V350256906L1C001R00601046355_chr1_21345	106	0	CCTG	GGCG
V350256906L1C001R00700486865	chr1	864186	50M	190	864376	864187	864377	V350256906L1C001R00700486865_chr1_864186	36	9	CCAG	TCCT
V350256906L1C001R00700727533	chr1	1003667	50M	160	1003827	1003668	1003828	V350256906L1C001R00700727533_chr1_1003667	48	208	CCAG	GGGA
V350256906L1C001R00700872746	chr1	565751	50M	106	565857	565752	565858	V350256906L1C001R00700872746_chr1_565751	9	48	TCCA	GGGG
V350256906L1C001R00700949293	chr1	727865	50M	150	728015	727866	728016	V350256906L1C001R00700949293_chr1_727865	0	0	agtt	caca
V350256906L1C001R00701078084	chr1	376431	50M	153	376584	376432	376585	V350256906L1C001R00701078084_chr1_376431	81	234	cttt	gacc
V350256906L1C001R00701094067	chr1	610133	50M	174	610307	610134	610308	V350256906L1C001R00701094067_chr1_610133	51	105	AACA	TATC
V350256906L1C001R00800009910	chr1	1400270	50M	175	1400445	1400271	1400446	V350256906L1C001R00800009910_chr1_1400270	21	31	cttt	aaaa
V350256906L1C001R00800205870	chr1	230111	50M	143	230254	230112	230255	V350256906L1C001R00800205870_chr1_230111	89	60	gggc	ccag
V350256906L1C001R00800626554	chr1	725193	13S37M	150	725343	725194	725344	V350256906L1C001R00800626554_chr1_725193	76	6	aatg	ccat
V350256906L1C001R00801060289	chr1	129984	50M	191	130175	129985	130176	V350256906L1C001R00801060289_chr1_129984	41	55	aaag	ccca
V350256906L1C001R00801297226	chr1	75172	50M	217	75389	75173	75390	V350256906L1C001R00801297226_chr1_75172	27	0	tctg	cact
V350256906L1C001R00801360816	chr1	719357	50M	196	719553	719358	719554	V350256906L1C001R00801360816_chr1_719357	96	16	GTTT	attg
V350256906L1C001R00900482061	chr1	324402	50M	170	324572	324403	324573	V350256906L1C001R00900482061_chr1_324402	92	87	ctaa	CAGT
V350256906L1C001R00900489019	chr1	1266024	50M	174	1266198	1266025	1266199	V350256906L1C001R00900489019_chr1_1266024	0	0	GAGT	GTCA
V350256906L1C001R00900614671	chr1	1060643	50M	168	1060811	1060644	1060812	V350256906L1C001R00900614671_chr1_1060643	0	19	CACA	CGGC
V350256906L1C001R00900758914	chr1	723591	50M	191	723782	723592	723783	V350256906L1C001R00900758914_chr1_723591	29	37	caaa	cctt
V350256906L1C001R01000438406	chr1	373746	50M	173	373919	373747	373920	V350256906L1C001R01000438406_chr1_373746	56	150	ggag	tgca
V350256906L1C001R01001251229	chr1	1184302	50M	130	1184432	1184303	1184433	V350256906L1C001R01001251229_chr1_1184302	16	146	TCCC	CCCA
V350256906L1C001R01100098643	chr1	870800	50M	183	870983	870801	870984	V350256906L1C001R01100098643_chr1_870800	21	0	CCCG	CCCA
V350256906L1C001R01100543855	chr1	31140	50M	176	31316	31141	31317	V350256906L1C001R01100543855_chr1_31140	0	34	TACA	caca
V350256906L1C001R01101066901	chr1	146288	50M	160	146448	146289	146449	V350256906L1C001R01101066901_chr1_146288	67	36	cttg	cctc
V350256906L1C001R01101396514	chr1	1386716	50M	184	1386900	1386717	1386901	V350256906L1C001R01101396514_chr1_1386716	17	0	CAGC	caaa
V350256906L1C001R01200226238	chr1	175666	50M	177	175843	175667	175844	V350256906L1C001R01200226238_chr1_175666	107	50	cact	aggt
V350256906L1C001R01200482990	chr1	16416	50M	153	16569	16417	16570	V350256906L1C001R01200482990_chr1_16416	171	104	CCCT	GCTC
V350256906L1C001R01200554290	chr1	1413328	50M	214	1413542	1413329	1413543	V350256906L1C001R01200554290_chr1_1413328	160	8	cccg	cgcc
V350256906L1C001R01201121024	chr1	617739	50M	161	617900	617740	617901	V350256906L1C001R01201121024_chr1_617739	41	68	CAAA	TCTT
V350256906L1C001R01300034089	chr1	158965	50M	191	159156	158966	159157	V350256906L1C001R01300034089_chr1_158965	0	0	agcc	CAGA
V350256906L1C001R01300871324	chr1	1132045	50M	177	1132222	1132046	1132223	V350256906L1C001R01300871324_chr1_1132045	50	41	GGGT	GCAT
V350256906L1C001R01300879649	chr1	234357	50M	147	234504	234358	234505	V350256906L1C001R01300879649_chr1_234357	72	28	TCCT	CCAG
V350256906L1C001R01300977167	chr1	726315	50M	193	726508	726316	726509	V350256906L1C001R01300977167_chr1_726315	24	31	aatg	tcca
V350256906L1C001R01301195405	chr1	1333056	50M	151	1333207	1333057	1333208	V350256906L1C001R01301195405_chr1_1333056	104	25	acac	gtgg
V350256906L1C001R01301204640	chr1	813525	50M	165	813690	813526	813691	V350256906L1C001R01301204640_chr1_813525	480	315	TTTC	CTCA
V350256906L1C001R01400202382	chr1	324893	50M	155	325048	324894	325049	V350256906L1C001R01400202382_chr1_324893	114	4	CACC	GGAT
V350256906L1C001R01400829515	chr1	243088	50M	141	243229	243089	243230	V350256906L1C001R01400829515_chr1_243088	35	62	CCAC	CCCA
V350256906L1C001R01401001033	chr1	688774	50M	161	688935	688775	688936	V350256906L1C001R01401001033_chr1_688774	44	23	gcta	gtgt
V350256906L1C001R01500433009	chr1	1165326	50M	139	1165465	1165327	1165466	V350256906L1C001R01500433009_chr1_1165326	13	2	CCCT	cccc
V350256906L1C001R01501016519	chr1	969294	50M	179	969473	969295	969474	V350256906L1C001R01501016519_chr1_969294	12	30	CCCC	GCCG
V350256906L1C001R01501308912	chr1	582185	50M	168	582353	582186	582354	V350256906L1C001R01501308912_chr1_582185	100	12	TGTG	TGTG
V350256906L1C001R01600324665	chr1	855450	50M	157	855607	855451	855608	V350256906L1C001R01600324665_chr1_855450	22	63	GTGA	CTGA
V350256906L1C001R01600503292	chr1	639323	50M	209	639532	639324	639533	V350256906L1C001R01600503292_chr1_639323	21	7	TAAA	CCTG
V350256906L1C001R01600580892	chr1	865194	50M	172	865366	865195	865367	V350256906L1C001R01600580892_chr1_865194	251	79	CAAG	CCCT
V350256906L1C001R01601107860	chr1	130522	50M	149	130671	130523	130672	V350256906L1C001R01601107860_chr1_130522	34	0	aata	gtcg
V350256906L1C001R01601195155	chr1	20206	50M	176	20382	20207	20383	V350256906L1C001R01601195155_chr1_20206	115	41	cggg	ggct
V350256906L1C001R01700028006	chr1	436478	50M	172	436650	436479	436651	V350256906L1C001R01700028006_chr1_436478	5	59	ggac	AAAG
V350256906L1C001R01700037607	chr1	1403844	50M	146	1403990	1403845	1403991	V350256906L1C001R01700037607_chr1_1403844	67	43	CCAG	CCTA
V350256906L1C001R01700050010	chr1	254324	50M	168	254492	254325	254493	V350256906L1C001R01700050010_chr1_254324	31	73	ATAG	gaac
V350256906L1C001R01700211216	chr1	76580	50M	159	76739	76581	76740	V350256906L1C001R01700211216_chr1_76580	132	0	agat	gtac
V350256906L1C001R01700529733	chr1	725819	50M	123	725942	725820	725943	V350256906L1C001R01700529733_chr1_725819	64	17	ctcg	catt
V350256906L1C001R01700876065	chr1	687985	50M	148	688133	687986	688134	V350256906L1C001R01700876065_chr1_687985	12	0	taat	ccag
V350256906L1C001R01800074015	chr1	1173393	50M	165	1173558	1173394	1173559	V350256906L1C001R01800074015_chr1_1173393	0	5	ACAC	CAGG
V350256906L1C001R01800373296	chr1	1039743	50M	165	1039908	1039744	1039909	V350256906L1C001R01800373296_chr1_1039743	57	23	gatg	CAGT
V350256906L1C001R01800748317	chr1	444251	50M	177	444428	444252	444429	V350256906L1C001R01800748317_chr1_444251	56	49	caga	cttc
V350256906L1C001R01800807534	chr1	1131431	50M	193	1131624	1131432	1131625	V350256906L1C001R01800807534_chr1_1131431	96	0	cagg	ctct
V350256906L1C001R01801065013	chr1	674209	50M	165	674374	674210	674375	V350256906L1C001R01801065013_chr1_674209	41	62	ctca	agta
V350256906L1C001R02000093059	chr1	720678	50M	173	720851	720679	720852	V350256906L1C001R02000093059_chr1_720678	30	0	atat	cttt
V350256906L1C001R02000135734	chr1	553130	50M	177	553307	553131	553308	V350256906L1C001R02000135734_chr1_553130	31	25	ACCG	GCTG
V350256906L1C001R02000456620	chr1	15081	50M	180	15261	15082	15262	V350256906L1C001R02000456620_chr1_15081	93	8	CATG	GCAC
V350256906L1C001R02000475412	chr1	161721	50M	184	161905	161722	161906	V350256906L1C001R02000475412_chr1_161721	38	116	aaac	CTAC
V350256906L1C001R02100426721	chr1	1382511	2S48M	242	1382753	1382512	1382754	V350256906L1C001R02100426721_chr1_1382511	34	78	acgg	ccag
V350256906L1C001R02100719534	chr1	1368290	50M	193	1368483	1368291	1368484	V350256906L1C001R02100719534_chr1_1368290	75	66	GGAG	AAGC
V350256906L1C001R02100720163	chr1	672630	50M	189	672819	672631	672820	V350256906L1C001R02100720163_chr1_672630	0	154	CCTG	cttt
V350256906L1C001R02101165301	chr1	334614	50M	185	334799	334615	334800	V350256906L1C001R02101165301_chr1_334614	44	115	cctg	ctga
V350256906L1C001R02200136610	chr1	914800	50M	162	914962	914801	914963	V350256906L1C001R02200136610_chr1_914800	29	15	CCCC	CCCC
V350256906L1C001R02200378876	chr1	18232	50M	173	18405	18233	18406	V350256906L1C001R02200378876_chr1_18232	29	0	CCCA	GCCT
V350256906L1C001R02200620031	chr1	1086138	50M	182	1086320	1086139	1086321	V350256906L1C001R02200620031_chr1_1086138	98	7	CCCA	CCCT
V350256906L1C001R02200652084	chr1	1345063	50M	177	1345240	1345064	1345241	V350256906L1C001R02200652084_chr1_1345063	88	52	acag	cttc
V350256906L1C001R02200661342	chr1	557548	50M	162	557710	557549	557711	V350256906L1C001R02200661342_chr1_557548	91	41	GCTA	GTCT
V350256906L1C001R02300099071	chr1	1034212	50M	168	1034380	1034213	1034381	V350256906L1C001R02300099071_chr1_1034212	45	52	gaac	ccaa
V350256906L1C001R02300116894	chr1	854750	50M	167	854917	854751	854918	V350256906L1C001R02300116894_chr1_854750	0	8	CCTC	CCTC
V350256906L1C001R02300385171	chr1	797051	50M	193	797244	797052	797245	V350256906L1C001R02300385171_chr1_797051	215	78	gcat	catc
V350256906L1C001R02300521084	chr1	1147698	50M	164	1147862	1147699	1147863	V350256906L1C001R02300521084_chr1_1147698	45	36	CACA	TGTG
V350256906L1C001R02300560570	chr1	1305937	50M	189	1306126	1305938	1306127	V350256906L1C001R02300560570_chr1_1305937	12	6	aaaa	CAGA
V350256906L1C001R02300661880	chr1	171844	50M	159	172003	171845	172004	V350256906L1C001R02300661880_chr1_171844	13	0	GCAT	CCAC
V350256906L1C001R02300665369	chr1	847673	50M	177	847850	847674	847851	V350256906L1C001R02300665369_chr1_847673	69	61	CTCA	acag
V350256906L1C001R02300709919	chr1	1306197	50M	162	1306359	1306198	1306360	V350256906L1C001R02300709919_chr1_1306197	74	46	CTGG	GGCC
V350256906L1C001R02301293932	chr1	158193	50M	187	158380	158194	158381	V350256906L1C001R02301293932_chr1_158193	43	107	agtc	CAAC
V350256906L1C001R02301336752	chr1	1188343	50M	167	1188510	1188344	1188511	V350256906L1C001R02301336752_chr1_1188343	0	32	acac	cagg
V350256906L1C001R02400052797	chr1	96373	50M	151	96524	96374	96525	V350256906L1C001R02400052797_chr1_96373	54	59	CCAA	GCAG
V350256906L1C001R02400781706	chr1	1026920	50M	166	1027086	1026921	1027087	V350256906L1C001R02400781706_chr1_1026920	0	0	CCAT	ccca
V350256906L1C001R02400977022	chr1	448216	50M	173	448389	448217	448390	V350256906L1C001R02400977022_chr1_448216	55	66	gtga	ctat
V350256906L1C001R02401071359	chr1	1045828	50M	168	1045996	1045829	1045997	V350256906L1C001R02401071359_chr1_1045828	38	70	cttt	CCCA
V350256906L1C001R02401119412	chr1	925764	50M	156	925920	925765	925921	V350256906L1C001R02401119412_chr1_925764	48	8	ccca	tgcc
V350256906L1C001R02401166240	chr1	1212029	50M	169	1212198	1212030	1212199	V350256906L1C001R02401166240_chr1_1212029	74	5	ttat	cctt
V350256906L1C001R02401225831	chr1	139334	50M	170	139504	139335	139505	V350256906L1C001R02401225831_chr1_139334	52	122	TGTG	CCTG
V350256906L1C001R02500373487	chr1	25075	50M	159	25234	25076	25235	V350256906L1C001R02500373487_chr1_25075	93	23	TGCT	GCTG
V350256906L1C001R02500529102	chr1	1212814	50M	180	1212994	1212815	1212995	V350256906L1C001R02500529102_chr1_1212814	75	0	taga	cgtg
V350256906L1C001R02500533037	chr1	779131	50M	174	779305	779132	779306	V350256906L1C001R02500533037_chr1_779131	153	32	CAAG	GGAC
V350256906L1C001R02501127325	chr1	453476	50M	147	453623	453477	453624	V350256906L1C001R02501127325_chr1_453476	5	51	ataa	ccat
V350256906L1C001R02600035619	chr1	1106962	50M	160	1107122	1106963	1107123	V350256906L1C001R02600035619_chr1_1106962	67	29	CGTC	CAAG
V350256906L1C001R02600388393	chr1	327627	50M	180	327807	327628	327808	V350256906L1C001R02600388393_chr1_327627	97	251	CCAG	CCTG
V350256906L1C001R02600646100	chr1	124420	50M	100	124520	124421	124521	V350256906L1C001R02600646100_chr1_124420	0	5	AATA	TTTC
V350256906L1C001R02600850940	chr1	1061299	50M	166	1061465	1061300	1061466	V350256906L1C001R02600850940_chr1_1061299	0	0	TGCT	TGAC
V350256906L1C001R02700228348	chr1	830090	50M	205	830295	830091	830296	V350256906L1C001R02700228348_chr1_830090	45	85	CAGA	caac
V350256906L1C001R02700281831	chr1	992418	50M	147	992565	992419	992566	V350256906L1C001R02700281831_chr1_992418	60	61	ctca	cagg
V350256906L1C001R02700327913	chr1	164340	50M	226	164566	164341	164567	V350256906L1C001R02700327913_chr1_164340	0	13	CCTA	ccca
V350256906L1C001R02700555064	chr1	431451	50M	219	431670	431452	431671	V350256906L1C001R02700555064_chr1_431451	6	32	TCCT	CAAA
V350256906L1C001R02700848386	chr1	1215284	50M	173	1215457	1215285	1215458	V350256906L1C001R02700848386_chr1_1215284	0	134	catg	gaga
V350256906L1C001R02700886762	chr1	15018	50M	132	15150	15019	15151	V350256906L1C001R02700886762_chr1_15018	156	24	CACC	GGAA
V350256906L1C001R02701031344	chr1	444416	50M	116	444532	444417	444533	V350256906L1C001R02701031344_chr1_444416	37	121	cgtc	cctc
V350256906L1C001R02701264721	chr1	749112	50M	165	749277	749113	749278	V350256906L1C001R02701264721_chr1_749112	29	194	TTAA	ccta
V350256906L1C001R02701283072	chr1	134767	50M	188	134955	134768	134956	V350256906L1C001R02701283072_chr1_134767	0	109	CGTT	CCAA
V350256906L1C001R02800598153	chr1	1254342	50M	252	1254594	1254343	1254595	V350256906L1C001R02800598153_chr1_1254342	70	202	CCAG	TGGA
V350256906L1C001R02801308839	chr1	1188808	50M	171	1188979	1188809	1188980	V350256906L1C001R02801308839_chr1_1188808	56	1	cctg	AACA
V350256906L1C001R02900181681	chr1	934716	50M	243	934959	934717	934960	V350256906L1C001R02900181681_chr1_934716	13	55	CCCT	CCTG
V350256906L1C001R02900374388	chr1	651913	50M	162	652075	651914	652076	V350256906L1C001R02900374388_chr1_651913	87	112	ACTA	AGAT
V350256906L1C001R02900637767	chr1	1165994	50M	153	1166147	1165995	1166148	V350256906L1C001R02900637767_chr1_1165994	0	0	ccac	AGAA
V350256906L1C001R02900817853	chr1	683871	50M	139	684010	683872	684011	V350256906L1C001R02900817853_chr1_683871	31	10	gcag	catt
V350256906L1C001R02901082038	chr1	12481	50M	179	12660	12482	12661	V350256906L1C001R02901082038_chr1_12481	0	25	CCTC	CTGG
V350256906L1C001R03000223376	chr1	41232	50M	162	41394	41233	41395	V350256906L1C001R03000223376_chr1_41232	21	183	CTAC	aaat
V350256906L1C001R03000845347	chr1	113250	50M	187	113437	113251	113438	V350256906L1C001R03000845347_chr1_113250	109	50	CCTT	TATT
V350256906L1C001R03001006165	chr1	1402392	50M	128	1402520	1402393	1402521	V350256906L1C001R03001006165_chr1_1402392	68	27	tttt	ggtg
V350256906L1C001R03100204411	chr1	21274	50M	163	21437	21275	21438	V350256906L1C001R03100204411_chr1_21274	129	14	CCTG	CCTC
V350256906L1C001R03100428767	chr1	1068305	50M	177	1068482	1068306	1068483	V350256906L1C001R03100428767_chr1_1068305	49	86	caca	CCCT
V350256906L1C001R03100981267	chr1	1077493	50M	172	1077665	1077494	1077666	V350256906L1C001R03100981267_chr1_1077493	3	0	CCTC	tgcc
V350256906L1C001R03101359108	chr1	1090420	50M	191	1090611	1090421	1090612	V350256906L1C001R03101359108_chr1_1090420	82	65	ggct	ctca
V350256906L1C001R03200095990	chr1	458714	50M	178	458892	458715	458893	V350256906L1C001R03200095990_chr1_458714	11	24	cagg	tctg
V350256906L1C001R03200344863	chr1	945805	50M	173	945978	945806	945979	V350256906L1C001R03200344863_chr1_945805	170	0	CAGG	CTGT
V350256906L1C001R03200685354	chr1	846037	50M	156	846193	846038	846194	V350256906L1C001R03200685354_chr1_846037	117	14	CCAG	GCCC
V350256906L1C001R03200832083	chr1	554417	50M	192	554609	554418	554610	V350256906L1C001R03200832083_chr1_554417	0	4	cgtc	cctg
V350256906L1C001R03200965981	chr1	827521	50M	160	827681	827522	827682	V350256906L1C001R03200965981_chr1_827521	11	0	agta	tttt
V350256906L1C001R03201081274	chr1	1143690	50M	198	1143888	1143691	1143889	V350256906L1C001R03201081274_chr1_1143690	10	0	GAGG	AGGG
V350256906L1C001R03201150797	chr1	419119	50M	168	419287	419120	419288	V350256906L1C001R03201150797_chr1_419119	56	47	gatg	gagg
V350256906L1C001R03300288160	chr1	1198452	50M	148	1198600	1198453	1198601	V350256906L1C001R03300288160_chr1_1198452	41	46	CCCC	GCTT
V350256906L1C001R03300303401	chr1	972093	50M	166	972259	972094	972260	V350256906L1C001R03300303401_chr1_972093	48	29	CCCC	CTGA
V350256906L1C001R03300580819	chr1	837676	50M	176	837852	837677	837853	V350256906L1C001R03300580819_chr1_837676	0	0	CCCA	CACC
V350256906L1C001R03300999681	chr1	743645	50M	159	743804	743646	743805	V350256906L1C001R03300999681_chr1_743645	72	46	TGTG	TGAG
V350256906L1C001R03301182343	chr1	1380235	50M	154	1380389	1380236	1380390	V350256906L1C001R03301182343_chr1_1380235	6	22	CCCC	CAAA
V350256906L1C001R03301304847	chr1	467785	50M	197	467982	467786	467983	V350256906L1C001R03301304847_chr1_467785	104	82	catc	caaa
V350256906L1C001R03301335657	chr1	1397373	50M	155	1397528	1397374	1397529	V350256906L1C001R03301335657_chr1_1397373	9	8	GGAA	GTCG
V350256906L1C001R03400008663	chr1	255045	50M	143	255188	255046	255189	V350256906L1C001R03400008663_chr1_255045	38	85	TATT	CCCA
V350256906L1C001R03400261719	chr1	417092	50M	176	417268	417093	417269	V350256906L1C001R03400261719_chr1_417092	69	233	ccca	tggc
V350256906L1C001R03400387770	chr1	171625	50M	203	171828	171626	171829	V350256906L1C001R03400387770_chr1_171625	0	0	CCCT	CTCC
V350256906L1C001R03400491601	chr1	440602	50M	190	440792	440603	440793	V350256906L1C001R03400491601_chr1_440602	52	110	CAGA	TGTT
V350256906L1C001R03400836481	chr1	25424	50M	173	25597	25425	25598	V350256906L1C001R03400836481_chr1_25424	213	142	CCTG	CCCA
V350256906L1C001R03500294548	chr1	897188	50M	163	897351	897189	897352	V350256906L1C001R03500294548_chr1_897188	57	47	CCTC	CCTT
V350256906L1C001R03500560932	chr1	991200	50M	188	991388	991201	991389	V350256906L1C001R03500560932_chr1_991200	32	35	CCCA	GGAG
V350256906L1C001R03500651864	chr1	997151	50M	165	997316	997152	997317	V350256906L1C001R03500651864_chr1_997151	13	0	CCTC	CTGC
V350256906L1C001R03500880485	chr1	724168	31M19S	196	724364	724169	724365	V350256906L1C001R03500880485_chr1_724168	51	57	aatg	tcca
V350256906L1C001R03501337149	chr1	1396021	50M	167	1396188	1396022	1396189	V350256906L1C001R03501337149_chr1_1396021	69	87	CTTT	GGCA
V350256906L1C001R03600094592	chr1	21325	50M	196	21521	21326	21522	V350256906L1C001R03600094592_chr1_21325	126	3	CCCC	CTTC
V350256906L1C001R03600458830	chr1	165025	50M	171	165196	165026	165197	V350256906L1C001R03600458830_chr1_165025	66	88	ccat	ccct
V350256906L1C001R03700286804	chr1	145624	50M	183	145807	145625	145808	V350256906L1C001R03700286804_chr1_145624	0	0	CAGC	agag
V350256906L1C001R03700373718	chr1	1043153	46M4S	162	1043315	1043154	1043316	V350256906L1C001R03700373718_chr1_1043153	40	72	cttt	ctga
V350256906L1C001R03700450521	chr1	1022102	50M	180	1022282	1022103	1022283	V350256906L1C001R03700450521_chr1_1022102	0	41	CCTG	TGGC
V350256906L1C001R03700888527	chr1	1210873	50M	164	1211037	1210874	1211038	V350256906L1C001R03700888527_chr1_1210873	171	297	GGAA	CCTG
V350256906L1C001R03701320662	chr1	348161	50M	215	348376	348162	348377	V350256906L1C001R03701320662_chr1_348161	138	0	gaag	TCTG
V350256906L1C001R03701362084	chr1	789180	50M	213	789393	789181	789394	V350256906L1C001R03701362084_chr1_789180	68	246	CCCC	GCAG
V350256906L1C001R03800105537	chr1	593890	50M	158	594048	593891	594049	V350256906L1C001R03800105537_chr1_593890	21	76	AGAG	ACTA
V350256906L1C001R03800332376	chr1	1176292	50M	167	1176459	1176293	1176460	V350256906L1C001R03800332376_chr1_1176292	0	0	CCCA	GCAC
V350256906L1C001R03800610925	chr1	644174	50M	156	644330	644175	644331	V350256906L1C001R03800610925_chr1_644174	77	36	gtcc	tctt
V350256906L1C001R03800647421	chr1	644782	50M	164	644946	644783	644947	V350256906L1C001R03800647421_chr1_644782	8	124	ggaa	cttt
V350256906L1C001R03800835547	chr1	705746	50M	168	705914	705747	705915	V350256906L1C001R03800835547_chr1_705746	100	14	agtc	cttt
V350256906L1C001R03800855885	chr1	951398	50M	185	951583	951399	951584	V350256906L1C001R03800855885_chr1_951398	4	1	ccca	ccat
V350256906L1C001R03800910618	chr1	230859	50M	177	231036	230860	231037	V350256906L1C001R03800910618_chr1_230859	27	0	caca	ctga
V350256906L1C001R03800911693	chr1	854110	50M	174	854284	854111	854285	V350256906L1C001R03800911693_chr1_854110	68	67	CTGT	TCAC
V350256906L1C001R03801182262	chr1	1353828	50M	254	1354082	1353829	1354083	V350256906L1C001R03801182262_chr1_1353828	21	0	ggag	atca
V350256906L1C001R03900063653	chr1	725398	5S26M19S	146	725544	725399	725545	V350256906L1C001R03900063653_chr1_725398	61	28	accc	tcca
V350256906L1C001R03900321995	chr1	400782	50M	151	400933	400783	400934	V350256906L1C001R03900321995_chr1_400782	92	0	gcct	caat
V350256906L1C001R03900367175	chr1	1248054	50M	195	1248249	1248055	1248250	V350256906L1C001R03900367175_chr1_1248054	8	39	CATT	GCAG
V350256906L1C001R03900840403	chr1	1131375	50M	174	1131549	1131376	1131550	V350256906L1C001R03900840403_chr1_1131375	152	0	caaa	cctc
V350256906L1C001R03900999494	chr1	925549	3M1D47M	165	925714	925550	925715	V350256906L1C001R03900999494_chr1_925549	8	0	gtat	cgag
V350256906L1C001R03901018581	chr1	825128	50M	178	825306	825129	825307	V350256906L1C001R03901018581_chr1_825128	54	52	CTTA	GAct
V350256906L1C001R03901361670	chr1	68718	50M	144	68862	68719	68863	V350256906L1C001R03901361670_chr1_68718	39	61	GTTT	TTCA
V350256906L1C001R04000146622	chr1	571644	50M	152	571796	571645	571797	V350256906L1C001R04000146622_chr1_571644	0	19	cagg	gaga
V350256906L1C001R04000338265	chr1	765229	50M	179	765408	765230	765409	V350256906L1C001R04000338265_chr1_765229	158	144	catt	agca
V350256906L1C001R04000694490	chr1	608154	50M	192	608346	608155	608347	V350256906L1C001R04000694490_chr1_608154	90	211	catt	acaa
V350256906L1C001R04000715100	chr1	163548	50M	165	163713	163549	163714	V350256906L1C001R04000715100_chr1_163548	64	36	CCAA	CCTC
V350256906L1C001R04000817655	chr1	1066742	50M	167	1066909	1066743	1066910	V350256906L1C001R04000817655_chr1_1066742	19	149	cgtc	agga
V350256906L1C001R04001052678	chr1	1278960	50M	244	1279204	1278961	1279205	V350256906L1C001R04001052678_chr1_1278960	190	14	CAGG	GGTT
V350256906L1C001R04001337482	chr1	64740	50M	174	64914	64741	64915	V350256906L1C001R04001337482_chr1_64740	91	51	TGAA	AAAG
V350256906L1C001R04001371335	chr1	119050	50M	171	119221	119051	119222	V350256906L1C001R04001371335_chr1_119050	4	0	ttag	TAAG
V350256906L1C001R04100062653	chr1	243604	50M	200	243804	243605	243805	V350256906L1C001R04100062653_chr1_243604	44	58	TACA	TTAA
V350256906L1C001R04100179067	chr1	631116	50M	148	631264	631117	631265	V350256906L1C001R04100179067_chr1_631116	39	61	TGAA	cctg
V350256906L1C001R04100232681	chr1	351741	50M	178	351919	351742	351920	V350256906L1C001R04100232681_chr1_351741	0	4	TTAT	CCAC
V350256906L1C001R04100397454	chr1	849415	50M	165	849580	849416	849581	V350256906L1C001R04100397454_chr1_849415	0	0	GGGC	CGGG
V350256906L1C001R04100683226	chr1	1337874	50M	175	1338049	1337875	1338050	V350256906L1C001R04100683226_chr1_1337874	31	37	CCTG	CCCC
V350256906L1C001R04100916534	chr1	1038700	50M	175	1038875	1038701	1038876	V350256906L1C001R04100916534_chr1_1038700	77	20	attg	aaat
V350256906L1C001R04200092853	chr1	12215	50M	154	12369	12216	12370	V350256906L1C001R04200092853_chr1_12215	63	44	ACAA	CCTC
V350256906L1C001R04200528909	chr1	1385516	50M	166	1385682	1385517	1385683	V350256906L1C001R04200528909_chr1_1385516	166	0	ggct	ccag
V350256906L1C001R04200720732	chr1	150013	50M	167	150180	150014	150181	V350256906L1C001R04200720732_chr1_150013	49	44	CTAT	accc
V350256906L1C001R04201107126	chr1	1091175	50M	239	1091414	1091176	1091415	V350256906L1C001R04201107126_chr1_1091175	25	67	GGCA	CCCA
V350256906L1C001R04201138550	chr1	961418	50M	200	961618	961419	961619	V350256906L1C001R04201138550_chr1_961418	0	17	GGGG	GTGT
V350256906L1C001R04201343156	chr1	531659	50M	203	531862	531660	531863	V350256906L1C001R04201343156_chr1_531659	99	238	tcac	tatg
V350256906L1C001R04201357769	chr1	1222832	50M	210	1223042	1222833	1223043	V350256906L1C001R04201357769_chr1_1222832	75	59	GCGT	AGGG
V350256906L1C001R04300253044	chr1	116330	50M	123	116453	116331	116454	V350256906L1C001R04300253044_chr1_116330	111	0	AAGC	caaa
V350256906L1C001R04300281161	chr1	1361709	50M	174	1361883	1361710	1361884	V350256906L1C001R04300281161_chr1_1361709	57	97	CTGG	ACAC
V350256906L1C001R04300341287	chr1	1170810	50M	212	1171022	1170811	1171023	V350256906L1C001R04300341287_chr1_1170810	89	60	AGTG	AGGG
V350256906L1C001R04300491738	chr1	1356413	50M	165	1356578	1356414	1356579	V350256906L1C001R04300491738_chr1_1356413	71	80	ACTG	CGGC
V350256906L1C001R04300507968	chr1	421478	50M	166	421644	421479	421645	V350256906L1C001R04300507968_chr1_421478	8	0	GCCA	CAGT
V350256906L1C001R04300582842	chr1	813725	50M	215	813940	813726	813941	V350256906L1C001R04300582842_chr1_813725	280	65	ACAC	GGTA
V350256906L1C001R04300609793	chr1	1419258	50M	190	1419448	1419259	1419449	V350256906L1C001R04300609793_chr1_1419258	52	46	CCTG	CCCA
V350256906L1C001R04300677337	chr1	775097	50M	171	775268	775098	775269	V350256906L1C001R04300677337_chr1_775097	101	0	caca	tctt
V350256906L1C001R04300864898	chr1	1381802	50M	173	1381975	1381803	1381976	V350256906L1C001R04300864898_chr1_1381802	36	80	caag	cagg
V350256906L1C001R04301084667	chr1	871969	50M	179	872148	871970	872149	V350256906L1C001R04301084667_chr1_871969	167	0	CCAG	CCAC
V350256906L1C001R04301089594	chr1	466613	50M	177	466790	466614	466791	V350256906L1C001R04301089594_chr1_466613	39	128	GAAA	TATT
V350256906L1C001R04301361896	chr1	1247053	50M	174	1247227	1247054	1247228	V350256906L1C001R04301361896_chr1_1247053	0	0	CTGG	ACCC
V350256906L1C001R04400103209	chr1	460609	50M	176	460785	460610	460786	V350256906L1C001R04400103209_chr1_460609	26	36	catt	tata
V350256906L1C001R04400176783	chr1	755914	50M	171	756085	755915	756086	V350256906L1C001R04400176783_chr1_755914	158	97	CACT	CAGG
V350256906L1C001R04400197772	chr1	1122620	50M	160	1122780	1122621	1122781	V350256906L1C001R04400197772_chr1_1122620	59	39	tgat	ccat
V350256906L1C001R04400315584	chr1	1171693	50M	168	1171861	1171694	1171862	V350256906L1C001R04400315584_chr1_1171693	27	1	CGGC	GCCA
V350256906L1C001R04400333140	chr1	53452	50M	162	53614	53453	53615	V350256906L1C001R04400333140_chr1_53452	186	314	GAAC	AGTT
V350256906L1C001R04400465854	chr1	962266	50M	168	962434	962267	962435	V350256906L1C001R04400465854_chr1_962266	47	84	GGGT	CCCA
V350256906L1C001R04400817424	chr1	249993	50M	166	250159	249994	250160	V350256906L1C001R04400817424_chr1_249993	54	40	cgat	ggag
V350256906L1C001R04400818739	chr1	176544	50M	192	176736	176545	176737	V350256906L1C001R04400818739_chr1_176544	185	0	GCCT	GGAA
V350256906L1C001R04401106627	chr1	1147379	50M	174	1147553	1147380	1147554	V350256906L1C001R04401106627_chr1_1147379	181	7	CAGT	TCTG
V350256906L1C001R04500367454	chr1	1238473	50M	157	1238630	1238474	1238631	V350256906L1C001R04500367454_chr1_1238473	0	22	TCAA	CGGT
V350256906L1C001R04500386340	chr1	229835	50M	175	230010	229836	230011	V350256906L1C001R04500386340_chr1_229835	36	0	caca	ggag
V350256906L1C001R04500635072	chr1	399098	50M	134	399232	399099	399233	V350256906L1C001R04500635072_chr1_399098	1	25	gaaa	tgtg
V350256906L1C001R04501049317	chr1	609189	50M	182	609371	609190	609372	V350256906L1C001R04501049317_chr1_609189	64	85	ccag	tatg
V350256906L1C001R04501056534	chr1	987366	50M	136	987502	987367	987503	V350256906L1C001R04501056534_chr1_987366	88	1	TTCC	CCAC
V350256906L1C001R04501123377	chr1	1050445	50M	177	1050622	1050446	1050623	V350256906L1C001R04501123377_chr1_1050445	63	82	CCCT	GGTG
V350256906L1C001R04501286310	chr1	55853	50M	130	55983	55854	55984	V350256906L1C001R04501286310_chr1_55853	65	10	TAAA	GGCA
V350256906L1C001R04600045142	chr1	123913	50M	166	124079	123914	124080	V350256906L1C001R04600045142_chr1_123913	116	10	tata	acag
V350256906L1C001R04600098335	chr1	172078	50M	177	172255	172079	172256	V350256906L1C001R04600098335_chr1_172078	54	121	CCTT	CCTG
V350256906L1C001R04600253064	chr1	979421	50M	158	979579	979422	979580	V350256906L1C001R04600253064_chr1_979421	49	113	GGCG	CCTC
V350256906L1C001R04600418509	chr1	164172	50M	164	164336	164173	164337	V350256906L1C001R04600418509_chr1_164172	0	2	GACT	CTTT
V350256906L1C001R04600431559	chr1	1027339	50M	173	1027512	1027340	1027513	V350256906L1C001R04600431559_chr1_1027339	154	54	ACGG	CGGC
V350256906L1C001R04600501067	chr1	725561	50M	163	725724	725562	725725	V350256906L1C001R04600501067_chr1_725561	45	159	cgaa	tcca
V350256906L1C001R04601071943	chr1	585527	50M	203	585730	585528	585731	V350256906L1C001R04601071943_chr1_585527	31	11	tctc	aaag
V350256906L1C001R04601090211	chr1	577840	50M	167	578007	577841	578008	V350256906L1C001R04601090211_chr1_577840	109	276	CTCA	GCCC
V350256906L1C001R04601155145	chr1	1113977	50M	167	1114144	1113978	1114145	V350256906L1C001R04601155145_chr1_1113977	16	25	CCCA	CCTG
V350256906L1C001R04601342971	chr1	982940	50M	174	983114	982941	983115	V350256906L1C001R04601342971_chr1_982940	21	34	CTCC	CCCC
V350256906L1C001R04700280429	chr1	142343	50M	161	142504	142344	142505	V350256906L1C001R04700280429_chr1_142343	177	32	catt	gcat
V350256906L1C001R04700838330	chr1	657333	7S43M	167	657500	657334	657501	V350256906L1C001R04700838330_chr1_657333	97	81	aaac	GCCT
V350256906L1C001R04700940157	chr1	1278142	50M	139	1278281	1278143	1278282	V350256906L1C001R04700940157_chr1_1278142	14	65	TGGG	TCCC
V350256906L1C001R04701296664	chr1	990240	50M	168	990408	990241	990409	V350256906L1C001R04701296664_chr1_990240	45	22	CCAA	CAAA
V350256906L1C001R04800263824	chr1	65446	50M	162	65608	65447	65609	V350256906L1C001R04800263824_chr1_65446	6	44	CATT	CTAA
V350256906L1C001R04800292144	chr1	1193132	50M	242	1193374	1193133	1193375	V350256906L1C001R04800292144_chr1_1193132	132	81	CCAG	AGGT
V350256906L1C001R04801171642	chr1	1030007	50M	169	1030176	1030008	1030177	V350256906L1C001R04801171642_chr1_1030007	63	59	cctg	aagg
V350256906L1C001R04801193822	chr1	1055231	50M	218	1055449	1055232	1055450	V350256906L1C001R04801193822_chr1_1055231	68	26	tggt	TGTT
V350256906L1C001R04900715790	chr1	26796	50M	172	26968	26797	26969	V350256906L1C001R04900715790_chr1_26796	46	26	ggcg	cccg
V350256906L1C001R04900739889	chr1	108006	50M	211	108217	108007	108218	V350256906L1C001R04900739889_chr1_108006	60	26	agca	ggct
V350256906L1C001R04901118917	chr1	252630	50M	161	252791	252631	252792	V350256906L1C001R04901118917_chr1_252630	264	254	TCAT	caat
V350256906L1C001R04901139389	chr1	668634	50M	146	668780	668635	668781	V350256906L1C001R04901139389_chr1_668634	2	148	cttt	ccta
V350256906L1C001R04901250151	chr1	998177	50M	182	998359	998178	998360	V350256906L1C001R04901250151_chr1_998177	32	0	TGGC	CCAC
V350256906L1C001R04901270575	chr1	1235646	50M	168	1235814	1235647	1235815	V350256906L1C001R04901270575_chr1_1235646	0	92	CCAT	GGAG
V350256906L1C001R05000067046	chr1	1384136	20M2D30M	159	1384295	1384137	1384296	V350256906L1C001R05000067046_chr1_1384136	37	41	CCAT	aatc
V350256906L1C001R05000161764	chr1	467432	50M	195	467627	467433	467628	V350256906L1C001R05000161764_chr1_467432	47	28	ccca	ccaa
V350256906L1C001R05000289710	chr1	783632	50M	200	783832	783633	783833	V350256906L1C001R05000289710_chr1_783632	138	14	GGAG	CCAA
V350256906L1C001R05000313333	chr1	727893	50M	203	728096	727894	728097	V350256906L1C001R05000313333_chr1_727893	27	0	gaaa	cata
V350256906L1C001R05000569698	chr1	1028745	50M	193	1028938	1028746	1028939	V350256906L1C001R05000569698_chr1_1028745	58	74	aact	ACAG
V350256906L1C001R05000709908	chr1	1262353	50M	172	1262525	1262354	1262526	V350256906L1C001R05000709908_chr1_1262353	0	19	CGAT	TCTG
V350256906L1C001R05000949602	chr1	1113815	50M	191	1114006	1113816	1114007	V350256906L1C001R05000949602_chr1_1113815	0	0	cctg	CTGT
V350256906L1C001R05100452734	chr1	142534	50M	160	142694	142535	142695	V350256906L1C001R05100452734_chr1_142534	2	0	CAAA	CGAA
V350256906L1C001R05100489193	chr1	1300889	50M	207	1301096	1300890	1301097	V350256906L1C001R05100489193_chr1_1300889	134	27	ctga	ccag
V350256906L1C001R05100624795	chr1	663825	50M	165	663990	663826	663991	V350256906L1C001R05100624795_chr1_663825	32	0	CCGA	TGCC
V350256906L1C001R05100974404	chr1	1382253	50M	135	1382388	1382254	1382389	V350256906L1C001R05100974404_chr1_1382253	0	45	ctcc	cctt
V350256906L1C001R05200068785	chr1	1391599	50M	190	1391789	1391600	1391790	V350256906L1C001R05200068785_chr1_1391599	110	54	GTCC	AGAA
V350256906L1C001R05200571447	chr1	987788	50M	191	987979	987789	987980	V350256906L1C001R05200571447_chr1_987788	8	7	tata	tgtg
V350256906L1C001R05200611862	chr1	104617	50M	178	104795	104618	104796	V350256906L1C001R05200611862_chr1_104617	68	60	ccta	tgct
V350256906L1C001R05200718467	chr1	65052	50M	165	65217	65053	65218	V350256906L1C001R05200718467_chr1_65052	0	96	TGCA	ACAA
V350256906L1C001R05200857965	chr1	115443	50M	210	115653	115444	115654	V350256906L1C001R05200857965_chr1_115443	43	93	ttaT	ccct
V350256906L1C001R05200935778	chr1	74425	50M	105	74530	74426	74531	V350256906L1C001R05200935778_chr1_74425	226	331	actt	tcat
V350256906L1C001R05200965335	chr1	795593	50M	168	795761	795594	795762	V350256906L1C001R05200965335_chr1_795593	47	23	tgga	acaa
V350256906L1C001R05300061418	chr1	1100958	50M	157	1101115	1100959	1101116	V350256906L1C001R05300061418_chr1_1100958	0	0	CACT	GAGT
V350256906L1C001R05300304988	chr1	77751	50M	170	77921	77752	77922	V350256906L1C001R05300304988_chr1_77751	32	29	CAAC	AACA
V350256906L1C001R05300689378	chr1	718651	50M	131	718782	718652	718783	V350256906L1C001R05300689378_chr1_718651	255	141	TCCC	AAAA
V350256906L1C001R05300707679	chr1	784900	50M	150	785050	784901	785051	V350256906L1C001R05300707679_chr1_784900	72	29	CCTC	cctt
V350256906L1C001R05301126365	chr1	673696	50M	178	673874	673697	673875	V350256906L1C001R05301126365_chr1_673696	0	27	ACCT	tcct
V350256906L1C001R05400135865	chr1	731217	50M	170	731387	731218	731388	V350256906L1C001R05400135865_chr1_731217	0	0	tggc	ctat
V350256906L1C001R05400169406	chr1	687482	50M	142	687624	687483	687625	V350256906L1C001R05400169406_chr1_687482	56	55	aggt	gcaa
V350256906L1C001R05400307539	chr1	775741	50M	198	775939	775742	775940	V350256906L1C001R05400307539_chr1_775741	45	6	tgtg	tgaa
V350256906L1C001R05400433367	chr1	1349639	50M	99	1349738	1349640	1349739	V350256906L1C001R05400433367_chr1_1349639	45	0	ccca	aaat
V350256906L1C001R05400546830	chr1	248015	50M	142	248157	248016	248158	V350256906L1C001R05400546830_chr1_248015	114	250	GGGA	tgag
V350256906L1C001R05400733616	chr1	573998	50M	172	574170	573999	574171	V350256906L1C001R05400733616_chr1_573998	55	63	CAGT	actc
V350256906L1C001R05400973225	chr1	132832	50M	161	132993	132833	132994	V350256906L1C001R05400973225_chr1_132832	117	0	GCAA	CCCT
V350256906L1C001R05401260754	chr1	1068785	50M	185	1068970	1068786	1068971	V350256906L1C001R05401260754_chr1_1068785	2	30	GGTG	CCTG
V350256906L1C001R05500299851	chr1	829692	50M	195	829887	829693	829888	V350256906L1C001R05500299851_chr1_829692	75	72	CCTG	TCCA
V350256906L1C001R05500779228	chr1	726328	13S37M	178	726506	726329	726507	V350256906L1C001R05500779228_chr1_726328	37	29	ggaa	catt
V350256906L1C001R05501076984	chr1	738576	50M	178	738754	738577	738755	V350256906L1C001R05501076984_chr1_738576	124	21	ccga	ccct
V350256906L1C001R05501290944	chr1	1414157	50M	176	1414333	1414158	1414334	V350256906L1C001R05501290944_chr1_1414157	4	137	CCCG	TCAC
V350256906L1C001R05501398790	chr1	903593	50M	145	903738	903594	903739	V350256906L1C001R05501398790_chr1_903593	0	3	GCCA	CTGT
V350256906L1C001R05600197228	chr1	700151	50M	159	700310	700152	700311	V350256906L1C001R05600197228_chr1_700151	12	10	GGCC	tcga
V350256906L1C001R05600233674	chr1	735436	50M	192	735628	735437	735629	V350256906L1C001R05600233674_chr1_735436	59	44	cctg	caag
V350256906L1C001R05600303899	chr1	1304176	4S46M	175	1304351	1304177	1304352	V350256906L1C001R05600303899_chr1_1304176	36	0	ggag	ccac
V350256906L1C001R05600396069	chr1	110027	50M	177	110204	110028	110205	V350256906L1C001R05600396069_chr1_110027	55	35	AGTG	tgaa
V350256906L1C001R05601152047	chr1	1028070	50M	152	1028222	1028071	1028223	V350256906L1C001R05601152047_chr1_1028070	205	53	CTGC	caag
V350256906L1C001R05601201407	chr1	350569	50M	190	350759	350570	350760	V350256906L1C001R05601201407_chr1_350569	8	0	aaag	taaa
V350256906L1C001R05700439724	chr1	1018637	50M	222	1018859	1018638	1018860	V350256906L1C001R05700439724_chr1_1018637	37	144	CCGA	CCCA
V350256906L1C001R05700685536	chr1	1425276	50M	120	1425396	1425277	1425397	V350256906L1C001R05700685536_chr1_1425276	38	9	CCAT	CCCC
V350256906L1C001R05700719440	chr1	142818	50M	180	142998	142819	142999	V350256906L1C001R05700719440_chr1_142818	51	109	tcag	AAAG
V350256906L1C001R05800555849	chr1	350620	50M	187	350807	350621	350808	V350256906L1C001R05800555849_chr1_350620	18	28	CCAG	caca
V350256906L1C001R05800684579	chr1	1299624	50M	172	1299796	1299625	1299797	V350256906L1C001R05800684579_chr1_1299624	67	62	ggct	CCAG
V350256906L1C001R05800763085	chr1	464765	50M	142	464907	464766	464908	V350256906L1C001R05800763085_chr1_464765	134	276	ccac	TCCT
V350256906L1C001R05800775070	chr1	393442	50M	162	393604	393443	393605	V350256906L1C001R05800775070_chr1_393442	44	66	gaac	ggat
V350256906L1C001R05800834985	chr1	1331745	50M	162	1331907	1331746	1331908	V350256906L1C001R05800834985_chr1_1331745	51	78	caag	tggg
V350256906L1C001R05801075448	chr1	734119	50M	182	734301	734120	734302	V350256906L1C001R05801075448_chr1_734119	5	73	ggca	cctc
V350256906L1C001R05801277208	chr1	573791	50M	170	573961	573792	573962	V350256906L1C001R05801277208_chr1_573791	37	80	CCAC	CCCT
V350256906L1C001R05900130605	chr1	868665	50M	173	868838	868666	868839	V350256906L1C001R05900130605_chr1_868665	72	54	GAAC	CAGA
V350256906L1C001R05900197527	chr1	1078115	50M	165	1078280	1078116	1078281	V350256906L1C001R05900197527_chr1_1078115	26	0	CCAG	CTGG
V350256906L1C001R05900329220	chr1	935590	50M	212	935802	935591	935803	V350256906L1C001R05900329220_chr1_935590	0	2	CCGC	CCGA
V350256906L1C001R05900409300	chr1	46479	50M	174	46653	46480	46654	V350256906L1C001R05900409300_chr1_46479	57	91	cccg	agaa
V350256906L1C001R05900523525	chr1	913827	50M	180	914007	913828	914008	V350256906L1C001R05900523525_chr1_913827	251	343	CCTG	CCCT
V350256906L1C001R05900836918	chr1	389013	50M	164	389177	389014	389178	V350256906L1C001R05900836918_chr1_389013	52	50	ccaa	gggt
V350256906L1C001R05900859835	chr1	42131	50M	176	42307	42132	42308	V350256906L1C001R05900859835_chr1_42131	417	241	tgac	TGAG
V350256906L1C001R05901094882	chr1	836963	50M	151	837114	836964	837115	V350256906L1C001R05901094882_chr1_836963	20	0	CATG	cacc
V350256906L1C001R05901177688	chr1	1380871	50M	173	1381044	1380872	1381045	V350256906L1C001R05901177688_chr1_1380871	67	0	ccta	ATTC
V350256906L1C001R05901214005	chr1	257097	50M	165	257262	257098	257263	V350256906L1C001R05901214005_chr1_257097	50	37	cttg	CTtt
V350256906L1C001R05901244783	chr1	669352	50M	204	669556	669353	669557	V350256906L1C001R05901244783_chr1_669352	0	98	taca	gggt
V350256906L1C001R06000413241	chr1	673829	50M	142	673971	673830	673972	V350256906L1C001R06000413241_chr1_673829	72	37	agtg	ggct
V350256906L1C001R06000490298	chr1	1030392	50M	178	1030570	1030393	1030571	V350256906L1C001R06000490298_chr1_1030392	53	66	catt	caaa
V350256906L1C001R06000495284	chr1	545686	50M	201	545887	545687	545888	V350256906L1C001R06000495284_chr1_545686	242	90	CCGG	CCTG
V350256906L1C001R06000526109	chr1	824755	50M	188	824943	824756	824944	V350256906L1C001R06000526109_chr1_824755	118	87	CACA	AGCA
V350256906L1C001R06000696831	chr1	678629	50M	179	678808	678630	678809	V350256906L1C001R06000696831_chr1_678629	61	49	TGAT	ACAT
V350256906L1C001R06000728839	chr1	330652	50M	163	330815	330653	330816	V350256906L1C001R06000728839_chr1_330652	21	0	CCTG	CCTC
V350256906L1C001R06000739626	chr1	650340	50M	180	650520	650341	650521	V350256906L1C001R06000739626_chr1_650340	66	81	gcct	gaga
V350256906L1C001R06001049726	chr1	540936	50M	181	541117	540937	541118	V350256906L1C001R06001049726_chr1_540936	39	48	AAAG	catt
V350256906L1C001R06001079527	chr1	227751	50M	165	227916	227752	227917	V350256906L1C001R06001079527_chr1_227751	10	71	agta	cata
V350256906L1C001R06100493572	chr1	1088580	50M	183	1088763	1088581	1088764	V350256906L1C001R06100493572_chr1_1088580	22	35	TCCT	CCCC
V350256906L1C001R06100511277	chr1	174310	50M	138	174448	174311	174449	V350256906L1C001R06100511277_chr1_174310	0	20	GGGA	aagt
V350256906L1C001R06100570195	chr1	1055895	50M	185	1056080	1055896	1056081	V350256906L1C001R06100570195_chr1_1055895	0	0	CCTG	actc
V350256906L1C001R06100691770	chr1	10225	12M5D22M1I15M	159	10384	10226	10385	V350256906L1C001R06100691770_chr1_10225	298	139	ccct	ttag
V350256906L1C001R06100790147	chr1	674387	50M	172	674559	674388	674560	V350256906L1C001R06100790147_chr1_674387	49	49	ggac	ACTT
V350256906L1C001R06200009942	chr1	1094407	50M	157	1094564	1094408	1094565	V350256906L1C001R06200009942_chr1_1094407	74	58	TTTA	agct
V350256906L1C001R06200018170	chr1	985050	50M	166	985216	985051	985217	V350256906L1C001R06200018170_chr1_985050	0	0	CCCG	CCCG
V350256906L1C001R06200603756	chr1	887537	50M	162	887699	887538	887700	V350256906L1C001R06200603756_chr1_887537	41	0	CGTC	CCCT
V350256906L1C001R06200675701	chr1	726745	50M	179	726924	726746	726925	V350256906L1C001R06200675701_chr1_726745	68	71	gaat	agtc
V350256906L1C001R06200706709	chr1	101960	50M	176	102136	101961	102137	V350256906L1C001R06200706709_chr1_101960	0	0	cagg	tatt
V350256906L1C001R06200750543	chr1	1293971	50M	184	1294155	1293972	1294156	V350256906L1C001R06200750543_chr1_1293971	49	50	CCCG	CCCT
V350256906L1C001R06200752198	chr1	953539	50M	175	953714	953540	953715	V350256906L1C001R06200752198_chr1_953539	126	83	gaca	ccac
V350256906L1C001R06200982858	chr1	1148473	50M	171	1148644	1148474	1148645	V350256906L1C001R06200982858_chr1_1148473	27	125	CCTG	CCCA
V350256906L1C001R06201240387	chr1	1370908	50M	194	1371102	1370909	1371103	V350256906L1C001R06201240387_chr1_1370908	57	49	CTGC	CAAc
V350256906L1C001R06201267066	chr1	801960	50M	165	802125	801961	802126	V350256906L1C001R06201267066_chr1_801960	19	184	GCAC	CGTC
V350256906L1C001R06300740991	chr1	386358	50M	189	386547	386359	386548	V350256906L1C001R06300740991_chr1_386358	444	255	accc	aggg
V350256906L1C001R06300903814	chr1	871288	50M	189	871477	871289	871478	V350256906L1C001R06300903814_chr1_871288	23	19	AGGG	CAGC
V350256906L1C001R06301135978	chr1	646865	50M	187	647052	646866	647053	V350256906L1C001R06301135978_chr1_646865	196	307	CCAA	ACAA
V350256906L1C001R06301310461	chr1	880193	50M	175	880368	880194	880369	V350256906L1C001R06301310461_chr1_880193	0	9	ATGG	CGGG
V350256906L1C001R06400042382	chr1	82858	50M	148	83006	82859	83007	V350256906L1C001R06400042382_chr1_82858	75	0	acac	atat
V350256906L1C001R06400050912	chr1	914141	50M	188	914329	914142	914330	V350256906L1C001R06400050912_chr1_914141	209	21	CCCT	GGCG
V350256906L1C001R06400348663	chr1	1101415	50M	191	1101606	1101416	1101607	V350256906L1C001R06400348663_chr1_1101415	111	78	CCTT	CGCC
V350256906L1C001R06400358809	chr1	1068307	50M	192	1068499	1068308	1068500	V350256906L1C001R06400358809_chr1_1068307	47	91	caca	CACA
V350256906L1C001R06400778593	chr1	726710	6S25M19S	158	726868	726711	726869	V350256906L1C001R06400778593_chr1_726710	61	24	gaat	ttcc
V350256906L1C001R06401019867	chr1	1200674	50M	179	1200853	1200675	1200854	V350256906L1C001R06401019867_chr1_1200674	57	41	TAAT	tgtg
V350256906L1C001R06500185761	chr1	24897	50M	227	25124	24898	25125	V350256906L1C001R06500185761_chr1_24897	0	44	GGTC	CCAG
V350256906L1C001R06500217807	chr1	320169	50M	177	320346	320170	320347	V350256906L1C001R06500217807_chr1_320169	2	179	gtct	CCTT
V350256906L1C001R06500490135	chr1	874101	50M	172	874273	874102	874274	V350256906L1C001R06500490135_chr1_874101	55	72	GGGG	CCAG
V350256906L1C001R06500796710	chr1	694053	50M	204	694257	694054	694258	V350256906L1C001R06500796710_chr1_694053	1	0	GGaa	CAAT
V350256906L1C001R06500835232	chr1	1417643	50M	146	1417789	1417644	1417790	V350256906L1C001R06500835232_chr1_1417643	0	20	AAGG	AGCC
V350256906L1C001R06501025530	chr1	621296	50M	196	621492	621297	621493	V350256906L1C001R06501025530_chr1_621296	47	16	CCAC	CCTC
V350256906L1C001R06501271514	chr1	66772	50M	168	66940	66773	66941	V350256906L1C001R06501271514_chr1_66772	24	192	TAGA	AGGA
V350256906L1C001R06600226231	chr1	878973	50M	181	879154	878974	879155	V350256906L1C001R06600226231_chr1_878973	43	30	TTTT	GCCC
V350256906L1C001R06600370523	chr1	657917	50M	192	658109	657918	658110	V350256906L1C001R06600370523_chr1_657917	95	170	ACAC	CCTG
V350256906L1C001R06600399097	chr1	458930	50M	158	459088	458931	459089	V350256906L1C001R06600399097_chr1_458930	20	54	gatg	gacc
V350256906L1C001R06601125867	chr1	585485	50M	187	585672	585486	585673	V350256906L1C001R06601125867_chr1_585485	67	69	tggg	ccat
V350256906L1C001R06700062072	chr1	435882	50M	162	436044	435883	436045	V350256906L1C001R06700062072_chr1_435882	50	85	ctgc	cctg
V350256906L1C001R06700254569	chr1	36937	50M	150	37087	36938	37088	V350256906L1C001R06700254569_chr1_36937	29	53	GGGT	caca
V350256906L1C001R06700730894	chr1	814100	50M	175	814275	814101	814276	V350256906L1C001R06700730894_chr1_814100	84	6	CTAG	CTTG
V350256906L1C001R06700870657	chr1	469625	50M	136	469761	469626	469762	V350256906L1C001R06700870657_chr1_469625	2	138	cttt	ccag
V350256906L1C001R06701024633	chr1	694451	50M	172	694623	694452	694624	V350256906L1C001R06701024633_chr1_694451	123	295	TGGG	tgaa
V350256906L1C001R06701191589	chr1	32365	50M	169	32534	32366	32535	V350256906L1C001R06701191589_chr1_32365	93	25	TCCT	CATT
V350256906L1C001R06701403729	chr1	854708	50M	179	854887	854709	854888	V350256906L1C001R06701403729_chr1_854708	32	38	CTCG	CTAG
V350256906L1C001R06801078207	chr1	101922	50M	159	102081	101923	102082	V350256906L1C001R06801078207_chr1_101922	25	0	ggtg	ccca
V350256906L1C001R06801379543	chr1	1041027	50M	177	1041204	1041028	1041205	V350256906L1C001R06801379543_chr1_1041027	64	59	cgag	ggct
V350256906L1C001R06900134625	chr1	389204	50M	171	389375	389205	389376	V350256906L1C001R06900134625_chr1_389204	77	34	tgaa	aacc
V350256906L1C001R06900279103	chr1	1260204	50M	179	1260383	1260205	1260384	V350256906L1C001R06900279103_chr1_1260204	57	67	CCTA	TGGG
V350256906L1C001R06900605046	chr1	324660	50M	185	324845	324661	324846	V350256906L1C001R06900605046_chr1_324660	0	159	TGAA	GGGG
V350256906L1C001R06900621520	chr1	442100	50M	167	442267	442101	442268	V350256906L1C001R06900621520_chr1_442100	0	87	CGCT	tgta
V350256906L1C001R06900910062	chr1	784212	50M	195	784407	784213	784408	V350256906L1C001R06900910062_chr1_784212	185	23	GTAG	TGCT
V350256906L1C001R06900925124	chr1	148229	50M	174	148403	148230	148404	V350256906L1C001R06900925124_chr1_148229	153	163	tttc	tggt
V350256906L1C001R06900980486	chr1	429376	50M	159	429535	429377	429536	V350256906L1C001R06900980486_chr1_429376	53	64	GCCT	CACT
V350256906L1C001R06901008485	chr1	1358371	50M	179	1358550	1358372	1358551	V350256906L1C001R06901008485_chr1_1358371	42	58	ttat	taaa
V350256906L1C001R06901299997	chr1	1404646	50M	169	1404815	1404647	1404816	V350256906L1C001R06901299997_chr1_1404646	74	54	acaa	tatc
V350256906L1C001R06901364763	chr1	128366	50M	173	128539	128367	128540	V350256906L1C001R06901364763_chr1_128366	55	99	CCAG	ctta
V350256906L1C001R07000085498	chr1	1301318	50M	200	1301518	1301319	1301519	V350256906L1C001R07000085498_chr1_1301318	0	22	TGAG	attc
V350256906L1C001R07000379758	chr1	380046	50M	223	380269	380047	380270	V350256906L1C001R07000379758_chr1_380046	9	37	caat	ctaa
V350256906L1C001R07000927976	chr1	674176	50M	162	674338	674177	674339	V350256906L1C001R07000927976_chr1_674176	71	39	cccc	ccag
V350256906L1C001R07001044448	chr1	107988	50M	179	108167	107989	108168	V350256906L1C001R07001044448_chr1_107988	78	76	ataa	caaa
V350256906L1C001R07001140735	chr1	1210993	50M	150	1211143	1210994	1211144	V350256906L1C001R07001140735_chr1_1210993	291	191	CCCA	cctt
V350256906L1C001R07100357492	chr1	254137	50M	160	254297	254138	254298	V350256906L1C001R07100357492_chr1_254137	41	58	tgaa	CAAA
V350256906L1C001R07100991529	chr1	13642	15M2D35M	171	13813	13643	13814	V350256906L1C001R07100991529_chr1_13642	217	46	CCCG	GGTG
V350256906L1C001R07101186938	chr1	126322	50M	183	126505	126323	126506	V350256906L1C001R07101186938_chr1_126322	98	41	cagc	cctg
V350256906L1C001R07101292952	chr1	1046941	50M	151	1047092	1046942	1047093	V350256906L1C001R07101292952_chr1_1046941	39	19	AGAA	CCTT
V350256906L1C001R07201052044	chr1	1238407	50M	157	1238564	1238408	1238565	V350256906L1C001R07201052044_chr1_1238407	40	84	CACC	CCAG
V350256906L1C001R07201164436	chr1	1211981	50M	172	1212153	1211982	1212154	V350256906L1C001R07201164436_chr1_1211981	26	17	cctg	ggtg
V350256906L1C001R07201180307	chr1	807612	50M	175	807787	807613	807788	V350256906L1C001R07201180307_chr1_807612	47	50	TAAT	TATT
V350256906L1C001R07201234161	chr1	112618	50M	187	112805	112619	112806	V350256906L1C001R07201234161_chr1_112618	230	81	CAGA	TAAC
V350256906L1C002R00100091340	chr1	364557	50M	198	364755	364558	364756	V350256906L1C002R00100091340_chr1_364557	0	0	TCTC	CCAA
V350256906L1C002R00100529834	chr1	787206	50M	145	787351	787207	787352	V350256906L1C002R00100529834_chr1_787206	32	20	TGGT	CAAT
V350256906L1C002R00100584829	chr1	1246028	50M	169	1246197	1246029	1246198	V350256906L1C002R00100584829_chr1_1246028	47	15	GGAA	CCCA
V350256906L1C002R00200299629	chr1	670624	50M	161	670785	670625	670786	V350256906L1C002R00200299629_chr1_670624	49	37	GCTG	tggt
V350256906L1C002R00200381435	chr1	669244	50M	201	669445	669245	669446	V350256906L1C002R00200381435_chr1_669244	0	0	CCAA	GGgc
V350256906L1C002R00200414625	chr1	833966	50M	171	834137	833967	834138	V350256906L1C002R00200414625_chr1_833966	25	42	ttcc	ATGC
V350256906L1C002R00200579494	chr1	630785	50M	185	630970	630786	630971	V350256906L1C002R00200579494_chr1_630785	1	0	AGAA	TGAA
V350256906L1C002R00200631125	chr1	1145629	50M	158	1145787	1145630	1145788	V350256906L1C002R00200631125_chr1_1145629	0	22	CCCT	CCCT
V350256906L1C002R00200747613	chr1	400662	50M	141	400803	400663	400804	V350256906L1C002R00200747613_chr1_400662	212	71	ggag	caac
V350256906L1C002R00200815321	chr1	960815	50M	151	960966	960816	960967	V350256906L1C002R00200815321_chr1_960815	11	30	AGGC	GGGC
V350256906L1C002R00200845529	chr1	65317	50M	187	65504	65318	65505	V350256906L1C002R00200845529_chr1_65317	135	30	CCTC	TGTA
V350256906L1C002R00200977702	chr1	656722	50M	173	656895	656723	656896	V350256906L1C002R00200977702_chr1_656722	67	43	tgag	taac
V350256906L1C002R00201329504	chr1	1074238	50M	174	1074412	1074239	1074413	V350256906L1C002R00201329504_chr1_1074238	31	21	GGTT	TGGG
V350256906L1C002R00300544718	chr1	711108	50M	182	711290	711109	711291	V350256906L1C002R00300544718_chr1_711108	167	0	agct	GCTG
V350256906L1C002R00300725184	chr1	1015276	50M	175	1015451	1015277	1015452	V350256906L1C002R00300725184_chr1_1015276	43	36	CCTG	ggcg
V350256906L1C002R00300841918	chr1	426484	50M	156	426640	426485	426641	V350256906L1C002R00300841918_chr1_426484	63	44	CCCT	GGTG
V350256906L1C002R00300914278	chr1	683520	50M	167	683687	683521	683688	V350256906L1C002R00300914278_chr1_683520	0	96	tggg	ccca
V350256906L1C002R00301059159	chr1	134032	50M	147	134179	134033	134180	V350256906L1C002R00301059159_chr1_134032	66	0	AATC	cgtg
V350256906L1C002R00301132494	chr1	607525	50M	172	607697	607526	607698	V350256906L1C002R00301132494_chr1_607525	37	21	tgtc	tgtc
V350256906L1C002R00301219452	chr1	96767	50M	174	96941	96768	96942	V350256906L1C002R00301219452_chr1_96767	26	68	GAGC	ACTT
V350256906L1C002R00301362945	chr1	1412309	50M	153	1412462	1412310	1412463	V350256906L1C002R00301362945_chr1_1412309	67	21	cccc	ccca
V350256906L1C002R00400380159	chr1	727324	50M	138	727462	727325	727463	V350256906L1C002R00400380159_chr1_727324	73	3	tatc	TAAT
V350256906L1C002R00400871509	chr1	1395609	50M	159	1395768	1395610	1395769	V350256906L1C002R00400871509_chr1_1395609	61	63	cacc	CCAC
V350256906L1C002R00401127294	chr1	238303	50M	171	238474	238304	238475	V350256906L1C002R00401127294_chr1_238303	58	25	cccc	gttc
V350256906L1C002R00500186515	chr1	1161688	50M	209	1161897	1161689	1161898	V350256906L1C002R00500186515_chr1_1161688	146	36	CTGG	tgtc
V350256906L1C002R00500467469	chr1	944785	50M	141	944926	944786	944927	V350256906L1C002R00500467469_chr1_944785	40	16	ggcg	ccac
V350256906L1C002R00500525282	chr1	1068532	50M	160	1068692	1068533	1068693	V350256906L1C002R00500525282_chr1_1068532	58	72	GGAA	CCCA
V350256906L1C002R00500757467	chr1	1366192	50M	160	1366352	1366193	1366353	V350256906L1C002R00500757467_chr1_1366192	69	34	AAGG	TCTC
V350256906L1C002R00500824803	chr1	109524	50M	152	109676	109525	109677	V350256906L1C002R00500824803_chr1_109524	204	52	GGGA	ACCT
V350256906L1C002R00500988517	chr1	453577	50M	166	453743	453578	453744	V350256906L1C002R00500988517_chr1_453577	56	54	cttg	CTGC
V350256906L1C002R00501216554	chr1	1344693	50M	178	1344871	1344694	1344872	V350256906L1C002R00501216554_chr1_1344693	7	47	ccca	gact
V350256906L1C002R00501358613	chr1	16121	50M	161	16282	16122	16283	V350256906L1C002R00501358613_chr1_16121	101	37	CTTC	TAGC
V350256906L1C002R00600011401	chr1	140396	50M	165	140561	140397	140562	V350256906L1C002R00600011401_chr1_140396	280	202	TAAC	ggtc
V350256906L1C002R00600544562	chr1	334706	50M	223	334929	334707	334930	V350256906L1C002R00600544562_chr1_334706	136	0	ctcc	GGTA
V350256906L1C002R00601265844	chr1	740256	50M	161	740417	740257	740418	V350256906L1C002R00601265844_chr1_740256	83	36	AATA	TAGA
V350256906L1C002R00700092877	chr1	63486	50M	166	63652	63487	63653	V350256906L1C002R00700092877_chr1_63486	60	0	GATT	TGGA
V350256906L1C002R00700131151	chr1	399303	50M	172	399475	399304	399476	V350256906L1C002R00700131151_chr1_399303	0	0	TAAT	gatt
V350256906L1C002R00700193056	chr1	340558	50M	171	340729	340559	340730	V350256906L1C002R00700193056_chr1_340558	7	142	GTTT	CCCA
V350256906L1C002R00700449181	chr1	975665	50M	151	975816	975666	975817	V350256906L1C002R00700449181_chr1_975665	387	236	CCCG	CCTT
V350256906L1C002R00700591211	chr1	825903	44M6S	194	826097	825904	826098	V350256906L1C002R00700591211_chr1_825903	186	170	AAAC	tcac
V350256906L1C002R00700813429	chr1	988234	50M	160	988394	988235	988395	V350256906L1C002R00700813429_chr1_988234	63	67	tgta	cgtg
V350256906L1C002R00700975961	chr1	1383747	50M	163	1383910	1383748	1383911	V350256906L1C002R00700975961_chr1_1383747	49	65	cctg	cctg
V350256906L1C002R00700984049	chr1	95525	50M	178	95703	95526	95704	V350256906L1C002R00700984049_chr1_95525	113	51	CTCT	TATA
V350256906L1C002R00800144447	chr1	962204	50M	140	962344	962205	962345	V350256906L1C002R00800144447_chr1_962204	53	0	CACC	CCCA
V350256906L1C002R00800781146	chr1	1325424	50M	179	1325603	1325425	1325604	V350256906L1C002R00800781146_chr1_1325424	75	45	ggag	TGTT
V350256906L1C002R00801160027	chr1	1210068	50M	149	1210217	1210069	1210218	V350256906L1C002R00801160027_chr1_1210068	110	18	CTGA	GCGT
V350256906L1C002R00801266284	chr1	821786	50M	174	821960	821787	821961	V350256906L1C002R00801266284_chr1_821786	36	50	ccaa	gaag
V350256906L1C002R00900017642	chr1	50366	50M	167	50533	50367	50534	V350256906L1C002R00900017642_chr1_50366	25	69	CCCG	TTTT
V350256906L1C002R00900199072	chr1	724529	27S21M2S	158	724687	724530	724688	V350256906L1C002R00900199072_chr1_724529	187	29	atgg	CATT
V350256906L1C002R00900406608	chr1	597404	50M	177	597581	597405	597582	V350256906L1C002R00900406608_chr1_597404	13	190	ttat	tact
V350256906L1C002R00900581296	chr1	119473	50M	201	119674	119474	119675	V350256906L1C002R00900581296_chr1_119473	34	68	taaa	cctg
V350256906L1C002R00900886576	chr1	1203547	50M	222	1203769	1203548	1203770	V350256906L1C002R00900886576_chr1_1203547	27	80	TGCG	CAGT
V350256906L1C002R00901085000	chr1	1400717	50M	182	1400899	1400718	1400900	V350256906L1C002R00901085000_chr1_1400717	30	40	atcc	ccag
V350256906L1C002R00901230841	chr1	231474	50M	189	231663	231475	231664	V350256906L1C002R00901230841_chr1_231474	202	351	taat	ccag
V350256906L1C002R00901263623	chr1	1252102	50M	155	1252257	1252103	1252258	V350256906L1C002R00901263623_chr1_1252102	0	3	caag	tctc
V350256906L1C002R01000380093	chr1	760557	50M	171	760728	760558	760729	V350256906L1C002R01000380093_chr1_760557	130	18	GACG	CTCA
V350256906L1C002R01000395900	chr1	19049	50M	240	19289	19050	19290	V350256906L1C002R01000395900_chr1_19049	33	273	TGAT	GGCT
V350256906L1C002R01000422130	chr1	413701	50M	176	413877	413702	413878	V350256906L1C002R01000422130_chr1_413701	77	73	AGGT	tgcc
V350256906L1C002R01000576720	chr1	748788	50M	154	748942	748789	748943	V350256906L1C002R01000576720_chr1_748788	68	41	ACAA	TGTT
V350256906L1C002R01000823079	chr1	1117363	50M	192	1117555	1117364	1117556	V350256906L1C002R01000823079_chr1_1117363	0	8	CACA	CTGC
V350256906L1C002R01001044979	chr1	758379	50M	174	758553	758380	758554	V350256906L1C002R01001044979_chr1_758379	11	16	GATC	GCAG
V350256906L1C002R01001306043	chr1	50958	50M	175	51133	50959	51134	V350256906L1C002R01001306043_chr1_50958	67	85	TCTA	CAAA
V350256906L1C002R01100245022	chr1	724952	29M21S	168	725120	724953	725121	V350256906L1C002R01100245022_chr1_724952	0	149	gaat	ttcc
V350256906L1C002R01100320611	chr1	916972	50M	175	917147	916973	917148	V350256906L1C002R01100320611_chr1_916972	72	56	CGGC	ATCG
V350256906L1C002R01100766562	chr1	1094706	50M	217	1094923	1094707	1094924	V350256906L1C002R01100766562_chr1_1094706	20	139	aaaa	GGAA
V350256906L1C002R01100931229	chr1	127228	50M	149	127377	127229	127378	V350256906L1C002R01100931229_chr1_127228	55	50	TGTT	GAAA
V350256906L1C002R01101060566	chr1	353848	50M	157	354005	353849	354006	V350256906L1C002R01101060566_chr1_353848	57	15	cccc	ccac
V350256906L1C002R01200047047	chr1	746096	50M	181	746277	746097	746278	V350256906L1C002R01200047047_chr1_746096	6	9	AAAT	TGTG
V350256906L1C002R01200451033	chr1	697847	50M	171	698018	697848	698019	V350256906L1C002R01200451033_chr1_697847	13	0	AGGT	tttt
V350256906L1C002R01200515693	chr1	673929	50M	263	674192	673930	674193	V350256906L1C002R01200515693_chr1_673929	0	58	cctt	atat
V350256906L1C002R01200699822	chr1	1361594	50M	215	1361809	1361595	1361810	V350256906L1C002R01200699822_chr1_1361594	7	23	CGAC	CCAG
V350256906L1C002R01200727796	chr1	961884	50M	191	962075	961885	962076	V350256906L1C002R01200727796_chr1_961884	43	28	CCCC	CGGG
V350256906L1C002R01201198347	chr1	521675	50M	162	521837	521676	521838	V350256906L1C002R01201198347_chr1_521675	128	0	ACTT	ccct
V350256906L1C002R01300432045	chr1	1423863	50M	171	1424034	1423864	1424035	V350256906L1C002R01300432045_chr1_1423863	34	46	tggc	ctga
V350256906L1C002R01300656705	chr1	1344622	2S48M	194	1344816	1344623	1344817	V350256906L1C002R01300656705_chr1_1344622	73	73	ccag	tgtt
V350256906L1C002R01300721773	chr1	67972	50M	173	68145	67973	68146	V350256906L1C002R01300721773_chr1_67972	0	0	CAAA	acct
V350256906L1C002R01301024622	chr1	1129386	50M	167	1129553	1129387	1129554	V350256906L1C002R01301024622_chr1_1129386	20	67	agct	aaac
V350256906L1C002R01301090975	chr1	577590	50M	188	577778	577591	577779	V350256906L1C002R01301090975_chr1_577590	15	47	GAAG	TATT
V350256906L1C002R01400125735	chr1	230575	50M	220	230795	230576	230796	V350256906L1C002R01400125735_chr1_230575	34	77	gcag	ccca
V350256906L1C002R01400218824	chr1	84758	50M	155	84913	84759	84914	V350256906L1C002R01400218824_chr1_84758	78	233	agtt	tctt
V350256906L1C002R01400228736	chr1	109993	50M	165	110158	109994	110159	V350256906L1C002R01400228736_chr1_109993	21	0	cata	tgaa
V350256906L1C002R01400290181	chr1	709368	50M	141	709509	709369	709510	V350256906L1C002R01400290181_chr1_709368	53	57	ACTA	GGAC
V350256906L1C002R01400538106	chr1	1106816	50M	199	1107015	1106817	1107016	V350256906L1C002R01400538106_chr1_1106816	58	34	CCCC	TGGG
V350256906L1C002R01400549151	chr1	1061380	50M	169	1061549	1061381	1061550	V350256906L1C002R01400549151_chr1_1061380	66	68	TCAA	CTGC
V350256906L1C002R01400691911	chr1	741380	50M	187	741567	741381	741568	V350256906L1C002R01400691911_chr1_741380	50	32	TTTT	CAGT
V350256906L1C002R01400765803	chr1	423042	50M	163	423205	423043	423206	V350256906L1C002R01400765803_chr1_423042	18	30	TCCT	AGAG
V350256906L1C002R01400829349	chr1	874468	50M	190	874658	874469	874659	V350256906L1C002R01400829349_chr1_874468	67	51	ACTG	CCTC
V350256906L1C002R01401034021	chr1	1241007	50M	169	1241176	1241008	1241177	V350256906L1C002R01401034021_chr1_1241007	47	25	CAGC	GGCC
V350256906L1C002R01401101597	chr1	356250	50M	168	356418	356251	356419	V350256906L1C002R01401101597_chr1_356250	61	50	TACA	ccaa
V350256906L1C002R01401276522	chr1	863959	50M	201	864160	863960	864161	V350256906L1C002R01401276522_chr1_863959	59	62	CATA	CCCG
V350256906L1C002R01500123766	chr1	709367	50M	166	709533	709368	709534	V350256906L1C002R01500123766_chr1_709367	54	81	GACT	CCAT
V350256906L1C002R01500200463	chr1	563505	50M	104	563609	563506	563610	V350256906L1C002R01500200463_chr1_563505	0	50	GGTA	caaa
V350256906L1C002R01500223057	chr1	591998	50M	178	592176	591999	592177	V350256906L1C002R01500223057_chr1_591998	0	2	acca	caaa
V350256906L1C002R01500414731	chr1	1313493	50M	152	1313645	1313494	1313646	V350256906L1C002R01500414731_chr1_1313493	62	61	GCCT	caga
V350256906L1C002R01500637638	chr1	1010050	50M	180	1010230	1010051	1010231	V350256906L1C002R01500637638_chr1_1010050	268	99	TGCT	TGAG
V350256906L1C002R01600039660	chr1	725589	3S47M	241	725830	725590	725831	V350256906L1C002R01600039660_chr1_725589	73	53	atgg	ttcc
V350256906L1C002R01600057460	chr1	986052	50M	190	986242	986053	986243	V350256906L1C002R01600057460_chr1_986052	60	60	TGGT	CCCC
V350256906L1C002R01600209427	chr1	928051	50M	198	928249	928052	928250	V350256906L1C002R01600209427_chr1_928051	34	0	CCTC	GCAA
V350256906L1C002R01600511145	chr1	1368227	50M	113	1368340	1368228	1368341	V350256906L1C002R01600511145_chr1_1368227	28	25	GTGA	TAAG
V350256906L1C002R01600798286	chr1	434310	50M	175	434485	434311	434486	V350256906L1C002R01600798286_chr1_434310	31	3	ccag	cacg
V350256906L1C002R01601044542	chr1	1355176	50M	177	1355353	1355177	1355354	V350256906L1C002R01601044542_chr1_1355176	49	86	GGGT	GGAG
V350256906L1C002R01700230611	chr1	386691	50M	180	386871	386692	386872	V350256906L1C002R01700230611_chr1_386691	111	22	ccta	gttc
V350256906L1C002R01700398526	chr1	860812	50M	169	860981	860813	860982	V350256906L1C002R01700398526_chr1_860812	0	59	CAAG	CCCG
V350256906L1C002R01700484415	chr1	994456	50M	149	994605	994457	994606	V350256906L1C002R01700484415_chr1_994456	62	50	CCCA	GCCC
V350256906L1C002R01700486177	chr1	462280	50M	142	462422	462281	462423	V350256906L1C002R01700486177_chr1_462280	177	248	ccca	cttt
V350256906L1C002R01700855178	chr1	530957	50M	140	531097	530958	531098	V350256906L1C002R01700855178_chr1_530957	10	45	GACG	gaaa
V350256906L1C002R01700862232	chr1	1011247	50M	151	1011398	1011248	1011399	V350256906L1C002R01700862232_chr1_1011247	0	136	GGTG	CCCC
V350256906L1C002R01701103720	chr1	865117	50M	188	865305	865118	865306	V350256906L1C002R01701103720_chr1_865117	247	140	GCCC	AGAG
V350256906L1C002R01800214931	chr1	44225	50M	207	44432	44226	44433	V350256906L1C002R01800214931_chr1_44225	0	177	aaag	cccc
V350256906L1C002R01800773056	chr1	79686	50M	197	79883	79687	79884	V350256906L1C002R01800773056_chr1_79686	56	68	cctc	ggtc
V350256906L1C002R01800869338	chr1	1402631	50M	176	1402807	1402632	1402808	V350256906L1C002R01800869338_chr1_1402631	26	49	CCCT	CCAC
V350256906L1C002R01801378483	chr1	1188433	50M	132	1188565	1188434	1188566	V350256906L1C002R01801378483_chr1_1188433	62	0	catt	gtgg
V350256906L1C002R01900069806	chr1	1304848	9M2D41M	173	1305021	1304849	1305022	V350256906L1C002R01900069806_chr1_1304848	109	24	AAAG	aaat
V350256906L1C002R01900362605	chr1	1062343	50M	168	1062511	1062344	1062512	V350256906L1C002R01900362605_chr1_1062343	0	0	tatt	caac
V350256906L1C002R01900475433	chr1	709528	50M	170	709698	709529	709699	V350256906L1C002R01900475433_chr1_709528	76	205	CATG	TGGT
V350256906L1C002R01900632255	chr1	606095	50M	163	606258	606096	606259	V350256906L1C002R01900632255_chr1_606095	33	51	GAAA	CTAG
V350256906L1C002R01900655003	chr1	1052608	50M	227	1052835	1052609	1052836	V350256906L1C002R01900655003_chr1_1052608	0	35	CCCA	TGAG
V350256906L1C002R01900823327	chr1	1007304	50M	173	1007477	1007305	1007478	V350256906L1C002R01900823327_chr1_1007304	56	8	CCGG	CGTA
V350256906L1C002R01900836870	chr1	552068	50M	201	552269	552069	552270	V350256906L1C002R01900836870_chr1_552068	28	54	caTT	gaat
V350256906L1C002R01900968101	chr1	549279	50M	151	549430	549280	549431	V350256906L1C002R01900968101_chr1_549279	0	8	CATT	TGCT
V350256906L1C002R02000309799	chr1	119145	50M	161	119306	119146	119307	V350256906L1C002R02000309799_chr1_119145	72	10	GGAA	ACTT
V350256906L1C002R02000360319	chr1	941627	50M	174	941801	941628	941802	V350256906L1C002R02000360319_chr1_941627	0	148	GTCC	CTGC
V350256906L1C002R02000755490	chr1	1217810	50M	180	1217990	1217811	1217991	V350256906L1C002R02000755490_chr1_1217810	55	64	CAGA	CCAA
V350256906L1C002R02000941110	chr1	145188	50M	229	145417	145189	145418	V350256906L1C002R02000941110_chr1_145188	196	0	ccct	ATGA
V350256906L1C002R02001182208	chr1	676583	50M	210	676793	676584	676794	V350256906L1C002R02001182208_chr1_676583	44	60	ggag	gtgc
V350256906L1C002R02001205231	chr1	48248	50M	177	48425	48249	48426	V350256906L1C002R02001205231_chr1_48248	52	65	TTCC	ccta
V350256906L1C002R02100151545	chr1	786291	50M	149	786440	786292	786441	V350256906L1C002R02100151545_chr1_786291	78	227	cttg	cgaa
V350256906L1C002R02100301363	chr1	1395961	50M	270	1396231	1395962	1396232	V350256906L1C002R02100301363_chr1_1395961	66	130	GGCG	CCTC
V350256906L1C002R02100434135	chr1	1403349	50M	177	1403526	1403350	1403527	V350256906L1C002R02100434135_chr1_1403349	46	43	TGGC	ATAG
V350256906L1C002R02100503531	chr1	1100506	50M	183	1100689	1100507	1100690	V350256906L1C002R02100503531_chr1_1100506	16	6	CGGA	CCAG
V350256906L1C002R02100696349	chr1	688114	50M	166	688280	688115	688281	V350256906L1C002R02100696349_chr1_688114	3	48	ctgt	ccag
V350256906L1C002R02100707842	chr1	125979	50M	207	126186	125980	126187	V350256906L1C002R02100707842_chr1_125979	0	10	TAAA	tgat
V350256906L1C002R02200022561	chr1	1121397	50M	187	1121584	1121398	1121585	V350256906L1C002R02200022561_chr1_1121397	24	129	tctc	ggca
V350256906L1C002R02200186757	chr1	71863	50M	174	72037	71864	72038	V350256906L1C002R02200186757_chr1_71863	23	20	CAGT	CCCA
V350256906L1C002R02200210253	chr1	105452	50M	178	105630	105453	105631	V350256906L1C002R02200210253_chr1_105452	18	121	TAGG	tGTA
V350256906L1C002R02200386811	chr1	994017	50M	166	994183	994018	994184	V350256906L1C002R02200386811_chr1_994017	0	0	GAGG	TCCG
V350256906L1C002R02200541860	chr1	786399	50M	169	786568	786400	786569	V350256906L1C002R02200541860_chr1_786399	186	136	gcca	ccat
V350256906L1C002R02200553853	chr1	10082	50M	132	10214	10083	10215	V350256906L1C002R02200553853_chr1_10082	441	309	ccct	gtta
V350256906L1C002R02200958836	chr1	22313	50M	172	22485	22314	22486	V350256906L1C002R02200958836_chr1_22313	0	6	AACC	GTTA
V350256906L1C002R02300245226	chr1	1201176	50M	172	1201348	1201177	1201349	V350256906L1C002R02300245226_chr1_1201176	36	11	ggct	ACAA
V350256906L1C002R02300933066	chr1	534064	50M	166	534230	534065	534231	V350256906L1C002R02300933066_chr1_534064	79	59	CACG	cctg
V350256906L1C002R02301038574	chr1	12848	50M	115	12963	12849	12964	V350256906L1C002R02301038574_chr1_12848	144	46	TCTG	GGGA
V350256906L1C002R02301189007	chr1	1070796	50M	198	1070994	1070797	1070995	V350256906L1C002R02301189007_chr1_1070796	15	4	cccc	cagg
V350256906L1C002R02400203150	chr1	665836	50M	178	666014	665837	666015	V350256906L1C002R02400203150_chr1_665836	170	0	CCAA	gttc
V350256906L1C002R02400316800	chr1	726012	4S46M	176	726188	726013	726189	V350256906L1C002R02400316800_chr1_726012	87	61	gaat	caat
V350256906L1C002R02400337990	chr1	698368	50M	165	698533	698369	698534	V350256906L1C002R02400337990_chr1_698368	38	93	agag	cccc
V350256906L1C002R02400449647	chr1	761365	50M	165	761530	761366	761531	V350256906L1C002R02400449647_chr1_761365	95	44	TGAT	TTAT
V350256906L1C002R02400811031	chr1	1403318	50M	149	1403467	1403319	1403468	V350256906L1C002R02400811031_chr1_1403318	73	25	TGCC	GGTG
V350256906L1C002R02401131227	chr1	752357	50M	134	752491	752358	752492	V350256906L1C002R02401131227_chr1_752357	20	88	ccat	tggg
V350256906L1C002R02401313869	chr1	1129381	50M	167	1129548	1129382	1129549	V350256906L1C002R02401313869_chr1_1129381	25	72	aaat	tttt
V350256906L1C002R02500271283	chr1	1256579	50M	193	1256772	1256580	1256773	V350256906L1C002R02500271283_chr1_1256579	71	264	GCTG	CCAC
V350256906L1C002R02500288928	chr1	57171	50M	178	57349	57172	57350	V350256906L1C002R02500288928_chr1_57171	32	31	GGCA	GGCT
V350256906L1C002R02500336903	chr1	1282715	50M	139	1282854	1282716	1282855	V350256906L1C002R02500336903_chr1_1282715	84	12	CCCT	CCGC
V350256906L1C002R02500359468	chr1	49695	50M	192	49887	49696	49888	V350256906L1C002R02500359468_chr1_49695	70	77	TGAT	ATAA
V350256906L1C002R02500858352	chr1	738157	50M	170	738327	738158	738328	V350256906L1C002R02500858352_chr1_738157	82	38	AAGC	GTTG
V350256906L1C002R02500960804	chr1	1239067	50M	160	1239227	1239068	1239228	V350256906L1C002R02500960804_chr1_1239067	106	4	GCCC	CCCC
V350256906L1C002R02501115273	chr1	1024911	50M	176	1025087	1024912	1025088	V350256906L1C002R02501115273_chr1_1024911	49	84	CACG	CCCA
V350256906L1C002R02501199225	chr1	918508	50M	178	918686	918509	918687	V350256906L1C002R02501199225_chr1_918508	23	0	gttt	CACA
V350256906L1C002R02501211205	chr1	1210563	50M	174	1210737	1210564	1210738	V350256906L1C002R02501211205_chr1_1210563	35	35	CCCC	CTGG
V350256906L1C002R02501237842	chr1	636928	50M	153	637081	636929	637082	V350256906L1C002R02501237842_chr1_636928	48	118	caca	ctga
V350256906L1C002R02501376237	chr1	467583	50M	168	467751	467584	467752	V350256906L1C002R02501376237_chr1_467583	69	70	cttc	cctc
V350256906L1C002R02600228286	chr1	1345642	50M	222	1345864	1345643	1345865	V350256906L1C002R02600228286_chr1_1345642	96	25	agga	aaag
V350256906L1C002R02600494942	chr1	693789	50M	168	693957	693790	693958	V350256906L1C002R02600494942_chr1_693789	54	34	TAGG	cccc
V350256906L1C002R02600527277	chr1	1312933	50M	188	1313121	1312934	1313122	V350256906L1C002R02600527277_chr1_1312933	57	27	ggag	CCCA
V350256906L1C002R02600531479	chr1	389280	50M	161	389441	389281	389442	V350256906L1C002R02600531479_chr1_389280	38	57	ccta	ACAA
V350256906L1C002R02600809414	chr1	671163	50M	145	671308	671164	671309	V350256906L1C002R02600809414_chr1_671163	106	93	AGAC	TGAT
V350256906L1C002R02600920470	chr1	1258367	50M	184	1258551	1258368	1258552	V350256906L1C002R02600920470_chr1_1258367	115	39	GCAG	CCTC
V350256906L1C002R02601401500	chr1	830397	50M	173	830570	830398	830571	V350256906L1C002R02601401500_chr1_830397	0	4	ggca	ATGA
V350256906L1C002R02700009915	chr1	1191871	50M	104	1191975	1191872	1191976	V350256906L1C002R02700009915_chr1_1191871	65	0	GAGA	GCCT
V350256906L1C002R02700066697	chr1	1371933	50M	184	1372117	1371934	1372118	V350256906L1C002R02700066697_chr1_1371933	43	35	TCTG	TGGG
V350256906L1C002R02700446992	chr1	926027	50M	165	926192	926028	926193	V350256906L1C002R02700446992_chr1_926027	22	38	acca	ccag
V350256906L1C002R02700603895	chr1	689763	50M	249	690012	689764	690013	V350256906L1C002R02700603895_chr1_689763	32	0	ggct	atca
V350256906L1C002R02700663343	chr1	397766	50M	170	397936	397767	397937	V350256906L1C002R02700663343_chr1_397766	99	35	CCTG	AGGC
V350256906L1C002R02700977803	chr1	924028	50M	161	924189	924029	924190	V350256906L1C002R02700977803_chr1_924028	107	268	tgtc	CCAG
V350256906L1C002R02800629254	chr1	1086140	50M	182	1086322	1086141	1086323	V350256906L1C002R02800629254_chr1_1086140	100	9	CACC	GGCC
V350256906L1C002R02800863447	chr1	384616	50M	199	384815	384617	384816	V350256906L1C002R02800863447_chr1_384616	283	84	cccc	tgga
V350256906L1C002R02801011913	chr1	858924	50M	182	859106	858925	859107	V350256906L1C002R02801011913_chr1_858924	116	32	CTAC	GCTG
V350256906L1C002R02801286708	chr1	20455	50M	183	20638	20456	20639	V350256906L1C002R02801286708_chr1_20455	73	77	GGGA	cctg
V350256906L1C002R02900285295	chr1	125853	50M	165	126018	125854	126019	V350256906L1C002R02900285295_chr1_125853	102	0	CTAG	TGAT
V350256906L1C002R02900413224	chr1	908897	50M	169	909066	908898	909067	V350256906L1C002R02900413224_chr1_908897	163	0	GGAG	CTGC
V350256906L1C002R02900455010	chr1	243078	50M	163	243241	243079	243242	V350256906L1C002R02900455010_chr1_243078	45	74	CTGG	AACT
V350256906L1C002R02901351638	chr1	118436	50M	182	118618	118437	118619	V350256906L1C002R02901351638_chr1_118436	0	11	caag	atta
V350256906L1C002R03000187251	chr1	1419887	50M	169	1420056	1419888	1420057	V350256906L1C002R03000187251_chr1_1419887	0	36	tagt	CTTT
V350256906L1C002R03000311969	chr1	1338455	50M	198	1338653	1338456	1338654	V350256906L1C002R03000311969_chr1_1338455	66	51	gcca	gact
V350256906L1C002R03000318918	chr1	645408	50M	162	645570	645409	645571	V350256906L1C002R03000318918_chr1_645408	0	86	aaga	AAAA
V350256906L1C002R03000507244	chr1	470717	50M	164	470881	470718	470882	V350256906L1C002R03000507244_chr1_470717	80	30	atta	CAAA
V350256906L1C002R03000551858	chr1	1145687	50M	147	1145834	1145688	1145835	V350256906L1C002R03000551858_chr1_1145687	40	0	TGAC	CCCA
V350256906L1C002R03000925501	chr1	623762	50M	207	623969	623763	623970	V350256906L1C002R03000925501_chr1_623762	216	9	AGGT	cctg
V350256906L1C002R03000988894	chr1	962514	50M	169	962683	962515	962684	V350256906L1C002R03000988894_chr1_962514	6	0	TCCT	CACA
V350256906L1C002R03001078053	chr1	113468	50M	168	113636	113469	113637	V350256906L1C002R03001078053_chr1_113468	19	53	CGGT	GGTC
V350256906L1C002R03001087632	chr1	1021170	50M	165	1021335	1021171	1021336	V350256906L1C002R03001087632_chr1_1021170	19	47	GGGA	CATC
V350256906L1C002R03001309808	chr1	726043	21S29M	179	726222	726044	726223	V350256906L1C002R03001309808_chr1_726043	118	27	aatg	agtc
V350256906L1C002R03100376214	chr1	819426	50M	156	819582	819427	819583	V350256906L1C002R03100376214_chr1_819426	65	39	gcct	gaaa
V350256906L1C002R03100568048	chr1	682867	50M	150	683017	682868	683018	V350256906L1C002R03100568048_chr1_682867	78	228	tgct	tgag
V350256906L1C002R03100775486	chr1	619402	50M	157	619559	619403	619560	V350256906L1C002R03100775486_chr1_619402	50	55	catt	gggt
V350256906L1C002R03100879783	chr1	671175	50M	141	671316	671176	671317	V350256906L1C002R03100879783_chr1_671175	118	85	AAAA	TGCT
V350256906L1C002R03101198132	chr1	1405783	42M8S	221	1406004	1405784	1406005	V350256906L1C002R03101198132_chr1_1405783	51	15	gtgc	agcg
V350256906L1C002R03101333250	chr1	266523	8M1D42M	171	266694	266524	266695	V350256906L1C002R03101333250_chr1_266523	117	10	ACAT	GCTC
V350256906L1C002R03101403156	chr1	1394622	50M	186	1394808	1394623	1394809	V350256906L1C002R03101403156_chr1_1394622	125	19	CCCT	CCCC
V350256906L1C002R03200225858	chr1	102627	50M	179	102806	102628	102807	V350256906L1C002R03200225858_chr1_102627	9	12	ccaa	tatg
V350256906L1C002R03200324417	chr1	26074	50M	155	26229	26075	26230	V350256906L1C002R03200324417_chr1_26074	37	133	CCCA	TAGT
V350256906L1C002R03200425947	chr1	761919	50M	144	762063	761920	762064	V350256906L1C002R03200425947_chr1_761919	18	123	AAAT	GACA
V350256906L1C002R03201046750	chr1	131357	50M	158	131515	131358	131516	V350256906L1C002R03201046750_chr1_131357	61	61	CCCT	TTCT
V350256906L1C002R03300613067	chr1	1017981	50M	175	1018156	1017982	1018157	V350256906L1C002R03300613067_chr1_1017981	17	10	CACC	CCTC
V350256906L1C002R03300618056	chr1	254586	50M	163	254749	254587	254750	V350256906L1C002R03300618056_chr1_254586	0	148	tctc	acat
V350256906L1C002R03301244975	chr1	134415	50M	178	134593	134416	134594	V350256906L1C002R03301244975_chr1_134415	125	0	TGTG	TGCA
V350256906L1C002R03400184754	chr1	1258416	50M	122	1258538	1258417	1258539	V350256906L1C002R03400184754_chr1_1258416	66	26	ACCC	CCCC
V350256906L1C002R03400618738	chr1	690994	50M	153	691147	690995	691148	V350256906L1C002R03400618738_chr1_690994	51	76	cctg	GAGA
V350256906L1C002R03401060178	chr1	1204479	50M	169	1204648	1204480	1204649	V350256906L1C002R03401060178_chr1_1204479	0	163	CCAT	CTCT
V350256906L1C002R03401121147	chr1	18970	50M	108	19078	18971	19079	V350256906L1C002R03401121147_chr1_18970	0	62	ccca	AGCA
V350256906L1C002R03500073188	chr1	918806	50M	163	918969	918807	918970	V350256906L1C002R03500073188_chr1_918806	36	62	gcct	tcag
V350256906L1C002R03500080204	chr1	1211148	50M	146	1211294	1211149	1211295	V350256906L1C002R03500080204_chr1_1211148	186	40	ccca	tgcc
V350256906L1C002R03500125994	chr1	82120	14M2D36M	163	82283	82121	82284	V350256906L1C002R03500125994_chr1_82120	40	70	ccac	CGAT
V350256906L1C002R03500284519	chr1	936424	50M	164	936588	936425	936589	V350256906L1C002R03500284519_chr1_936424	93	139	GTAA	CCAC
V350256906L1C002R03500563256	chr1	805462	50M	165	805627	805463	805628	V350256906L1C002R03500563256_chr1_805462	0	0	CCAC	AACT
V350256906L1C002R03500771076	chr1	816490	50M	140	816630	816491	816631	V350256906L1C002R03500771076_chr1_816490	48	76	ttga	acaa
V350256906L1C002R03500792731	chr1	563038	50M	188	563226	563039	563227	V350256906L1C002R03500792731_chr1_563038	39	54	AGAG	TGAA
V350256906L1C002R03500968070	chr1	1247231	50M	171	1247402	1247232	1247403	V350256906L1C002R03500968070_chr1_1247231	0	0	TGCC	CCAG
V350256906L1C002R03501179527	chr1	1271129	50M	169	1271298	1271130	1271299	V350256906L1C002R03501179527_chr1_1271129	67	46	CCCT	CCTC
V350256906L1C002R03501226688	chr1	933214	50M	153	933367	933215	933368	V350256906L1C002R03501226688_chr1_933214	27	15	CCTG	CCTC
V350256906L1C002R03501336195	chr1	1204033	50M	219	1204252	1204034	1204253	V350256906L1C002R03501336195_chr1_1204033	57	12	CAGG	gatc
V350256906L1C002R03600417204	chr1	858386	50M	157	858543	858387	858544	V350256906L1C002R03600417204_chr1_858386	50	63	GTCT	CCTT
V350256906L1C002R03600575994	chr1	14519	50M	156	14675	14520	14676	V350256906L1C002R03600575994_chr1_14519	0	82	CCCG	CCCC
V350256906L1C002R03600782611	chr1	674751	50M	175	674926	674752	674927	V350256906L1C002R03600782611_chr1_674751	35	69	CAAG	AGTT
V350256906L1C002R03601128908	chr1	924268	50M	158	924426	924269	924427	V350256906L1C002R03601128908_chr1_924268	196	38	TGAT	CCAC
V350256906L1C002R03601267988	chr1	1194770	50M	175	1194945	1194771	1194946	V350256906L1C002R03601267988_chr1_1194770	0	169	TCAG	ctaa
V350256906L1C002R03601337386	chr1	136577	50M	146	136723	136578	136724	V350256906L1C002R03601337386_chr1_136577	95	241	AGGG	CCAC
V350256906L1C002R03700155407	chr1	235410	50M	210	235620	235411	235621	V350256906L1C002R03700155407_chr1_235410	6	208	TGTC	CCCC
V350256906L1C002R03700278361	chr1	317819	50M	239	318058	317820	318059	V350256906L1C002R03700278361_chr1_317819	0	222	AATT	CTGA
V350256906L1C002R03700360641	chr1	402495	50M	174	402669	402496	402670	V350256906L1C002R03700360641_chr1_402495	78	32	ggtt	atac
V350256906L1C002R03700406585	chr1	1402027	50M	210	1402237	1402028	1402238	V350256906L1C002R03700406585_chr1_1402027	54	29	tgtt	tatc
V350256906L1C002R03700561902	chr1	765789	50M	186	765975	765790	765976	V350256906L1C002R03700561902_chr1_765789	16	0	ggag	aaaa
V350256906L1C002R03700662819	chr1	96542	50M	218	96760	96543	96761	V350256906L1C002R03700662819_chr1_96542	41	33	AAAT	CCTG
V350256906L1C002R03700815482	chr1	1206337	50M	134	1206471	1206338	1206472	V350256906L1C002R03700815482_chr1_1206337	100	234	GCCT	GTGT
V350256906L1C002R03700920647	chr1	20010	50M	153	20163	20011	20164	V350256906L1C002R03700920647_chr1_20010	212	158	ccca	catt
V350256906L1C002R03700969848	chr1	35855	50M	171	36026	35856	36027	V350256906L1C002R03700969848_chr1_35855	0	149	TCTC	CCTG
V350256906L1C002R03800014591	chr1	56969	50M	162	57131	56970	57132	V350256906L1C002R03800014591_chr1_56969	67	66	CCTC	TATC
V350256906L1C002R03800111298	chr1	726616	3S27M20S	176	726792	726617	726793	V350256906L1C002R03800111298_chr1_726616	0	21	gaat	tcca
V350256906L1C002R03800311662	chr1	245688	50M	179	245867	245689	245868	V350256906L1C002R03800311662_chr1_245688	115	22	aggc	GCAC
V350256906L1C002R03800976636	chr1	787815	50M	146	787961	787816	787962	V350256906L1C002R03800976636_chr1_787815	26	72	AAAT	AGCA
V350256906L1C002R03801002986	chr1	567741	50M	148	567889	567742	567890	V350256906L1C002R03801002986_chr1_567741	86	17	CTTT	CGAA
V350256906L1C002R03801039977	chr1	1235432	50M	161	1235593	1235433	1235594	V350256906L1C002R03801039977_chr1_1235432	10	24	TGCA	CCTC
V350256906L1C002R03801187964	chr1	972704	50M	145	972849	972705	972850	V350256906L1C002R03801187964_chr1_972704	60	61	CACA	GGAG
V350256906L1C002R03900303245	chr1	650842	50M	190	651032	650843	651033	V350256906L1C002R03900303245_chr1_650842	10	145	GGTC	ccaa
V350256906L1C002R03900789326	chr1	823277	50M	174	823451	823278	823452	V350256906L1C002R03900789326_chr1_823277	0	16	TCTA	TATT
V350256906L1C002R03901115080	chr1	169688	50M	137	169825	169689	169826	V350256906L1C002R03901115080_chr1_169688	23	5	GAAG	GTGC
V350256906L1C002R03901157456	chr1	67485	50M	181	67666	67486	67667	V350256906L1C002R03901157456_chr1_67485	16	74	TAAA	CTGT
V350256906L1C002R04000208666	chr1	1118399	50M	178	1118577	1118400	1118578	V350256906L1C002R04000208666_chr1_1118399	0	104	CGGG	ACAC
V350256906L1C002R04001294964	chr1	941361	50M	141	941502	941362	941503	V350256906L1C002R04001294964_chr1_941361	57	34	CCCA	GGGA
V350256906L1C002R04001346228	chr1	1156125	50M	178	1156303	1156126	1156304	V350256906L1C002R04001346228_chr1_1156125	84	58	CCCA	CCCA
V350256906L1C002R04100017779	chr1	1135121	50M	174	1135295	1135122	1135296	V350256906L1C002R04100017779_chr1_1135121	80	74	GGAT	TGTT
V350256906L1C002R04100504951	chr1	1161708	50M	192	1161900	1161709	1161901	V350256906L1C002R04100504951_chr1_1161708	126	39	CCCT	cggt
V350256906L1C002R04100570524	chr1	417123	50M	194	417317	417124	417318	V350256906L1C002R04100570524_chr1_417123	100	184	ctca	tggg
V350256906L1C002R04100732151	chr1	1073510	50M	151	1073661	1073511	1073662	V350256906L1C002R04100732151_chr1_1073510	68	20	CGAG	TGTC
V350256906L1C002R04100952016	chr1	640364	50M	180	640544	640365	640545	V350256906L1C002R04100952016_chr1_640364	68	76	actg	GTGT
V350256906L1C002R04100994286	chr1	901116	50M	156	901272	901117	901273	V350256906L1C002R04100994286_chr1_901116	40	31	CTGG	CGCT
V350256906L1C002R04101343695	chr1	337568	50M	171	337739	337569	337740	V350256906L1C002R04101343695_chr1_337568	60	157	TCTT	GTCA
V350256906L1C002R04200190953	chr1	1294975	50M	144	1295119	1294976	1295120	V350256906L1C002R04200190953_chr1_1294975	0	0	CTCA	TGAC
V350256906L1C002R04200216027	chr1	384105	50M	111	384216	384106	384217	V350256906L1C002R04200216027_chr1_384105	67	0	gaat	TCAT
V350256906L1C002R04200233729	chr1	1076956	50M	170	1077126	1076957	1077127	V350256906L1C002R04200233729_chr1_1076956	112	35	CCTG	GACC
V350256906L1C002R04200385905	chr1	1390794	50M	171	1390965	1390795	1390966	V350256906L1C002R04200385905_chr1_1390794	37	53	CGTG	CACA
V350256906L1C002R04200506951	chr1	927093	50M	172	927265	927094	927266	V350256906L1C002R04200506951_chr1_927093	43	32	gaca	cttt
V350256906L1C002R04200616264	chr1	1345860	50M	158	1346018	1345861	1346019	V350256906L1C002R04200616264_chr1_1345860	29	61	cttt	ggag
V350256906L1C002R04200764182	chr1	169535	5S25M20S	178	169713	169536	169714	V350256906L1C002R04200764182_chr1_169535	176	0	aatc	AGTG
V350256906L1C002R04201402331	chr1	943185	16M2I32M	137	943322	943186	943323	V350256906L1C002R04201402331_chr1_943185	0	121	cagg	aaat
V350256906L1C002R04300726962	chr1	108362	50M	169	108531	108363	108532	V350256906L1C002R04300726962_chr1_108362	62	37	acca	tgtc
V350256906L1C002R04300730036	chr1	16449	50M	165	16614	16450	16615	V350256906L1C002R04300730036_chr1_16449	204	59	TGAA	CCTT
V350256906L1C002R04301146991	chr1	1011140	50M	165	1011305	1011141	1011306	V350256906L1C002R04301146991_chr1_1011140	37	43	GGAT	CCAC
V350256906L1C002R04301289961	chr1	1358620	50M	143	1358763	1358621	1358764	V350256906L1C002R04301289961_chr1_1358620	0	81	gccc	ccag
V350256906L1C002R04301398259	chr1	1381011	50M	167	1381178	1381012	1381179	V350256906L1C002R04301398259_chr1_1381011	26	0	ccaa	ccaa
V350256906L1C002R04400318187	chr1	320970	50M	180	321150	320971	321151	V350256906L1C002R04400318187_chr1_320970	39	114	cagt	CGGA
V350256906L1C002R04400828281	chr1	69271	50M	166	69437	69272	69438	V350256906L1C002R04400828281_chr1_69271	34	31	CTCA	ATCT
V350256906L1C002R04401017641	chr1	370195	50M	145	370340	370196	370341	V350256906L1C002R04401017641_chr1_370195	0	11	ccat	aaag
V350256906L1C002R04500264738	chr1	959652	50M	155	959807	959653	959808	V350256906L1C002R04500264738_chr1_959652	406	251	AGAA	CCCT
V350256906L1C002R04500338544	chr1	781792	50M	177	781969	781793	781970	V350256906L1C002R04500338544_chr1_781792	40	16	ccag	agag
V350256906L1C002R04500370074	chr1	725791	50M	149	725940	725792	725941	V350256906L1C002R04500370074_chr1_725791	92	15	cgaa	ttcc
V350256906L1C002R04500475981	chr1	809773	50M	204	809977	809774	809978	V350256906L1C002R04500475981_chr1_809773	78	61	TAAC	GACA
V350256906L1C002R04600118592	chr1	966267	50M	174	966441	966268	966442	V350256906L1C002R04600118592_chr1_966267	116	52	gcat	caca
V350256906L1C002R04600307050	chr1	931301	50M	159	931460	931302	931461	V350256906L1C002R04600307050_chr1_931301	30	96	GCCT	CCCT
V350256906L1C002R04600360438	chr1	865153	50M	179	865332	865154	865333	V350256906L1C002R04600360438_chr1_865153	283	113	CGAC	GCAG
V350256906L1C002R04600404154	chr1	813574	50M	201	813775	813575	813776	V350256906L1C002R04600404154_chr1_813574	431	230	GGTA	GCCG
V350256906L1C002R04600458277	chr1	470199	50M	167	470366	470200	470367	V350256906L1C002R04600458277_chr1_470199	60	66	ctat	GGTT
V350256906L1C002R04600689101	chr1	656443	50M	170	656613	656444	656614	V350256906L1C002R04600689101_chr1_656443	0	0	cctg	ggag
V350256906L1C002R04600836934	chr1	725219	1S35M14S	142	725361	725220	725362	V350256906L1C002R04600836934_chr1_725219	50	24	atgg	attc
V350256906L1C002R04600878212	chr1	1326816	50M	182	1326998	1326817	1326999	V350256906L1C002R04600878212_chr1_1326816	47	29	CCAC	CAGT
V350256906L1C002R04600894371	chr1	831835	50M	150	831985	831836	831986	V350256906L1C002R04600894371_chr1_831835	9	6	gcca	tgca
V350256906L1C002R04600986266	chr1	982302	50M	208	982510	982303	982511	V350256906L1C002R04600986266_chr1_982302	18	158	CGCC	GCTT
V350256906L1C002R04601196487	chr1	1379130	50M	171	1379301	1379131	1379302	V350256906L1C002R04601196487_chr1_1379130	53	53	ctgg	caag
V350256906L1C002R04700204996	chr1	1003332	50M	164	1003496	1003333	1003497	V350256906L1C002R04700204996_chr1_1003332	28	50	CCAG	CCTG
V350256906L1C002R04700226300	chr1	1419588	50M	169	1419757	1419589	1419758	V350256906L1C002R04700226300_chr1_1419588	47	16	ctca	accc
V350256906L1C002R04700511663	chr1	1141608	50M	227	1141835	1141609	1141836	V350256906L1C002R04700511663_chr1_1141608	15	0	GCCT	CTGC
V350256906L1C002R04700549308	chr1	781351	50M	184	781535	781352	781536	V350256906L1C002R04700549308_chr1_781351	0	2	aagc	tttc
V350256906L1C002R04700569130	chr1	50936	50M	172	51108	50937	51109	V350256906L1C002R04700569130_chr1_50936	74	60	ATAT	AGAT
V350256906L1C002R04700838698	chr1	558879	50M	169	559048	558880	559049	V350256906L1C002R04700838698_chr1_558879	63	51	ACCC	CCAG
V350256906L1C002R04800120496	chr1	1382917	50M	198	1383115	1382918	1383116	V350256906L1C002R04800120496_chr1_1382917	64	79	gctg	gtaa
V350256906L1C002R04800192140	chr1	1077954	50M	179	1078133	1077955	1078134	V350256906L1C002R04800192140_chr1_1077954	43	44	CGCC	GGGT
V350256906L1C002R04800226341	chr1	946405	50M	139	946544	946406	946545	V350256906L1C002R04800226341_chr1_946405	148	9	ggtg	ccca
V350256906L1C002R04800579514	chr1	1283490	50M	174	1283664	1283491	1283665	V350256906L1C002R04800579514_chr1_1283490	0	0	CAGG	GACC
V350256906L1C002R04801004997	chr1	943369	50M	170	943539	943370	943540	V350256906L1C002R04801004997_chr1_943369	168	39	cctg	CCAG
V350256906L1C002R04801007881	chr1	59333	50M	130	59463	59334	59464	V350256906L1C002R04801007881_chr1_59333	54	0	CATT	GTTT
V350256906L1C002R04900008695	chr1	1103550	50M	172	1103722	1103551	1103723	V350256906L1C002R04900008695_chr1_1103550	71	69	CCAG	CTAA
V350256906L1C002R04900497124	chr1	1316833	50M	267	1317100	1316834	1317101	V350256906L1C002R04900497124_chr1_1316833	0	34	CCTC	CAGG
V350256906L1C002R04900958609	chr1	965884	50M	166	966050	965885	966051	V350256906L1C002R04900958609_chr1_965884	17	21	TGCA	ccat
V350256906L1C002R05000541645	chr1	33457	50M	181	33638	33458	33639	V350256906L1C002R05000541645_chr1_33457	0	101	AAAA	tgac
V350256906L1C002R05000822238	chr1	726313	50M	193	726506	726314	726507	V350256906L1C002R05000822238_chr1_726313	22	29	cgaa	catt
V350256906L1C002R05000946072	chr1	27855	50M	218	28073	27856	28074	V350256906L1C002R05000946072_chr1_27855	44	0	agtg	CTTA
V350256906L1C002R05001238863	chr1	1432065	50M	171	1432236	1432066	1432237	V350256906L1C002R05001238863_chr1_1432065	64	34	CAGG	ATGC
V350256906L1C002R05001275117	chr1	850654	50M	158	850812	850655	850813	V350256906L1C002R05001275117_chr1_850654	3	32	ccca	GGTG
V350256906L1C002R05100069298	chr1	455533	50M	204	455737	455534	455738	V350256906L1C002R05100069298_chr1_455533	36	64	CAGA	CCCA
V350256906L1C002R05100429749	chr1	920536	50M	138	920674	920537	920675	V350256906L1C002R05100429749_chr1_920536	1	7	aggt	ggag
V350256906L1C002R05100585494	chr1	138614	50M	176	138790	138615	138791	V350256906L1C002R05100585494_chr1_138614	31	40	GGGC	CTAA
V350256906L1C002R05100771504	chr1	1226080	50M	163	1226243	1226081	1226244	V350256906L1C002R05100771504_chr1_1226080	43	29	TCCC	CCCC
V350256906L1C002R05100799449	chr1	1139105	50M	133	1139238	1139106	1139239	V350256906L1C002R05100799449_chr1_1139105	0	59	CCCA	ACCT
V350256906L1C002R05200339967	chr1	465752	23M3D27M	170	465922	465753	465923	V350256906L1C002R05200339967_chr1_465752	202	32	TAGA	taaa
V350256906L1C002R05200695126	chr1	627410	50M	166	627576	627411	627577	V350256906L1C002R05200695126_chr1_627410	54	58	CATT	CTTA
V350256906L1C002R05200732986	chr1	151734	50M	170	151904	151735	151905	V350256906L1C002R05200732986_chr1_151734	30	57	tggg	CTCA
V350256906L1C002R05200768153	chr1	740939	50M	210	741149	740940	741150	V350256906L1C002R05200768153_chr1_740939	194	0	ACAG	TGAC
V350256906L1C002R05200918916	chr1	376987	50M	203	377190	376988	377191	V350256906L1C002R05200918916_chr1_376987	92	60	tgtg	gcct
V350256906L1C002R05201244319	chr1	1163981	50M	149	1164130	1163982	1164131	V350256906L1C002R05201244319_chr1_1163981	63	62	CCCC	CATT
V350256906L1C002R05300612569	chr1	1088130	50M	157	1088287	1088131	1088288	V350256906L1C002R05300612569_chr1_1088130	0	127	CACA	CGAT
V350256906L1C002R05300712588	chr1	544037	50M	157	544194	544038	544195	V350256906L1C002R05300712588_chr1_544037	21	178	CAAG	CAGG
V350256906L1C002R05400001409	chr1	1369176	50M	171	1369347	1369177	1369348	V350256906L1C002R05400001409_chr1_1369176	17	15	CAAG	CTCC
V350256906L1C002R05400117417	chr1	1373291	50M	161	1373452	1373292	1373453	V350256906L1C002R05400117417_chr1_1373291	62	33	ACCT	GGGC
V350256906L1C002R05400623411	chr1	618879	50M	165	619044	618880	619045	V350256906L1C002R05400623411_chr1_618879	51	76	aaac	ccat
V350256906L1C002R05400677003	chr1	609999	50M	165	610164	610000	610165	V350256906L1C002R05400677003_chr1_609999	26	20	tcac	TCTC
V350256906L1C002R05400818100	chr1	825891	50M	165	826056	825892	826057	V350256906L1C002R05400818100_chr1_825891	174	211	CACA	caca
V350256906L1C002R05401184471	chr1	325829	50M	161	325990	325830	325991	V350256906L1C002R05401184471_chr1_325829	0	8	CCCA	TGGA
V350256906L1C002R05401233772	chr1	1083070	50M	165	1083235	1083071	1083236	V350256906L1C002R05401233772_chr1_1083070	68	53	GTTG	ggtc
V350256906L1C002R05500016618	chr1	725893	1S32M17S	263	726156	725894	726157	V350256906L1C002R05500016618_chr1_725893	0	93	AATG	ttcc
V350256906L1C002R05500149267	chr1	1390418	50M	153	1390571	1390419	1390572	V350256906L1C002R05500149267_chr1_1390418	29	61	accc	ggct
V350256906L1C002R05500191922	chr1	635670	50M	167	635837	635671	635838	V350256906L1C002R05500191922_chr1_635670	58	225	ccca	cctg
V350256906L1C002R05500424832	chr1	985139	50M	198	985337	985140	985338	V350256906L1C002R05500424832_chr1_985139	61	40	GGAA	CCCC
V350256906L1C002R05500449807	chr1	937256	50M	167	937423	937257	937424	V350256906L1C002R05500449807_chr1_937256	0	76	CTCT	CCCA
V350256906L1C002R05500555355	chr1	1062549	50M	168	1062717	1062550	1062718	V350256906L1C002R05500555355_chr1_1062549	2	0	ctgg	CCAA
V350256906L1C002R05501112223	chr1	1210051	50M	181	1210232	1210052	1210233	V350256906L1C002R05501112223_chr1_1210051	127	33	ACAG	CCAC
V350256906L1C002R05501362682	chr1	984036	50M	165	984201	984037	984202	V350256906L1C002R05501362682_chr1_984036	39	68	cctc	CCCC
V350256906L1C002R05600096777	chr1	639053	50M	158	639211	639054	639212	V350256906L1C002R05600096777_chr1_639053	34	58	GCTC	TCCA
V350256906L1C002R05600281749	chr1	1339830	50M	151	1339981	1339831	1339982	V350256906L1C002R05600281749_chr1_1339830	70	40	ggcc	tgaa
V350256906L1C002R05600370094	chr1	905406	50M	169	905575	905407	905576	V350256906L1C002R05600370094_chr1_905406	32	55	CTGT	TAGC
V350256906L1C002R05600526790	chr1	892944	50M	166	893110	892945	893111	V350256906L1C002R05600526790_chr1_892944	2	13	cctg	ctga
V350256906L1C002R05601254125	chr1	433659	50M	199	433858	433660	433859	V350256906L1C002R05601254125_chr1_433659	210	17	TCCA	ACTC
V350256906L1C002R05700135367	chr1	1299311	50M	169	1299480	1299312	1299481	V350256906L1C002R05700135367_chr1_1299311	0	132	cgtt	gtga
V350256906L1C002R05700145544	chr1	128215	50M	172	128387	128216	128388	V350256906L1C002R05700145544_chr1_128215	87	34	TAAT	TTAT
V350256906L1C002R05700233893	chr1	131201	50M	174	131375	131202	131376	V350256906L1C002R05700233893_chr1_131201	24	43	TCTC	CCAG
V350256906L1C002R05700442919	chr1	466333	50M	143	466476	466334	466477	V350256906L1C002R05700442919_chr1_466333	0	68	CCTA	ACCC
V350256906L1C002R05700461936	chr1	464433	50M	185	464618	464434	464619	V350256906L1C002R05700461936_chr1_464433	146	0	gctc	cagg
V350256906L1C002R05700642659	chr1	603934	50M	159	604093	603935	604094	V350256906L1C002R05700642659_chr1_603934	351	192	ccat	gatg
V350256906L1C002R05700832977	chr1	1388133	50M	189	1388322	1388134	1388323	V350256906L1C002R05700832977_chr1_1388133	0	0	cctg	aaaa
V350256906L1C002R05700925566	chr1	1047875	50M	161	1048036	1047876	1048037	V350256906L1C002R05700925566_chr1_1047875	183	302	CCAG	ccct
V350256906L1C002R05800185288	chr1	549862	50M	143	550005	549863	550006	V350256906L1C002R05800185288_chr1_549862	0	74	CCTC	GAAA
V350256906L1C002R05800315290	chr1	675162	50M	105	675267	675163	675268	V350256906L1C002R05800315290_chr1_675162	52	7	gtcc	ACAG
V350256906L1C002R05800507332	chr1	941570	50M	139	941709	941571	941710	V350256906L1C002R05800507332_chr1_941570	42	56	TGCC	CCCC
V350256906L1C002R05800964485	chr1	674858	50M	164	675022	674859	675023	V350256906L1C002R05800964485_chr1_674858	19	0	TAAG	cacc
V350256906L1C002R05800980986	chr1	1179543	50M	212	1179755	1179544	1179756	V350256906L1C002R05800980986_chr1_1179543	50	53	GGTC	CCCG
V350256906L1C002R05801092761	chr1	135158	50M	153	135311	135159	135312	V350256906L1C002R05801092761_chr1_135158	165	12	GTCC	CATG
V350256906L1C002R05801336121	chr1	48208	50M	170	48378	48209	48379	V350256906L1C002R05801336121_chr1_48208	32	39	GAAG	GGCC
V350256906L1C002R05900019475	chr1	887746	50M	176	887922	887747	887923	V350256906L1C002R05900019475_chr1_887746	8	27	CCCC	CATC
V350256906L1C002R05900619819	chr1	1290809	50M	191	1291000	1290810	1291001	V350256906L1C002R05900619819_chr1_1290809	32	39	cccg	CCAG
V350256906L1C002R05900993769	chr1	237630	50M	160	237790	237631	237791	V350256906L1C002R05900993769_chr1_237630	0	2	GTGC	CGGG
V350256906L1C002R06000592311	chr1	119464	50M	139	119603	119465	119604	V350256906L1C002R06000592311_chr1_119464	43	0	tttt	gggc
V350256906L1C002R06000878041	chr1	160201	50M	186	160387	160202	160388	V350256906L1C002R06000878041_chr1_160201	59	245	CCTA	CCCA
V350256906L1C002R06001278201	chr1	895290	50M	170	895460	895291	895461	V350256906L1C002R06001278201_chr1_895290	52	26	GCCA	CCCG
V350256906L1C002R06001325451	chr1	457715	50M	193	457908	457716	457909	V350256906L1C002R06001325451_chr1_457715	30	13	ggcc	aaac
V350256906L1C002R06100387208	chr1	740677	50M	182	740859	740678	740860	V350256906L1C002R06100387208_chr1_740677	44	226	AGAT	ACGG
V350256906L1C002R06100429809	chr1	139345	50M	152	139497	139346	139498	V350256906L1C002R06100429809_chr1_139345	63	129	CGTT	CCCA
V350256906L1C002R06101199651	chr1	764731	50M	171	764902	764732	764903	V350256906L1C002R06101199651_chr1_764731	0	0	catc	CCTG
V350256906L1C002R06200053184	chr1	1305486	50M	150	1305636	1305487	1305637	V350256906L1C002R06200053184_chr1_1305486	11	65	AACT	GTTA
V350256906L1C002R06200220741	chr1	1084619	50M	188	1084807	1084620	1084808	V350256906L1C002R06200220741_chr1_1084619	68	74	CCAG	TCTA
V350256906L1C002R06201315233	chr1	16417	50M	100	16517	16418	16518	V350256906L1C002R06201315233_chr1_16417	172	156	CCTA	CTCA
V350256906L1C002R06201344258	chr1	102277	50M	178	102455	102278	102456	V350256906L1C002R06201344258_chr1_102277	0	148	GCAT	CAGG
V350256906L1C002R06300299545	chr1	597737	50M	175	597912	597738	597913	V350256906L1C002R06300299545_chr1_597737	48	18	ctaa	tcag
V350256906L1C002R06300355009	chr1	152881	50M	177	153058	152882	153059	V350256906L1C002R06300355009_chr1_152881	637	460	caat	actt
V350256906L1C002R06300475805	chr1	589373	50M	167	589540	589374	589541	V350256906L1C002R06300475805_chr1_589373	0	0	tatg	aatt
V350256906L1C002R06300633673	chr1	924383	50M	195	924578	924384	924579	V350256906L1C002R06300633673_chr1_924383	81	66	TGAT	CCAG
V350256906L1C002R06300925441	chr1	1038632	50M	205	1038837	1038633	1038838	V350256906L1C002R06300925441_chr1_1038632	145	35	ctga	caga
V350256906L1C002R06400103811	chr1	462344	50M	184	462528	462345	462529	V350256906L1C002R06400103811_chr1_462344	241	142	gaga	CCTT
V350256906L1C002R06400278509	chr1	412991	50M	162	413153	412992	413154	V350256906L1C002R06400278509_chr1_412991	267	105	TCCA	CATC
V350256906L1C002R06400552659	chr1	118521	50M	194	118715	118522	118716	V350256906L1C002R06400552659_chr1_118521	57	51	agat	actg
V350256906L1C002R06400852033	chr1	743221	50M	187	743408	743222	743409	V350256906L1C002R06400852033_chr1_743221	58	53	AGGA	AAGA
V350256906L1C002R06401263276	chr1	828166	50M	227	828393	828167	828394	V350256906L1C002R06401263276_chr1_828166	62	23	aacc	ctcc
V350256906L1C002R06500050834	chr1	625790	50M	118	625908	625791	625909	V350256906L1C002R06500050834_chr1_625790	67	0	AAAA	CAAA
V350256906L1C002R06500471298	chr1	19986	50M	171	20157	19987	20158	V350256906L1C002R06500471298_chr1_19986	188	164	caaa	gagc
V350256906L1C002R06500582264	chr1	1033403	50M	150	1033553	1033404	1033554	V350256906L1C002R06500582264_chr1_1033403	0	26	cagt	ctta
V350256906L1C002R06500657973	chr1	807846	50M	241	808087	807847	808088	V350256906L1C002R06500657973_chr1_807846	36	12	CAAA	CCCC
V350256906L1C002R06600524757	chr1	1178095	50M	154	1178249	1178096	1178250	V350256906L1C002R06600524757_chr1_1178095	36	68	CCTG	CACG
V350256906L1C002R06601000784	chr1	118796	50M	166	118962	118797	118963	V350256906L1C002R06601000784_chr1_118796	132	57	catt	aaac
V350256906L1C002R06601104772	chr1	601848	50M	164	602012	601849	602013	V350256906L1C002R06601104772_chr1_601848	64	75	ccaa	gctg
V350256906L1C002R06601364160	chr1	1189339	50M	180	1189519	1189340	1189520	V350256906L1C002R06601364160_chr1_1189339	40	68	GGTT	CCTG
V350256906L1C002R06700527306	chr1	621680	50M	197	621877	621681	621878	V350256906L1C002R06700527306_chr1_621680	22	10	CCAT	TCAC
V350256906L1C002R06700741765	chr1	1395694	50M	151	1395845	1395695	1395846	V350256906L1C002R06700741765_chr1_1395694	0	2	cagg	CCAC
V350256906L1C002R06701087754	chr1	248814	50M	162	248976	248815	248977	V350256906L1C002R06701087754_chr1_248814	0	39	TCTT	ctat
V350256906L1C002R06800044459	chr1	686920	50M	166	687086	686921	687087	V350256906L1C002R06800044459_chr1_686920	46	68	tcaa	tgct
V350256906L1C002R06800487254	chr1	765060	50M	180	765240	765061	765241	V350256906L1C002R06800487254_chr1_765060	0	169	agtg	agcg
V350256906L1C002R06800496081	chr1	169743	50M	169	169912	169744	169913	V350256906L1C002R06800496081_chr1_169743	20	8	CATT	cctg
V350256906L1C002R06800669656	chr1	100335	50M	174	100509	100336	100510	V350256906L1C002R06800669656_chr1_100335	9	0	GCAT	GTTG
V350256906L1C002R06800867668	chr1	770410	50M	183	770593	770411	770594	V350256906L1C002R06800867668_chr1_770410	58	55	TCTC	CAAA
V350256906L1C002R06900216543	chr1	813765	50M	192	813957	813766	813958	V350256906L1C002R06900216543_chr1_813765	240	48	CCTG	GCTT
V350256906L1C002R06900708021	chr1	685323	50M	185	685508	685324	685509	V350256906L1C002R06900708021_chr1_685323	53	72	cacc	TTGC
V350256906L1C002R06900868501	chr1	1089099	50M	177	1089276	1089100	1089277	V350256906L1C002R06900868501_chr1_1089099	248	109	tcct	ctgg
V350256906L1C002R06900970377	chr1	818109	50M	156	818265	818110	818266	V350256906L1C002R06900970377_chr1_818109	0	29	tgca	catg
V350256906L1C002R07000023775	chr1	1340043	50M	153	1340196	1340044	1340197	V350256906L1C002R07000023775_chr1_1340043	52	63	gcta	GGAT
V350256906L1C002R07000092146	chr1	228123	50M	120	228243	228124	228244	V350256906L1C002R07000092146_chr1_228123	23	143	taaa	TAAG
V350256906L1C002R07000203439	chr1	463075	50M	201	463276	463076	463277	V350256906L1C002R07000203439_chr1_463075	127	183	cctc	cctc
V350256906L1C002R07000208680	chr1	61767	50M	182	61949	61768	61950	V350256906L1C002R07000208680_chr1_61767	0	165	ttta	cgga
V350256906L1C002R07000312484	chr1	625372	50M	210	625582	625373	625583	V350256906L1C002R07000312484_chr1_625372	4	39	TGGG	TACT
V350256906L1C002R07000587641	chr1	1186172	50M	174	1186346	1186173	1186347	V350256906L1C002R07000587641_chr1_1186172	65	44	GGAC	CACC
V350256906L1C002R07001072290	chr1	265815	50M	166	265981	265816	265982	V350256906L1C002R07001072290_chr1_265815	72	36	CCAA	agct
V350256906L1C002R07100127434	chr1	243954	50M	152	244106	243955	244107	V350256906L1C002R07100127434_chr1_243954	60	35	ACTA	GCCT
V350256906L1C002R07100384931	chr1	1047039	50M	170	1047209	1047040	1047210	V350256906L1C002R07100384931_chr1_1047039	9	62	CACA	TACG
V350256906L1C002R07100430152	chr1	243789	50M	188	243977	243790	243978	V350256906L1C002R07100430152_chr1_243789	60	60	CTGC	TGGA
V350256906L1C002R07101007571	chr1	463189	50M	188	463377	463190	463378	V350256906L1C002R07101007571_chr1_463189	241	82	gtta	ccta
V350256906L1C002R07101020349	chr1	1262407	50M	175	1262582	1262408	1262583	V350256906L1C002R07101020349_chr1_1262407	30	19	GGTC	GGGG
V350256906L1C002R07101227533	chr1	915186	50M	162	915348	915187	915349	V350256906L1C002R07101227533_chr1_915186	66	26	ATGT	GACA
V350256906L1C002R07101311886	chr1	939587	50M	168	939755	939588	939756	V350256906L1C002R07101311886_chr1_939587	312	144	CCCA	CCAG
V350256906L1C002R07200498706	chr1	1104839	50M	184	1105023	1104840	1105024	V350256906L1C002R07200498706_chr1_1104839	65	61	CAAA	GCTG
V350256906L1C003R00100596406	chr1	636998	50M	173	637171	636999	637172	V350256906L1C003R00100596406_chr1_636998	118	28	cttt	cctt
V350256906L1C003R00200777440	chr1	998735	50M	146	998881	998736	998882	V350256906L1C003R00200777440_chr1_998735	0	0	GGAA	CCCA
V350256906L1C003R00200950012	chr1	1084627	50M	187	1084814	1084628	1084815	V350256906L1C003R00200950012_chr1_1084627	60	81	CGAG	GGCC
V350256906L1C003R00201246141	chr1	747436	50M	174	747610	747437	747611	V350256906L1C003R00201246141_chr1_747436	38	212	CATG	ggag
V350256906L1C003R00300011286	chr1	759315	50M	177	759492	759316	759493	V350256906L1C003R00300011286_chr1_759315	6	23	AAAA	TGTT
V350256906L1C003R00300347478	chr1	1038623	50M	214	1038837	1038624	1038838	V350256906L1C003R00300347478_chr1_1038623	154	35	tttt	caga
V350256906L1C003R00300583158	chr1	172609	50M	161	172770	172610	172771	V350256906L1C003R00300583158_chr1_172609	21	19	CCAC	CTGC
V350256906L1C003R00300855075	chr1	784730	50M	134	784864	784731	784865	V350256906L1C003R00300855075_chr1_784730	50	36	CGTG	CTAA
V350256906L1C003R00300899718	chr1	253921	50M	148	254069	253922	254070	V350256906L1C003R00300899718_chr1_253921	66	28	gaaa	cctg
V350256906L1C003R00301188703	chr1	1153999	50M	160	1154159	1154000	1154160	V350256906L1C003R00301188703_chr1_1153999	63	60	TGTC	CGGG
V350256906L1C003R00301365459	chr1	1254705	50M	164	1254869	1254706	1254870	V350256906L1C003R00301365459_chr1_1254705	91	35	CCAC	CTTC
V350256906L1C003R00301388177	chr1	1166613	50M	174	1166787	1166614	1166788	V350256906L1C003R00301388177_chr1_1166613	59	67	CCGG	TGTG
V350256906L1C003R00400068934	chr1	689140	50M	241	689381	689141	689382	V350256906L1C003R00400068934_chr1_689140	209	0	cccg	ccaa
V350256906L1C003R00400645948	chr1	554766	50M	177	554943	554767	554944	V350256906L1C003R00400645948_chr1_554766	0	3	gcca	CCCC
V350256906L1C003R00400770983	chr1	853751	50M	191	853942	853752	853943	V350256906L1C003R00400770983_chr1_853751	38	41	TCAT	CCTG
V350256906L1C003R00400817212	chr1	686193	50M	186	686379	686194	686380	V350256906L1C003R00400817212_chr1_686193	0	0	cttg	ATTA
V350256906L1C003R00400945268	chr1	755118	50M	180	755298	755119	755299	V350256906L1C003R00400945268_chr1_755118	71	86	ccac	acag
V350256906L1C003R00400984401	chr1	897325	50M	134	897459	897326	897460	V350256906L1C003R00400984401_chr1_897325	21	0	GCAC	gggG
V350256906L1C003R00401391512	chr1	861366	50M	168	861534	861367	861535	V350256906L1C003R00401391512_chr1_861366	33	33	CCCG	CCCC
V350256906L1C003R00500368698	chr1	1150794	50M	150	1150944	1150795	1150945	V350256906L1C003R00500368698_chr1_1150794	50	63	ACCC	TGTG
V350256906L1C003R00500468618	chr1	642864	50M	228	643092	642865	643093	V350256906L1C003R00500468618_chr1_642864	0	49	ccca	tggg
V350256906L1C003R00501052274	chr1	1321220	50M	174	1321394	1321221	1321395	V350256906L1C003R00501052274_chr1_1321220	45	89	cagg	ggac
V350256906L1C003R00600422113	chr1	1127127	50M	165	1127292	1127128	1127293	V350256906L1C003R00600422113_chr1_1127127	8	22	tagt	caaa
V350256906L1C003R00600658109	chr1	1370510	50M	159	1370669	1370511	1370670	V350256906L1C003R00600658109_chr1_1370510	78	45	CAAG	GGCG
V350256906L1C003R00600794984	chr1	98622	50M	158	98780	98623	98781	V350256906L1C003R00600794984_chr1_98622	45	64	CTGA	CATT
V350256906L1C003R00600932934	chr1	145881	50M	194	146075	145882	146076	V350256906L1C003R00600932934_chr1_145881	44	40	cgag	ctgt
V350256906L1C003R00600955430	chr1	427016	50M	148	427164	427017	427165	V350256906L1C003R00600955430_chr1_427016	58	123	GATT	CCCA
V350256906L1C003R00700070706	chr1	1251575	50M	187	1251762	1251576	1251763	V350256906L1C003R00700070706_chr1_1251575	292	152	tcgc	cctg
V350256906L1C003R00700238015	chr1	457837	50M	199	458036	457838	458037	V350256906L1C003R00700238015_chr1_457837	70	51	cctg	caaa
V350256906L1C003R00700656295	chr1	722161	50M	166	722327	722162	722328	V350256906L1C003R00700656295_chr1_722161	1	0	cttt	ctga
V350256906L1C003R00700669835	chr1	1159290	50M	138	1159428	1159291	1159429	V350256906L1C003R00700669835_chr1_1159290	21	66	CCAT	GGGC
V350256906L1C003R00701009259	chr1	1021119	50M	180	1021299	1021120	1021300	V350256906L1C003R00701009259_chr1_1021119	70	55	CCAC	CTCC
V350256906L1C003R00701115284	chr1	335877	50M	185	336062	335878	336063	V350256906L1C003R00701115284_chr1_335877	141	0	TTAA	AAAA
V350256906L1C003R00701266148	chr1	1127079	50M	150	1127229	1127080	1127230	V350256906L1C003R00701266148_chr1_1127079	6	17	caca	ccta
V350256906L1C003R00800136871	chr1	542121	50M	155	542276	542122	542277	V350256906L1C003R00800136871_chr1_542121	39	62	GACA	CTTG
V350256906L1C003R00800594722	chr1	1279959	50M	177	1280136	1279960	1280137	V350256906L1C003R00800594722_chr1_1279959	51	0	CCCA	CCCT
V350256906L1C003R00800691813	chr1	960433	50M	142	960575	960434	960576	V350256906L1C003R00800691813_chr1_960433	27	72	AGAG	GCCC
V350256906L1C003R00800874486	chr1	1089346	50M	174	1089520	1089347	1089521	V350256906L1C003R00800874486_chr1_1089346	39	35	AGCC	ttac
V350256906L1C003R00800909455	chr1	1328605	50M	175	1328780	1328606	1328781	V350256906L1C003R00800909455_chr1_1328605	52	13	TGCC	CATG
V350256906L1C003R00800925528	chr1	155718	50M	157	155875	155719	155876	V350256906L1C003R00800925528_chr1_155718	106	263	TGCA	CCCT
V350256906L1C003R00800932459	chr1	1280035	50M	186	1280221	1280036	1280222	V350256906L1C003R00800932459_chr1_1280035	87	68	CCCC	GTCC
V350256906L1C003R00801265466	chr1	1239321	50M	133	1239454	1239322	1239455	V350256906L1C003R00801265466_chr1_1239321	98	52	GACA	CCTG
V350256906L1C003R00801395844	chr1	630080	50M	160	630240	630081	630241	V350256906L1C003R00801395844_chr1_630080	11	0	caaa	TATG
V350256906L1C003R00900193428	chr1	721847	50M	187	722034	721848	722035	V350256906L1C003R00900193428_chr1_721847	39	97	caaa	tgta
V350256906L1C003R00900241146	chr1	1096027	50M	179	1096206	1096028	1096207	V350256906L1C003R00900241146_chr1_1096027	0	60	CGCC	TGGC
V350256906L1C003R00900304204	chr1	465844	50M	120	465964	465845	465965	V350256906L1C003R00900304204_chr1_465844	110	0	ACAT	catc
V350256906L1C003R00900660510	chr1	860456	50M	196	860652	860457	860653	V350256906L1C003R00900660510_chr1_860456	133	149	CCCC	CCTC
V350256906L1C003R00900935482	chr1	1281157	50M	195	1281352	1281158	1281353	V350256906L1C003R00900935482_chr1_1281157	68	72	GGAA	GGCA
V350256906L1C003R00901278582	chr1	1076953	50M	121	1077074	1076954	1077075	V350256906L1C003R00901278582_chr1_1076953	115	0	CCAC	GGCC
V350256906L1C003R01000031944	chr1	865346	50M	187	865533	865347	865534	V350256906L1C003R01000031944_chr1_865346	99	35	TCCC	ggtg
V350256906L1C003R01000084335	chr1	860908	50M	162	861070	860909	861071	V350256906L1C003R01000084335_chr1_860908	0	0	CGTG	TGGG
V350256906L1C003R01000210273	chr1	1364969	50M	219	1365188	1364970	1365189	V350256906L1C003R01000210273_chr1_1364969	62	99	ctga	CCCT
V350256906L1C003R01000217130	chr1	137106	50M	123	137229	137107	137230	V350256906L1C003R01000217130_chr1_137106	54	0	CACG	GCCT
V350256906L1C003R01000564879	chr1	420134	50M	212	420346	420135	420347	V350256906L1C003R01000564879_chr1_420134	30	70	CTGT	TGCA
V350256906L1C003R01000799946	chr1	1278946	50M	159	1279105	1278947	1279106	V350256906L1C003R01000799946_chr1_1278946	176	50	CCCT	CGTC
V350256906L1C003R01001013558	chr1	673838	50M	150	673988	673839	673989	V350256906L1C003R01001013558_chr1_673838	63	54	ccca	ggct
V350256906L1C003R01001196467	chr1	394585	50M	204	394789	394586	394790	V350256906L1C003R01001196467_chr1_394585	0	0	cgac	taat
V350256906L1C003R01001257657	chr1	649330	50M	146	649476	649331	649477	V350256906L1C003R01001257657_chr1_649330	29	117	GTTA	TGTA
V350256906L1C003R01100728431	chr1	359068	50M	176	359244	359069	359245	V350256906L1C003R01100728431_chr1_359068	169	2	CAAT	TGAA
V350256906L1C003R01101324164	chr1	792007	50M	173	792180	792008	792181	V350256906L1C003R01101324164_chr1_792007	62	46	TCCA	ACCT
V350256906L1C003R01200373184	chr1	1156712	50M	185	1156897	1156713	1156898	V350256906L1C003R01200373184_chr1_1156712	69	64	tgaa	gata
V350256906L1C003R01200701313	chr1	400356	50M	182	400538	400357	400539	V350256906L1C003R01200701313_chr1_400356	23	205	catt	catg
V350256906L1C003R01201118930	chr1	1221288	50M	175	1221463	1221289	1221464	V350256906L1C003R01201118930_chr1_1221288	36	54	AGGC	GGCG
V350256906L1C003R01201272776	chr1	1196738	50M	180	1196918	1196739	1196919	V350256906L1C003R01201272776_chr1_1196738	55	48	CAAC	CACC
V350256906L1C003R01300013774	chr1	74749	50M	155	74904	74750	74905	V350256906L1C003R01300013774_chr1_74749	376	221	cttt	cggt
V350256906L1C003R01300294286	chr1	334706	50M	169	334875	334707	334876	V350256906L1C003R01300294286_chr1_334706	136	39	ctcc	TTTT
V350256906L1C003R01300841521	chr1	884338	50M	169	884507	884339	884508	V350256906L1C003R01300841521_chr1_884338	10	16	TGAC	CTGT
V350256906L1C003R01400384318	chr1	656335	50M	173	656508	656336	656509	V350256906L1C003R01400384318_chr1_656335	40	61	aaga	gtgc
V350256906L1C003R01400752788	chr1	1170840	50M	184	1171024	1170841	1171025	V350256906L1C003R01400752788_chr1_1170840	59	58	CAGT	TCAG
V350256906L1C003R01400850989	chr1	824161	50M	140	824301	824162	824302	V350256906L1C003R01400850989_chr1_824161	22	61	CTGC	GAAT
V350256906L1C003R01401115806	chr1	1361283	50M	169	1361452	1361284	1361453	V350256906L1C003R01401115806_chr1_1361283	28	149	GGCG	CCAG
V350256906L1C003R01401146613	chr1	410389	50M	198	410587	410390	410588	V350256906L1C003R01401146613_chr1_410389	277	206	TGAG	GATG
V350256906L1C003R01401175121	chr1	1349773	50M	173	1349946	1349774	1349947	V350256906L1C003R01401175121_chr1_1349773	0	0	aata	aggt
V350256906L1C003R01401326191	chr1	427939	50M	176	428115	427940	428116	V350256906L1C003R01401326191_chr1_427939	73	57	cctt	AGGT
V350256906L1C003R01500369123	chr1	161941	50M	177	162118	161942	162119	V350256906L1C003R01500369123_chr1_161941	80	60	TAGG	acTC
V350256906L1C003R01500479944	chr1	111800	50M	194	111994	111801	111995	V350256906L1C003R01500479944_chr1_111800	0	0	CAAG	TGTG
V350256906L1C003R01600233631	chr1	861989	50M	166	862155	861990	862156	V350256906L1C003R01600233631_chr1_861989	49	40	CCCA	TCTT
V350256906L1C003R01600324110	chr1	829548	50M	167	829715	829549	829716	V350256906L1C003R01600324110_chr1_829548	29	53	gcca	CCAT
V350256906L1C003R01600381085	chr1	959151	50M	171	959322	959152	959323	V350256906L1C003R01600381085_chr1_959151	132	303	TACC	GTGG
V350256906L1C003R01600405240	chr1	469731	50M	182	469913	469732	469914	V350256906L1C003R01600405240_chr1_469731	108	290	tcct	ctcc
V350256906L1C003R01700144061	chr1	580634	50M	201	580835	580635	580836	V350256906L1C003R01700144061_chr1_580634	44	33	cttt	acat
V350256906L1C003R01700259787	chr1	418211	50M	174	418385	418212	418386	V350256906L1C003R01700259787_chr1_418211	54	62	TGTG	cttt
V350256906L1C003R01700279613	chr1	1183688	50M	176	1183864	1183689	1183865	V350256906L1C003R01700279613_chr1_1183688	66	87	GTAC	CCCG
V350256906L1C003R01700828635	chr1	734276	50M	156	734432	734277	734433	V350256906L1C003R01700828635_chr1_734276	48	0	atcc	AGTT
V350256906L1C003R01701091918	chr1	588126	50M	150	588276	588127	588277	V350256906L1C003R01701091918_chr1_588126	0	24	caaa	tctt
V350256906L1C003R01701308493	chr1	253189	50M	173	253362	253190	253363	V350256906L1C003R01701308493_chr1_253189	37	53	CTTA	GGTT
V350256906L1C003R01800042882	chr1	403333	50M	175	403508	403334	403509	V350256906L1C003R01800042882_chr1_403333	47	110	tgat	atta
V350256906L1C003R01800362066	chr1	1112935	50M	180	1113115	1112936	1113116	V350256906L1C003R01800362066_chr1_1112935	55	38	cccg	CACC
V350256906L1C003R01800454421	chr1	129349	50M	187	129536	129350	129537	V350256906L1C003R01800454421_chr1_129349	0	179	TCAA	ctat
V350256906L1C003R01800664407	chr1	347640	50M	200	347840	347641	347841	V350256906L1C003R01800664407_chr1_347640	0	32	cctt	GGTT
V350256906L1C003R01800772491	chr1	235862	50M	171	236033	235863	236034	V350256906L1C003R01800772491_chr1_235862	0	0	agtg	TCAG
V350256906L1C003R01801195582	chr1	809957	50M	177	810134	809958	810135	V350256906L1C003R01801195582_chr1_809957	58	56	CCTG	CCAA
V350256906L1C003R01801328281	chr1	1159298	50M	183	1159481	1159299	1159482	V350256906L1C003R01801328281_chr1_1159298	13	119	CAGC	GCCT
V350256906L1C003R01801371157	chr1	423972	50M	162	424134	423973	424135	V350256906L1C003R01801371157_chr1_423972	190	28	cttt	TTTA
V350256906L1C003R01900368997	chr1	318412	50M	152	318564	318413	318565	V350256906L1C003R01900368997_chr1_318412	0	3	ttgc	tcag
V350256906L1C003R01900527447	chr1	1387796	50M	177	1387973	1387797	1387974	V350256906L1C003R01900527447_chr1_1387796	126	17	GGAC	GGAG
V350256906L1C003R01900603761	chr1	1094933	50M	174	1095107	1094934	1095108	V350256906L1C003R01900603761_chr1_1094933	129	30	CAGG	GCCC
V350256906L1C003R01900653764	chr1	1038931	50M	184	1039115	1038932	1039116	V350256906L1C003R01900653764_chr1_1038931	0	0	ctgc	gcaa
V350256906L1C003R01900669088	chr1	1376210	50M	184	1376394	1376211	1376395	V350256906L1C003R01900669088_chr1_1376210	43	49	TGAA	GCCC
V350256906L1C003R01900973304	chr1	1263226	50M	135	1263361	1263227	1263362	V350256906L1C003R01900973304_chr1_1263226	7	46	CTTC	AGGC
V350256906L1C003R01901373804	chr1	557691	50M	170	557861	557692	557862	V350256906L1C003R01901373804_chr1_557691	22	0	CCTC	GCAT
V350256906L1C003R02000084088	chr1	1318030	50M	153	1318183	1318031	1318184	V350256906L1C003R02000084088_chr1_1318030	201	48	TCCA	TACC
V350256906L1C003R02000438491	chr1	1203429	50M	154	1203583	1203430	1203584	V350256906L1C003R02000438491_chr1_1203429	1	0	CCCC	GGTG
V350256906L1C003R02000488659	chr1	427096	50M	164	427260	427097	427261	V350256906L1C003R02000488659_chr1_427096	138	27	ATAG	GCCC
V350256906L1C003R02001032217	chr1	247609	50M	167	247776	247610	247777	V350256906L1C003R02001032217_chr1_247609	42	43	tgca	ggtc
V350256906L1C003R02001235134	chr1	384114	50M	178	384292	384115	384293	V350256906L1C003R02001235134_chr1_384114	58	17	aatg	acct
V350256906L1C003R02100240503	chr1	49945	50M	174	50119	49946	50120	V350256906L1C003R02100240503_chr1_49945	57	95	ACTG	CTAA
V350256906L1C003R02100345489	chr1	1335198	50M	179	1335377	1335199	1335378	V350256906L1C003R02100345489_chr1_1335198	0	4	CCCC	CCCC
V350256906L1C003R02100381070	chr1	908222	50M	175	908397	908223	908398	V350256906L1C003R02100381070_chr1_908222	0	3	CCAC	GCTC
V350256906L1C003R02100455261	chr1	1117754	50M	154	1117908	1117755	1117909	V350256906L1C003R02100455261_chr1_1117754	181	27	GAAG	gccc
V350256906L1C003R02100503752	chr1	1360530	50M	173	1360703	1360531	1360704	V350256906L1C003R02100503752_chr1_1360530	73	74	GGAA	agca
V350256906L1C003R02100544275	chr1	53305	50M	184	53489	53306	53490	V350256906L1C003R02100544275_chr1_53305	39	223	ACAT	GGCA
V350256906L1C003R02100673036	chr1	795245	50M	175	795420	795246	795421	V350256906L1C003R02100673036_chr1_795245	59	58	GCTT	CAAG
V350256906L1C003R02101360403	chr1	726606	5S45M	148	726754	726607	726755	V350256906L1C003R02101360403_chr1_726606	0	59	gaat	attc
V350256906L1C003R02200728228	chr1	101071	50M	187	101258	101072	101259	V350256906L1C003R02200728228_chr1_101071	70	26	ctca	caag
V350256906L1C003R02200864960	chr1	78325	50M	165	78490	78326	78491	V350256906L1C003R02200864960_chr1_78325	13	9	tggg	gtca
V350256906L1C003R02200882887	chr1	395018	50M	145	395163	395019	395164	V350256906L1C003R02200882887_chr1_395018	43	33	gggc	tact
V350256906L1C003R02200971266	chr1	828351	50M	146	828497	828352	828498	V350256906L1C003R02200971266_chr1_828351	65	40	actt	ctcc
V350256906L1C003R02201045897	chr1	610939	50M	177	611116	610940	611117	V350256906L1C003R02201045897_chr1_610939	81	70	TGTA	GCTG
V350256906L1C003R02201237239	chr1	1361582	50M	181	1361763	1361583	1361764	V350256906L1C003R02201237239_chr1_1361582	19	3	CCGG	CGAG
V350256906L1C003R02201297846	chr1	724932	9S41M	195	725127	724933	725128	V350256906L1C003R02201297846_chr1_724932	0	142	gaat	catt
V350256906L1C003R02201396828	chr1	335847	50M	166	336013	335848	336014	V350256906L1C003R02201396828_chr1_335847	171	5	AGAT	TATT
V350256906L1C003R02300500862	chr1	757316	50M	148	757464	757317	757465	V350256906L1C003R02300500862_chr1_757316	94	230	CTGC	ACAG
V350256906L1C003R02300716156	chr1	540495	50M	168	540663	540496	540664	V350256906L1C003R02300716156_chr1_540495	69	75	gcaa	ccca
V350256906L1C003R02300778198	chr1	648120	50M	168	648288	648121	648289	V350256906L1C003R02300778198_chr1_648120	0	19	GAGA	TCTC
V350256906L1C003R02300792004	chr1	1235751	50M	172	1235923	1235752	1235924	V350256906L1C003R02300792004_chr1_1235751	29	0	CCAT	CTTC
V350256906L1C003R02301114220	chr1	701193	50M	173	701366	701194	701367	V350256906L1C003R02301114220_chr1_701193	48	88	CTTC	CATA
V350256906L1C003R02400045033	chr1	88129	50M	156	88285	88130	88286	V350256906L1C003R02400045033_chr1_88129	53	17	ACTA	cagg
V350256906L1C003R02400971940	chr1	1293443	50M	198	1293641	1293444	1293642	V350256906L1C003R02400971940_chr1_1293443	51	46	CCGG	TCCC
V350256906L1C003R02401343413	chr1	882418	50M	163	882581	882419	882582	V350256906L1C003R02401343413_chr1_882418	80	0	caca	GAAA
V350256906L1C003R02401375763	chr1	71912	50M	123	72035	71913	72036	V350256906L1C003R02401375763_chr1_71912	0	22	CCTA	CAGG
V350256906L1C003R02500298799	chr1	1417255	50M	137	1417392	1417256	1417393	V350256906L1C003R02500298799_chr1_1417255	28	70	GGGT	CATG
V350256906L1C003R02500520950	chr1	1422382	50M	170	1422552	1422383	1422553	V350256906L1C003R02500520950_chr1_1422382	17	0	TGGG	GAGG
V350256906L1C003R02500676623	chr1	792280	50M	160	792440	792281	792441	V350256906L1C003R02500676623_chr1_792280	0	0	CTTG	CCCT
V350256906L1C003R02500868428	chr1	1098146	50M	122	1098268	1098147	1098269	V350256906L1C003R02500868428_chr1_1098146	0	29	CAGG	CGGG
V350256906L1C003R02500870961	chr1	1221802	50M	225	1222027	1221803	1222028	V350256906L1C003R02500870961_chr1_1221802	55	65	CCCA	CTGG
V350256906L1C003R02500985510	chr1	891639	50M	161	891800	891640	891801	V350256906L1C003R02500985510_chr1_891639	54	63	GCAC	CCTG
V350256906L1C003R02501021519	chr1	1033603	50M	133	1033736	1033604	1033737	V350256906L1C003R02501021519_chr1_1033603	76	25	ccac	ggct
V350256906L1C003R02501132705	chr1	693945	50M	163	694108	693946	694109	V350256906L1C003R02501132705_chr1_693945	22	0	ggta	gcct
V350256906L1C003R02501137257	chr1	1133047	50M	174	1133221	1133048	1133222	V350256906L1C003R02501137257_chr1_1133047	51	72	ACCT	CTCG
V350256906L1C003R02501157815	chr1	640640	50M	156	640796	640641	640797	V350256906L1C003R02501157815_chr1_640640	0	33	agca	cttt
V350256906L1C003R02501266480	chr1	884651	50M	175	884826	884652	884827	V350256906L1C003R02501266480_chr1_884651	103	5	CCAG	CCCA
V350256906L1C003R02600364768	chr1	1300804	50M	159	1300963	1300805	1300964	V350256906L1C003R02600364768_chr1_1300804	219	60	cggg	agct
V350256906L1C003R02600641588	chr1	730874	50M	200	731074	730875	731075	V350256906L1C003R02600641588_chr1_730874	155	127	ccca	tgca
V350256906L1C003R02600856438	chr1	251378	50M	190	251568	251379	251569	V350256906L1C003R02600856438_chr1_251378	41	20	gctc	CAAA
V350256906L1C003R02700232255	chr1	463677	50M	173	463850	463678	463851	V350256906L1C003R02700232255_chr1_463677	176	91	GAaa	cagg
V350256906L1C003R02700304732	chr1	978103	50M	152	978255	978104	978256	V350256906L1C003R02700304732_chr1_978103	0	33	TGCC	GGAG
V350256906L1C003R02700436671	chr1	158043	50M	157	158200	158044	158201	V350256906L1C003R02700436671_chr1_158043	12	36	TAAA	cagg
V350256906L1C003R02700640659	chr1	468506	50M	166	468672	468507	468673	V350256906L1C003R02700640659_chr1_468506	75	0	ctac	ccag
V350256906L1C003R02700821116	chr1	836745	50M	199	836944	836746	836945	V350256906L1C003R02700821116_chr1_836745	0	1	ctca	CCTG
V350256906L1C003R02700842104	chr1	1010894	50M	162	1011056	1010895	1011057	V350256906L1C003R02700842104_chr1_1010894	11	0	GGGA	CCCC
V350256906L1C003R02701208267	chr1	1387479	50M	172	1387651	1387480	1387652	V350256906L1C003R02701208267_chr1_1387479	53	70	TCAG	GGTC
V350256906L1C003R02800480203	chr1	1247658	50M	182	1247840	1247659	1247841	V350256906L1C003R02800480203_chr1_1247658	18	22	CATG	CCCT
V350256906L1C003R02800973956	chr1	250048	50M	266	250314	250049	250315	V350256906L1C003R02800973956_chr1_250048	38	6	agcc	gaga
V350256906L1C003R02801079313	chr1	1430408	50M	147	1430555	1430409	1430556	V350256906L1C003R02801079313_chr1_1430408	117	0	ATGG	GCAG
V350256906L1C003R02801188602	chr1	986123	50M	186	986309	986124	986310	V350256906L1C003R02801188602_chr1_986123	18	16	CCCT	CAGC
V350256906L1C003R02900476504	chr1	1060077	50M	170	1060247	1060078	1060248	V350256906L1C003R02900476504_chr1_1060077	7	0	CCAC	AGCC
V350256906L1C003R02900487731	chr1	767697	50M	187	767884	767698	767885	V350256906L1C003R02900487731_chr1_767697	57	67	CCTC	CCTG
V350256906L1C003R02900533281	chr1	67712	50M	153	67865	67713	67866	V350256906L1C003R02900533281_chr1_67712	28	80	ATGC	ATAC
V350256906L1C003R02900913967	chr1	10145	50M	146	10291	10146	10292	V350256906L1C003R02900913967_chr1_10145	378	232	aacc	gggt
V350256906L1C003R02900926888	chr1	1384408	50M	206	1384614	1384409	1384615	V350256906L1C003R02900926888_chr1_1384408	50	217	caaa	gaca
V350256906L1C003R02901129779	chr1	948272	50M	133	948405	948273	948406	V350256906L1C003R02901129779_chr1_948272	27	57	ggtg	gggt
V350256906L1C003R02901229762	chr1	878270	50M	143	878413	878271	878414	V350256906L1C003R02901229762_chr1_878270	78	45	CCCA	TAAG
V350256906L1C003R02901313830	chr1	241372	50M	156	241528	241373	241529	V350256906L1C003R02901313830_chr1_241372	0	0	actg	CCTT
V350256906L1C003R02901336896	chr1	1059581	50M	151	1059732	1059582	1059733	V350256906L1C003R02901336896_chr1_1059581	325	300	ctgc	CGTC
V350256906L1C003R02901394979	chr1	14995	50M	170	15165	14996	15166	V350256906L1C003R02901394979_chr1_14995	179	9	GAAG	GCTC
V350256906L1C003R03000072343	chr1	321663	50M	171	321834	321664	321835	V350256906L1C003R03000072343_chr1_321663	209	147	TGAC	CTAC
V350256906L1C003R03000118723	chr1	1320697	50M	191	1320888	1320698	1320889	V350256906L1C003R03000118723_chr1_1320697	28	58	tgtt	tggg
V350256906L1C003R03000410280	chr1	822804	50M	178	822982	822805	822983	V350256906L1C003R03000410280_chr1_822804	60	43	ccag	ccag
V350256906L1C003R03000566022	chr1	990510	50M	164	990674	990511	990675	V350256906L1C003R03000566022_chr1_990510	21	53	CTAG	AGGG
V350256906L1C003R03000901821	chr1	1212901	50M	178	1213079	1212902	1213080	V350256906L1C003R03000901821_chr1_1212901	0	8	ctcc	ctac
V350256906L1C003R03100709375	chr1	924730	50M	166	924896	924731	924897	V350256906L1C003R03100709375_chr1_924730	12	0	GTTT	taaa
V350256906L1C003R03100733643	chr1	960130	50M	169	960299	960131	960300	V350256906L1C003R03100733643_chr1_960130	10	0	CCCT	CTGA
V350256906L1C003R03100853026	chr1	697340	50M	169	697509	697341	697510	V350256906L1C003R03100853026_chr1_697340	0	0	acaa	GCTA
V350256906L1C003R03100931565	chr1	462048	50M	161	462209	462049	462210	V350256906L1C003R03100931565_chr1_462048	0	106	GGGA	tcca
V350256906L1C003R03101141133	chr1	679710	50M	180	679890	679711	679891	V350256906L1C003R03101141133_chr1_679710	35	48	GCTT	TGCT
V350256906L1C003R03101278537	chr1	1031500	50M	179	1031679	1031501	1031680	V350256906L1C003R03101278537_chr1_1031500	72	58	ataa	tccc
V350256906L1C003R03200105887	chr1	110715	50M	170	110885	110716	110886	V350256906L1C003R03200105887_chr1_110715	25	0	agtt	cagg
V350256906L1C003R03200340544	chr1	342518	50M	165	342683	342519	342684	V350256906L1C003R03200340544_chr1_342518	58	164	GAAA	TGTC
V350256906L1C003R03200474977	chr1	1294190	50M	165	1294355	1294191	1294356	V350256906L1C003R03200474977_chr1_1294190	62	53	CGTG	CGCT
V350256906L1C003R03200795764	chr1	37593	50M	160	37753	37594	37754	V350256906L1C003R03200795764_chr1_37593	174	334	CCTA	tgtg
V350256906L1C003R03200852082	chr1	1187773	50M	177	1187950	1187774	1187951	V350256906L1C003R03200852082_chr1_1187773	0	18	atga	ccct
V350256906L1C003R03201389305	chr1	650170	50M	152	650322	650171	650323	V350256906L1C003R03201389305_chr1_650170	58	54	gaca	ctgc
V350256906L1C003R03300382076	chr1	1145171	50M	172	1145343	1145172	1145344	V350256906L1C003R03300382076_chr1_1145171	44	85	CGGC	ggct
V350256906L1C003R03300428342	chr1	667159	50M	145	667304	667160	667305	V350256906L1C003R03300428342_chr1_667159	262	130	cctg	ACGC
V350256906L1C003R03300511021	chr1	239865	50M	220	240085	239866	240086	V350256906L1C003R03300511021_chr1_239865	112	56	TACA	tcta
V350256906L1C003R03301024302	chr1	462113	50M	169	462282	462114	462283	V350256906L1C003R03301024302_chr1_462113	10	179	CAAG	ggag
V350256906L1C003R03301219293	chr1	124587	50M	168	124755	124588	124756	V350256906L1C003R03301219293_chr1_124587	72	240	tgtc	tcca
V350256906L1C003R03400063678	chr1	72834	50M	162	72996	72835	72997	V350256906L1C003R03400063678_chr1_72834	22	71	ggaa	CATT
V350256906L1C003R03400068773	chr1	932351	50M	194	932545	932352	932546	V350256906L1C003R03400068773_chr1_932351	0	24	GCCC	gctc
V350256906L1C003R03400118115	chr1	98191	50M	160	98351	98192	98352	V350256906L1C003R03400118115_chr1_98191	261	118	GGAA	AGGA
V350256906L1C003R03400349161	chr1	674200	50M	200	674400	674201	674401	V350256906L1C003R03400349161_chr1_674200	50	36	ccat	ccct
V350256906L1C003R03401095253	chr1	874703	50M	168	874871	874704	874872	V350256906L1C003R03401095253_chr1_874703	6	51	ACCA	AGGG
V350256906L1C003R03401260189	chr1	387993	50M	183	388176	387994	388177	V350256906L1C003R03401260189_chr1_387993	77	260	ccag	tgat
V350256906L1C003R03401381819	chr1	61025	50M	179	61204	61026	61205	V350256906L1C003R03401381819_chr1_61025	155	113	AGTA	CTAG
V350256906L1C003R03500365858	chr1	92741	50M	203	92944	92742	92945	V350256906L1C003R03500365858_chr1_92741	47	47	cgtt	TCAA
V350256906L1C003R03500789235	chr1	144169	50M	143	144312	144170	144313	V350256906L1C003R03500789235_chr1_144169	183	110	CATC	aaac
V350256906L1C003R03501275032	chr1	159445	50M	166	159611	159446	159612	V350256906L1C003R03501275032_chr1_159445	232	66	ggcc	CAAA
V350256906L1C003R03501321340	chr1	764290	50M	187	764477	764291	764478	V350256906L1C003R03501321340_chr1_764290	45	46	tatt	ccag
V350256906L1C003R03600464719	chr1	1205722	50M	162	1205884	1205723	1205885	V350256906L1C003R03600464719_chr1_1205722	79	42	GAGA	TTGG
V350256906L1C003R03600479885	chr1	445739	50M	155	445894	445740	445895	V350256906L1C003R03600479885_chr1_445739	34	189	GCAT	cacc
V350256906L1C003R03600557384	chr1	1403944	50M	140	1404084	1403945	1404085	V350256906L1C003R03600557384_chr1_1403944	0	31	CCGC	CCAG
V350256906L1C003R03600604794	chr1	405193	50M	158	405351	405194	405352	V350256906L1C003R03600604794_chr1_405193	48	66	cacc	cccc
V350256906L1C003R03600736601	chr1	685072	50M	183	685255	685073	685256	V350256906L1C003R03600736601_chr1_685072	48	34	AAAA	gctg
V350256906L1C003R03600766758	chr1	141174	50M	194	141368	141175	141369	V350256906L1C003R03600766758_chr1_141174	1	12	aaag	ggtt
V350256906L1C003R03600769066	chr1	823287	50M	177	823464	823288	823465	V350256906L1C003R03600769066_chr1_823287	0	3	GGTA	CTGT
V350256906L1C003R03600915820	chr1	104795	50M	160	104955	104796	104956	V350256906L1C003R03600915820_chr1_104795	60	22	taat	gtat
V350256906L1C003R03601097671	chr1	461670	50M	165	461835	461671	461836	V350256906L1C003R03601097671_chr1_461670	0	83	tctg	GTTT
V350256906L1C003R03700068203	chr1	672257	50M	159	672416	672258	672417	V350256906L1C003R03700068203_chr1_672257	182	23	tatg	cctg
V350256906L1C003R03700296951	chr1	891416	50M	160	891576	891417	891577	V350256906L1C003R03700296951_chr1_891416	65	70	TACT	GTTC
V350256906L1C003R03700416948	chr1	708279	50M	166	708445	708280	708446	V350256906L1C003R03700416948_chr1_708279	59	59	CCCA	TCCC
V350256906L1C003R03700752136	chr1	258735	50M	163	258898	258736	258899	V350256906L1C003R03700752136_chr1_258735	6	0	ttat	catt
V350256906L1C003R03701106544	chr1	1087417	50M	124	1087541	1087418	1087542	V350256906L1C003R03701106544_chr1_1087417	0	22	actg	cctg
V350256906L1C003R03701269843	chr1	702768	50M	187	702955	702769	702956	V350256906L1C003R03701269843_chr1_702768	0	6	AGGT	TCAG
V350256906L1C003R03800280453	chr1	326324	50M	153	326477	326325	326478	V350256906L1C003R03800280453_chr1_326324	65	57	CCAC	GGTC
V350256906L1C003R03800494013	chr1	957992	50M	167	958159	957993	958160	V350256906L1C003R03800494013_chr1_957992	58	73	TCTC	CCAG
V350256906L1C003R03800535306	chr1	245752	50M	210	245962	245753	245963	V350256906L1C003R03800535306_chr1_245752	137	20	GAAC	TGGG
V350256906L1C003R03800781364	chr1	70011	50M	168	70179	70012	70180	V350256906L1C003R03800781364_chr1_70011	158	0	CTTA	CACA
V350256906L1C003R03800835650	chr1	1352173	50M	154	1352327	1352174	1352328	V350256906L1C003R03800835650_chr1_1352173	6	0	ctgt	ccga
V350256906L1C003R03801270534	chr1	1276582	50M	178	1276760	1276583	1276761	V350256906L1C003R03801270534_chr1_1276582	0	61	cctg	tcac
V350256906L1C003R03801321662	chr1	1176148	50M	179	1176327	1176149	1176328	V350256906L1C003R03801321662_chr1_1176148	10	25	ATCA	AGCA
V350256906L1C003R03900112988	chr1	856611	50M	156	856767	856612	856768	V350256906L1C003R03900112988_chr1_856611	16	0	CCCA	ACGG
V350256906L1C003R03900238128	chr1	38784	50M	181	38965	38785	38966	V350256906L1C003R03900238128_chr1_38784	205	24	cctt	ccag
V350256906L1C003R03900293794	chr1	979645	50M	203	979848	979646	979849	V350256906L1C003R03900293794_chr1_979645	47	76	CTGT	CCTG
V350256906L1C003R03900490825	chr1	87693	50M	166	87859	87694	87860	V350256906L1C003R03900490825_chr1_87693	0	0	CTGC	TGCT
V350256906L1C003R03900639463	chr1	598924	50M	158	599082	598925	599083	V350256906L1C003R03900639463_chr1_598924	29	14	tatt	ctgc
V350256906L1C003R03900819722	chr1	152121	50M	157	152278	152122	152279	V350256906L1C003R03900819722_chr1_152121	274	431	cccc	ccAC
V350256906L1C003R03900849838	chr1	708802	50M	171	708973	708803	708974	V350256906L1C003R03900849838_chr1_708802	84	39	CCTA	TCTT
V350256906L1C003R04000039239	chr1	1361592	50M	175	1361767	1361593	1361768	V350256906L1C003R04000039239_chr1_1361592	9	0	CCCG	CCCT
V350256906L1C003R04000339545	chr1	1213745	50M	163	1213908	1213746	1213909	V350256906L1C003R04000339545_chr1_1213745	35	46	cacc	agaa
V350256906L1C003R04000479290	chr1	415832	50M	169	416001	415833	416002	V350256906L1C003R04000479290_chr1_415832	20	0	TCAT	CTTA
V350256906L1C003R04000562034	chr1	470023	50M	174	470197	470024	470198	V350256906L1C003R04000562034_chr1_470023	236	62	gcta	taat
V350256906L1C003R04000684503	chr1	253162	50M	151	253313	253163	253314	V350256906L1C003R04000684503_chr1_253162	64	40	CTGT	AGTA
V350256906L1C003R04000815810	chr1	1345292	50M	174	1345466	1345293	1345467	V350256906L1C003R04000815810_chr1_1345292	0	110	ggga	ctgg
V350256906L1C003R04000915666	chr1	1408430	50M	170	1408600	1408431	1408601	V350256906L1C003R04000915666_chr1_1408430	55	54	cctg	tgca
V350256906L1C003R04001104401	chr1	1003362	50M	166	1003528	1003363	1003529	V350256906L1C003R04001104401_chr1_1003362	54	58	GCAG	CAGT
V350256906L1C003R04001133807	chr1	1044806	50M	169	1044975	1044807	1044976	V350256906L1C003R04001133807_chr1_1044806	5	0	tcct	cttg
V350256906L1C003R04100234258	chr1	395156	50M	182	395338	395157	395339	V350256906L1C003R04100234258_chr1_395156	26	3	ctaa	TATT
V350256906L1C003R04100306293	chr1	17603	50M	185	17788	17604	17789	V350256906L1C003R04100306293_chr1_17603	33	6	TACA	CAGC
V350256906L1C003R04100372959	chr1	792411	50M	173	792584	792412	792585	V350256906L1C003R04100372959_chr1_792411	18	34	CATA	TCAA
V350256906L1C003R04100676941	chr1	1187312	50M	174	1187486	1187313	1187487	V350256906L1C003R04100676941_chr1_1187312	60	53	cact	gatc
V350256906L1C003R04100842770	chr1	551005	50M	174	551179	551006	551180	V350256906L1C003R04100842770_chr1_551005	0	161	CCTC	TACT
V350256906L1C003R04100956792	chr1	725400	25S25M	152	725552	725401	725553	V350256906L1C003R04100956792_chr1_725400	63	36	ccga	catt
V350256906L1C003R04101364688	chr1	64497	50M	176	64673	64498	64674	V350256906L1C003R04101364688_chr1_64497	12	158	gggc	AGTC
V350256906L1C003R04200629562	chr1	932532	50M	146	932678	932533	932679	V350256906L1C003R04200629562_chr1_932532	37	69	cgcc	CCTT
V350256906L1C003R04201070456	chr1	1214650	50M	183	1214833	1214651	1214834	V350256906L1C003R04201070456_chr1_1214650	54	61	cccc	ccag
V350256906L1C003R04201245733	chr1	917035	50M	169	917204	917036	917205	V350256906L1C003R04201245733_chr1_917035	12	35	TGGC	CCTT
V350256906L1C003R04300249737	chr1	557916	50M	188	558104	557917	558105	V350256906L1C003R04300249737_chr1_557916	49	50	CCCA	TGAG
V350256906L1C003R04300478189	chr1	722615	50M	146	722761	722616	722762	V350256906L1C003R04300478189_chr1_722615	45	39	tgca	catg
V350256906L1C003R04300562983	chr1	161386	50M	168	161554	161387	161555	V350256906L1C003R04300562983_chr1_161386	68	32	gcca	gaac
V350256906L1C003R04301157893	chr1	725655	31M19S	109	725764	725656	725765	V350256906L1C003R04301157893_chr1_725655	139	119	ttta	tcca
V350256906L1C003R04400183611	chr1	797365	50M	190	797555	797366	797556	V350256906L1C003R04400183611_chr1_797365	0	0	tgat	TCTC
V350256906L1C003R04400686528	chr1	1274113	50M	185	1274298	1274114	1274299	V350256906L1C003R04400686528_chr1_1274113	33	7	TCTG	TGCA
V350256906L1C003R04400823582	chr1	1243048	50M	179	1243227	1243049	1243228	V350256906L1C003R04400823582_chr1_1243048	94	26	gcgg	CGTG
V350256906L1C003R04400909182	chr1	39318	50M	133	39451	39319	39452	V350256906L1C003R04400909182_chr1_39318	248	312	caga	ccca
V350256906L1C003R04401256819	chr1	404484	50M	181	404665	404485	404666	V350256906L1C003R04401256819_chr1_404484	125	199	ccat	cacg
V350256906L1C003R04401359568	chr1	396448	50M	160	396608	396449	396609	V350256906L1C003R04401359568_chr1_396448	51	58	ACAT	TGTG
V350256906L1C003R04401402470	chr1	822877	50M	170	823047	822878	823048	V350256906L1C003R04401402470_chr1_822877	5	52	taat	ggtg
V350256906L1C003R04401402595	chr1	585318	50M	161	585479	585319	585480	V350256906L1C003R04401402595_chr1_585318	59	61	ccca	tggg
V350256906L1C003R04500090159	chr1	418015	50M	183	418198	418016	418199	V350256906L1C003R04500090159_chr1_418015	67	63	AGGC	CCCT
V350256906L1C003R04500242241	chr1	152056	50M	202	152258	152057	152259	V350256906L1C003R04500242241_chr1_152056	209	411	catt	tata
V350256906L1C003R04500709692	chr1	1359794	50M	155	1359949	1359795	1359950	V350256906L1C003R04500709692_chr1_1359794	0	40	CAAT	tgta
V350256906L1C003R04500923505	chr1	37564	50M	176	37740	37565	37741	V350256906L1C003R04500923505_chr1_37564	145	321	AGAT	ggtg
V350256906L1C003R04500965681	chr1	726825	27S22M1S	147	726972	726826	726973	V350256906L1C003R04500965681_chr1_726825	0	23	gaat	tcca
V350256906L1C003R04500981685	chr1	20634	50M	164	20798	20635	20799	V350256906L1C003R04500981685_chr1_20634	78	41	cagg	CAAG
V350256906L1C003R04600022185	chr1	408093	50M	162	408255	408094	408256	V350256906L1C003R04600022185_chr1_408093	37	75	CTAT	CATA
V350256906L1C003R04600034292	chr1	101417	50M	166	101583	101418	101584	V350256906L1C003R04600034292_chr1_101417	32	198	ccag	ccac
V350256906L1C003R04600749518	chr1	1099007	50M	209	1099216	1099008	1099217	V350256906L1C003R04600749518_chr1_1099007	138	46	CCTG	GCTC
V350256906L1C003R04601117851	chr1	61802	50M	176	61978	61803	61979	V350256906L1C003R04601117851_chr1_61802	18	194	gcgt	aggc
V350256906L1C003R04601353273	chr1	357011	50M	207	357218	357012	357219	V350256906L1C003R04601353273_chr1_357011	27	26	aaac	ctgc
V350256906L1C003R04601365341	chr1	1067953	50M	177	1068130	1067954	1068131	V350256906L1C003R04601365341_chr1_1067953	55	54	CAAT	cccg
V350256906L1C003R04700153221	chr1	334352	50M	163	334515	334353	334516	V350256906L1C003R04700153221_chr1_334352	6	41	atct	accc
V350256906L1C003R04700223686	chr1	874646	50M	200	874846	874647	874847	V350256906L1C003R04700223686_chr1_874646	63	76	CCCC	CTCA
V350256906L1C003R04700575292	chr1	674979	50M	134	675113	674980	675114	V350256906L1C003R04700575292_chr1_674979	16	79	GAAA	cacg
V350256906L1C003R04700686044	chr1	630742	50M	175	630917	630743	630918	V350256906L1C003R04700686044_chr1_630742	44	34	GGGA	ACGA
V350256906L1C003R04700828283	chr1	547132	50M	131	547263	547133	547264	V350256906L1C003R04700828283_chr1_547132	284	153	cgtg	AGAG
V350256906L1C003R04700868250	chr1	82672	50M	196	82868	82673	82869	V350256906L1C003R04700868250_chr1_82672	0	65	tttt	tata
V350256906L1C003R04700872118	chr1	941907	50M	194	942101	941908	942102	V350256906L1C003R04700872118_chr1_941907	254	94	TCCA	CAAA
V350256906L1C003R04701041718	chr1	927344	50M	135	927479	927345	927480	V350256906L1C003R04701041718_chr1_927344	25	70	GGtt	acat
V350256906L1C003R04800041271	chr1	747643	50M	166	747809	747644	747810	V350256906L1C003R04800041271_chr1_747643	245	114	acta	cctc
V350256906L1C003R04800042698	chr1	1363825	50M	190	1364015	1363826	1364016	V350256906L1C003R04800042698_chr1_1363825	32	17	GACA	AAAA
V350256906L1C003R04800137381	chr1	843685	50M	155	843840	843686	843841	V350256906L1C003R04800137381_chr1_843685	186	341	GGGG	GCAG
V350256906L1C003R04800308305	chr1	632480	50M	201	632681	632481	632682	V350256906L1C003R04800308305_chr1_632480	43	124	ggag	acct
V350256906L1C003R04800399578	chr1	121646	50M	186	121832	121647	121833	V350256906L1C003R04800399578_chr1_121646	26	0	taat	ATAT
V350256906L1C003R04800479107	chr1	1061279	50M	169	1061448	1061280	1061449	V350256906L1C003R04800479107_chr1_1061279	0	1	GCTC	AGTG
V350256906L1C003R04800803104	chr1	963543	50M	173	963716	963544	963717	V350256906L1C003R04800803104_chr1_963543	0	0	GCAG	gggg
V350256906L1C003R04800818417	chr1	667061	50M	171	667232	667062	667233	V350256906L1C003R04800818417_chr1_667061	164	202	gcca	TGAT
V350256906L1C003R04800867263	chr1	1317663	50M	181	1317844	1317664	1317845	V350256906L1C003R04800867263_chr1_1317663	93	274	cttc	CTGG
V350256906L1C003R04801026201	chr1	1369609	50M	175	1369784	1369610	1369785	V350256906L1C003R04801026201_chr1_1369609	21	83	CCTC	CCTC
V350256906L1C003R04801088244	chr1	358796	50M	214	359010	358797	359011	V350256906L1C003R04801088244_chr1_358796	64	111	AAAC	AATG
V350256906L1C003R04900148424	chr1	1156541	50M	197	1156738	1156542	1156739	V350256906L1C003R04900148424_chr1_1156541	61	43	ACTG	caaa
V350256906L1C003R04900434349	chr1	572563	50M	161	572724	572564	572725	V350256906L1C003R04900434349_chr1_572563	8	4	AGGA	tttc
V350256906L1C003R04900913046	chr1	769998	50M	190	770188	769999	770189	V350256906L1C003R04900913046_chr1_769998	39	47	AGGC	cccc
V350256906L1C003R04901086944	chr1	661943	50M	188	662131	661944	662132	V350256906L1C003R04901086944_chr1_661943	281	250	GGGC	CCCA
V350256906L1C003R04901126316	chr1	820998	50M	160	821158	820999	821159	V350256906L1C003R04901126316_chr1_820998	0	36	tttt	tcta
V350256906L1C003R04901144289	chr1	726186	4S46M	186	726372	726187	726373	V350256906L1C003R04901144289_chr1_726186	63	39	tgga	tttc
V350256906L1C003R05000005534	chr1	1096960	50M	141	1097101	1096961	1097102	V350256906L1C003R05000005534_chr1_1096960	43	49	CAAC	GGCC
V350256906L1C003R05000228043	chr1	1175322	50M	162	1175484	1175323	1175485	V350256906L1C003R05000228043_chr1_1175322	36	66	GCTC	CTTC
V350256906L1C003R05000449216	chr1	1186930	50M	189	1187119	1186931	1187120	V350256906L1C003R05000449216_chr1_1186930	17	55	acca	CAAC
V350256906L1C003R05000608291	chr1	744175	50M	140	744315	744176	744316	V350256906L1C003R05000608291_chr1_744175	50	58	GTTT	AGGG
V350256906L1C003R05000881757	chr1	346087	50M	166	346253	346088	346254	V350256906L1C003R05000881757_chr1_346087	72	0	catg	gagc
V350256906L1C003R05100151917	chr1	1249331	50M	154	1249485	1249332	1249486	V350256906L1C003R05100151917_chr1_1249331	0	8	GGCC	GGTT
V350256906L1C003R05100153240	chr1	1299640	50M	207	1299847	1299641	1299848	V350256906L1C003R05100153240_chr1_1299640	51	11	ctga	GACA
V350256906L1C003R05100341824	chr1	739120	50M	185	739305	739121	739306	V350256906L1C003R05100341824_chr1_739120	163	67	TATG	CTTC
V350256906L1C003R05100478644	chr1	1068154	50M	169	1068323	1068155	1068324	V350256906L1C003R05100478644_chr1_1068154	30	31	ctgc	acaa
V350256906L1C003R05100732364	chr1	1158505	50M	186	1158691	1158506	1158692	V350256906L1C003R05100732364_chr1_1158505	0	56	acga	GGCC
V350256906L1C003R05100917170	chr1	628540	50M	165	628705	628541	628706	V350256906L1C003R05100917170_chr1_628540	52	31	tcac	TTCA
V350256906L1C003R05101186553	chr1	408880	50M	150	409030	408881	409031	V350256906L1C003R05101186553_chr1_408880	59	43	cagt	taat
V350256906L1C003R05101307803	chr1	1215749	50M	170	1215919	1215750	1215920	V350256906L1C003R05101307803_chr1_1215749	71	66	cagg	cctt
V350256906L1C003R05200221986	chr1	780726	50M	170	780896	780727	780897	V350256906L1C003R05200221986_chr1_780726	58	69	CCCA	GCGC
V350256906L1C003R05200280711	chr1	885441	50M	183	885624	885442	885625	V350256906L1C003R05200280711_chr1_885441	54	45	CGTG	tgca
V350256906L1C003R05200376441	chr1	779545	50M	188	779733	779546	779734	V350256906L1C003R05200376441_chr1_779545	0	3	ggac	CCCA
V350256906L1C003R05200414156	chr1	922559	50M	153	922712	922560	922713	V350256906L1C003R05200414156_chr1_922559	0	63	cagg	ccag
V350256906L1C003R05200465962	chr1	1065303	50M	174	1065477	1065304	1065478	V350256906L1C003R05200465962_chr1_1065303	7	0	GGAC	tcct
V350256906L1C003R05201062724	chr1	1322504	50M	166	1322670	1322505	1322671	V350256906L1C003R05201062724_chr1_1322504	0	0	GCTG	AACG
V350256906L1C003R05201177243	chr1	138566	50M	166	138732	138567	138733	V350256906L1C003R05201177243_chr1_138566	78	43	GAGC	TCTG
V350256906L1C003R05201382674	chr1	575040	50M	151	575191	575041	575192	V350256906L1C003R05201382674_chr1_575040	26	40	ctct	cttg
V350256906L1C003R05300052574	chr1	323312	50M	167	323479	323313	323480	V350256906L1C003R05300052574_chr1_323312	0	75	tgag	ccct
V350256906L1C003R05300238309	chr1	979180	7S43M	164	979344	979181	979345	V350256906L1C003R05300238309_chr1_979180	25	0	CTGC	CCCG
V350256906L1C003R05300815683	chr1	815306	50M	160	815466	815307	815467	V350256906L1C003R05300815683_chr1_815306	45	101	acat	atat
V350256906L1C003R05301041838	chr1	726323	50M	176	726499	726324	726500	V350256906L1C003R05301041838_chr1_726323	32	22	ggaa	ttgc
V350256906L1C003R05301166244	chr1	44944	50M	183	45127	44945	45128	V350256906L1C003R05301166244_chr1_44944	603	420	acat	atgt
V350256906L1C003R05400031044	chr1	1308010	50M	180	1308190	1308011	1308191	V350256906L1C003R05400031044_chr1_1308010	57	44	CAGC	ggcc
V350256906L1C003R05400068557	chr1	388832	50M	168	389000	388833	389001	V350256906L1C003R05400068557_chr1_388832	50	39	caca	tatt
V350256906L1C003R05400196012	chr1	1271980	50M	201	1272181	1271981	1272182	V350256906L1C003R05400196012_chr1_1271980	132	40	GGCA	CCGC
V350256906L1C003R05400420679	chr1	64539	50M	201	64740	64540	64741	V350256906L1C003R05400420679_chr1_64539	54	91	ggag	AGGG
V350256906L1C003R05400486053	chr1	745386	50M	186	745572	745387	745573	V350256906L1C003R05400486053_chr1_745386	35	47	GAGT	TAGA
V350256906L1C003R05400785549	chr1	1064966	50M	169	1065135	1064967	1065136	V350256906L1C003R05400785549_chr1_1064966	40	17	CCAC	TACG
V350256906L1C003R05400913875	chr1	570528	50M	202	570730	570529	570731	V350256906L1C003R05400913875_chr1_570528	0	0	CACC	CTTT
V350256906L1C003R05500880713	chr1	21248	50M	188	21436	21249	21437	V350256906L1C003R05500880713_chr1_21248	103	15	TCCT	CTCA
V350256906L1C003R05600464940	chr1	722593	50M	171	722764	722594	722765	V350256906L1C003R05600464940_chr1_722593	51	42	caat	atac
V350256906L1C003R05600523199	chr1	668294	50M	189	668483	668295	668484	V350256906L1C003R05600523199_chr1_668294	55	46	acaa	GCCT
V350256906L1C003R05600546676	chr1	1294598	50M	163	1294761	1294599	1294762	V350256906L1C003R05600546676_chr1_1294598	2	142	CTCC	ATGT
V350256906L1C003R05600617338	chr1	930725	50M	166	930891	930726	930892	V350256906L1C003R05600617338_chr1_930725	0	22	ctaa	aatc
V350256906L1C003R05600698357	chr1	532730	50M	187	532917	532731	532918	V350256906L1C003R05600698357_chr1_532730	45	51	caac	atac
V350256906L1C003R05601214989	chr1	699824	50M	145	699969	699825	699970	V350256906L1C003R05601214989_chr1_699824	0	19	agcc	accg
V350256906L1C003R05700236362	chr1	687034	50M	155	687189	687035	687190	V350256906L1C003R05700236362_chr1_687034	16	0	cttg	tcaa
V350256906L1C003R05700276785	chr1	671535	32M1I17M	174	671709	671536	671710	V350256906L1C003R05700276785_chr1_671535	14	3	CCTG	ttgt
V350256906L1C003R05700354539	chr1	544411	50M	183	544594	544412	544595	V350256906L1C003R05700354539_chr1_544411	3	0	AGGG	AGAC
V350256906L1C003R05700544447	chr1	399385	50M	204	399589	399386	399590	V350256906L1C003R05700544447_chr1_399385	74	64	gcat	acat
V350256906L1C003R05700662451	chr1	1382077	50M	225	1382302	1382078	1382303	V350256906L1C003R05700662451_chr1_1382077	12	11	CATT	cagt
V350256906L1C003R05700740661	chr1	168763	50M	172	168935	168764	168936	V350256906L1C003R05700740661_chr1_168763	59	44	cctc	gggg
V350256906L1C003R05701105599	chr1	555853	50M	171	556024	555854	556025	V350256906L1C003R05701105599_chr1_555853	72	9	CCAG	agat
V350256906L1C003R05800849795	chr1	880609	31M1D19M	176	880785	880610	880786	V350256906L1C003R05800849795_chr1_880609	0	0	AGGC	GCCC
V350256906L1C003R05800904232	chr1	1181315	50M	150	1181465	1181316	1181466	V350256906L1C003R05800904232_chr1_1181315	6	0	GGAG	CCAT
V350256906L1C003R05801405217	chr1	92916	50M	218	93134	92917	93135	V350256906L1C003R05801405217_chr1_92916	75	25	ATGT	CTCT
V350256906L1C003R05900139275	chr1	1317286	50M	253	1317539	1317287	1317540	V350256906L1C003R05900139275_chr1_1317286	79	0	GGAC	ccca
V350256906L1C003R05900150870	chr1	1400927	50M	175	1401102	1400928	1401103	V350256906L1C003R05900150870_chr1_1400927	12	24	tgcc	ccta
V350256906L1C003R05900784696	chr1	654111	50M	237	654348	654112	654349	V350256906L1C003R05900784696_chr1_654111	45	227	GGCT	catt
V350256906L1C003R05901040086	chr1	1308836	50M	141	1308977	1308837	1308978	V350256906L1C003R05901040086_chr1_1308836	17	0	CCCA	CCGC
V350256906L1C003R05901254110	chr1	876394	50M	191	876585	876395	876586	V350256906L1C003R05901254110_chr1_876394	7	0	ACCA	TCCA
V350256906L1C003R06000126765	chr1	571726	50M	160	571886	571727	571887	V350256906L1C003R06000126765_chr1_571726	57	45	ggta	cgtt
V350256906L1C003R06000263938	chr1	1381869	50M	171	1382040	1381870	1382041	V350256906L1C003R06000263938_chr1_1381869	0	49	ccca	CCAC
V350256906L1C003R06000482392	chr1	1068344	50M	173	1068517	1068345	1068518	V350256906L1C003R06000482392_chr1_1068344	10	73	taac	CTCA
V350256906L1C003R06001199534	chr1	1127837	50M	206	1128043	1127838	1128044	V350256906L1C003R06001199534_chr1_1127837	0	0	GTAT	GTCT
V350256906L1C003R06100353698	chr1	453747	50M	173	453920	453748	453921	V350256906L1C003R06100353698_chr1_453747	58	0	ACCG	aact
V350256906L1C003R06100487745	chr1	463307	50M	177	463484	463308	463485	V350256906L1C003R06100487745_chr1_463307	152	0	CTTA	cctc
V350256906L1C003R06100493350	chr1	951678	50M	191	951869	951679	951870	V350256906L1C003R06100493350_chr1_951678	63	65	tgat	ccag
V350256906L1C003R06100502328	chr1	1155933	50M	161	1156094	1155934	1156095	V350256906L1C003R06100502328_chr1_1155933	48	74	CCCT	CCTA
V350256906L1C003R06100576732	chr1	541144	50M	174	541318	541145	541319	V350256906L1C003R06100576732_chr1_541144	21	23	CAAC	GCGA
V350256906L1C003R06100943067	chr1	174757	50M	172	174929	174758	174930	V350256906L1C003R06100943067_chr1_174757	72	29	ccat	tttt
V350256906L1C003R06200611615	chr1	1006495	50M	175	1006670	1006496	1006671	V350256906L1C003R06200611615_chr1_1006495	56	39	CAGG	aaaa
V350256906L1C003R06200613518	chr1	812357	50M	186	812543	812358	812544	V350256906L1C003R06200613518_chr1_812357	310	124	GGAT	GCCG
V350256906L1C003R06200625566	chr1	759257	50M	195	759452	759258	759453	V350256906L1C003R06200625566_chr1_759257	64	63	CAAC	ataa
V350256906L1C003R06200709223	chr1	732437	50M	156	732593	732438	732594	V350256906L1C003R06200709223_chr1_732437	24	111	aact	TGTT
V350256906L1C003R06200795268	chr1	85490	50M	247	85737	85491	85738	V350256906L1C003R06200795268_chr1_85490	127	65	aaca	ggct
V350256906L1C003R06201125081	chr1	266429	50M	148	266577	266430	266578	V350256906L1C003R06201125081_chr1_266429	48	63	CTAA	TGGA
V350256906L1C003R06201298167	chr1	78959	50M	158	79117	78960	79118	V350256906L1C003R06201298167_chr1_78959	0	23	ctgc	cctc
V350256906L1C003R06201325715	chr1	355689	50M	159	355848	355690	355849	V350256906L1C003R06201325715_chr1_355689	65	224	cccc	tgat
V350256906L1C003R06201334088	chr1	112319	50M	168	112487	112320	112488	V350256906L1C003R06201334088_chr1_112319	15	99	cagg	tgta
V350256906L1C003R06300048978	chr1	737990	50M	188	738178	737991	738179	V350256906L1C003R06300048978_chr1_737990	212	61	CCAC	TGTC
V350256906L1C003R06300334499	chr1	1174987	50M	196	1175183	1174988	1175184	V350256906L1C003R06300334499_chr1_1174987	0	0	GCCC	CCCG
V350256906L1C003R06300642545	chr1	244119	50M	133	244252	244120	244253	V350256906L1C003R06300642545_chr1_244119	48	0	GTAG	gaag
V350256906L1C003R06300686969	chr1	745203	50M	169	745372	745204	745373	V350256906L1C003R06300686969_chr1_745203	98	21	CAAG	TATG
V350256906L1C003R06301305947	chr1	799249	50M	181	799430	799250	799431	V350256906L1C003R06301305947_chr1_799249	20	41	TGGG	TGAT
V350256906L1C003R06301324600	chr1	997860	50M	169	998029	997861	998030	V350256906L1C003R06301324600_chr1_997860	67	69	CGAG	CCAT
V350256906L1C003R06400331072	chr1	702375	50M	165	702540	702376	702541	V350256906L1C003R06400331072_chr1_702375	149	0	AGAT	AGCA
V350256906L1C003R06400452851	chr1	460540	50M	165	460705	460541	460706	V350256906L1C003R06400452851_chr1_460540	0	0	aggg	tctt
V350256906L1C003R06400781376	chr1	725071	50M	184	725255	725072	725256	V350256906L1C003R06400781376_chr1_725071	101	14	ggaa	ttcc
V350256906L1C003R06400837496	chr1	1183227	50M	178	1183405	1183228	1183406	V350256906L1C003R06400837496_chr1_1183227	30	19	CCCT	GCCA
V350256906L1C003R06401009539	chr1	668277	50M	175	668452	668278	668453	V350256906L1C003R06401009539_chr1_668277	63	65	agtg	AGCC
V350256906L1C003R06401106396	chr1	638463	50M	146	638609	638464	638610	V350256906L1C003R06401106396_chr1_638463	75	48	ccca	ctgg
V350256906L1C003R06500270189	chr1	624522	50M	178	624700	624523	624701	V350256906L1C003R06500270189_chr1_624522	12	18	ATAT	CCTA
V350256906L1C003R06500375358	chr1	726825	31S19M	147	726972	726826	726973	V350256906L1C003R06500375358_chr1_726825	0	23	gaat	tcca
V350256906L1C003R06500716836	chr1	331939	50M	216	332155	331940	332156	V350256906L1C003R06500716836_chr1_331939	125	64	TGGG	CGTG
V350256906L1C003R06500824616	chr1	754528	50M	182	754710	754529	754711	V350256906L1C003R06500824616_chr1_754528	218	36	ctgc	GACT
V350256906L1C003R06501067841	chr1	845431	50M	169	845600	845432	845601	V350256906L1C003R06501067841_chr1_845431	25	17	GGGG	CCAG
V350256906L1C003R06501082739	chr1	577167	50M	255	577422	577168	577423	V350256906L1C003R06501082739_chr1_577167	66	140	ACCA	CCCT
V350256906L1C003R06600139181	chr1	540605	50M	161	540766	540606	540767	V350256906L1C003R06600139181_chr1_540605	17	42	cgat	tgtt
V350256906L1C003R06600169649	chr1	761050	50M	170	761220	761051	761221	V350256906L1C003R06600169649_chr1_761050	124	240	TGAA	GGTA
V350256906L1C003R06600407140	chr1	572971	50M	187	573158	572972	573159	V350256906L1C003R06600407140_chr1_572971	43	48	GCAA	ccca
V350256906L1C003R06600511576	chr1	738087	50M	200	738287	738088	738288	V350256906L1C003R06600511576_chr1_738087	152	0	CCTT	GCCC
V350256906L1C003R06600990834	chr1	40272	50M	184	40456	40273	40457	V350256906L1C003R06600990834_chr1_40272	65	43	gtgg	agag
V350256906L1C003R06601207041	chr1	109512	50M	161	109673	109513	109674	V350256906L1C003R06601207041_chr1_109512	216	55	TATG	TTAA
V350256906L1C003R06601287287	chr1	1326744	50M	101	1326845	1326745	1326846	V350256906L1C003R06601287287_chr1_1326744	109	18	CTTC	CCCA
V350256906L1C003R06601296157	chr1	1428422	50M	189	1428611	1428423	1428612	V350256906L1C003R06601296157_chr1_1428422	0	0	caga	ccaa
V350256906L1C003R06601338420	chr1	622727	50M	149	622876	622728	622877	V350256906L1C003R06601338420_chr1_622727	229	179	CCCA	CAGA
V350256906L1C003R06700026678	chr1	1239598	50M	158	1239756	1239599	1239757	V350256906L1C003R06700026678_chr1_1239598	60	55	CCCT	CCCC
V350256906L1C003R06700231571	chr1	341081	50M	167	341248	341082	341249	V350256906L1C003R06700231571_chr1_341081	59	68	CTTA	TTTT
V350256906L1C003R06700543387	chr1	696004	50M	164	696168	696005	696169	V350256906L1C003R06700543387_chr1_696004	55	33	CCCA	ATGA
V350256906L1C003R06700697175	chr1	1017752	50M	174	1017926	1017753	1017927	V350256906L1C003R06700697175_chr1_1017752	0	18	GCTG	GCCT
V350256906L1C003R06700756032	chr1	1161116	50M	160	1161276	1161117	1161277	V350256906L1C003R06700756032_chr1_1161116	18	13	caca	TGGA
V350256906L1C003R06701200567	chr1	23447	50M	167	23614	23448	23615	V350256906L1C003R06701200567_chr1_23447	142	185	TTCC	CACA
V350256906L1C003R06800404224	chr1	131918	50M	182	132100	131919	132101	V350256906L1C003R06800404224_chr1_131918	87	143	AGCA	CAGG
V350256906L1C003R06800414017	chr1	244841	50M	180	245021	244842	245022	V350256906L1C003R06800414017_chr1_244841	251	313	GCCT	CCTT
V350256906L1C003R06800432041	chr1	327717	50M	157	327874	327718	327875	V350256906L1C003R06800432041_chr1_327717	187	184	GGCC	TGGG
V350256906L1C003R06800611059	chr1	816989	50M	198	817187	816990	817188	V350256906L1C003R06800611059_chr1_816989	0	82	ATTT	TCTC
V350256906L1C003R06800712024	chr1	905613	50M	174	905787	905614	905788	V350256906L1C003R06800712024_chr1_905613	17	31	GGGG	GCAG
V350256906L1C003R06800926712	chr1	74254	50M	155	74409	74255	74410	V350256906L1C003R06800926712_chr1_74254	55	210	attt	cagg
V350256906L1C003R06800930448	chr1	585865	50M	171	586036	585866	586037	V350256906L1C003R06800930448_chr1_585865	59	52	AGGC	ctgc
V350256906L1C003R06801054401	chr1	975881	50M	173	976054	975882	976055	V350256906L1C003R06801054401_chr1_975881	171	0	CGGT	CCCG
V350256906L1C003R06801069481	chr1	728804	50M	172	728976	728805	728977	V350256906L1C003R06801069481_chr1_728804	118	29	gttc	acaa
V350256906L1C003R06900119452	chr1	167517	50M	168	167685	167518	167686	V350256906L1C003R06900119452_chr1_167517	59	71	ctat	ctct
V350256906L1C003R06900145349	chr1	348032	50M	248	348280	348033	348281	V350256906L1C003R06900145349_chr1_348032	224	19	CTGT	GACC
V350256906L1C003R06900293742	chr1	858945	50M	167	859112	858946	859113	V350256906L1C003R06900293742_chr1_858945	95	38	CCCT	GGAT
V350256906L1C003R06900569238	chr1	906112	50M	168	906280	906113	906281	V350256906L1C003R06900569238_chr1_906112	68	23	CCCG	GGAG
V350256906L1C003R06900597525	chr1	233214	50M	177	233391	233215	233392	V350256906L1C003R06900597525_chr1_233214	104	18	TGGA	ccaa
V350256906L1C003R06901036616	chr1	753683	50M	142	753825	753684	753826	V350256906L1C003R06901036616_chr1_753683	56	33	ACTG	CATG
V350256906L1C003R06901403197	chr1	32467	50M	148	32615	32468	32616	V350256906L1C003R06901403197_chr1_32467	0	106	TGCT	CCCA
V350256906L1C003R07000478641	chr1	323159	48M	163	323322	323160	323323	V350256906L1C003R07000478641_chr1_323159	0	0	gggt	ccct
V350256906L1C003R07000761424	chr1	64133	50M	196	64329	64134	64330	V350256906L1C003R07000761424_chr1_64133	56	52	TTTG	TAAA
V350256906L1C003R07000866045	chr1	933963	50M	179	934142	933964	934143	V350256906L1C003R07000866045_chr1_933963	74	64	TGCT	ccgc
V350256906L1C003R07000887566	chr1	239651	50M	171	239822	239652	239823	V350256906L1C003R07000887566_chr1_239651	32	69	agag	TGAG
V350256906L1C003R07001050404	chr1	42198	50M	170	42368	42199	42369	V350256906L1C003R07001050404_chr1_42198	350	180	catg	ACAA
V350256906L1C003R07001178904	chr1	144260	50M	181	144441	144261	144442	V350256906L1C003R07001178904_chr1_144260	162	0	ccca	ccag
V350256906L1C003R07100095692	chr1	1287710	50M	186	1287896	1287711	1287897	V350256906L1C003R07100095692_chr1_1287710	12	146	cccc	CTAG
V350256906L1C003R07100308821	chr1	67760	50M	171	67931	67761	67932	V350256906L1C003R07100308821_chr1_67760	0	26	CAAA	TAAG
V350256906L1C003R07100314298	chr1	1312290	50M	178	1312468	1312291	1312469	V350256906L1C003R07100314298_chr1_1312290	62	61	AAGG	CCAA
V350256906L1C003R07100367617	chr1	468829	50M	172	469001	468830	469002	V350256906L1C003R07100367617_chr1_468829	74	45	caga	tgct
V350256906L1C003R07100754740	chr1	1227868	50M	108	1227976	1227869	1227977	V350256906L1C003R07100754740_chr1_1227868	1	65	GGCA	CAAT
V350256906L1C003R07100815810	chr1	925089	50M	188	925277	925090	925278	V350256906L1C003R07100815810_chr1_925089	4	48	tgag	acct
V350256906L1C003R07101135474	chr1	1313217	50M	218	1313435	1313218	1313436	V350256906L1C003R07101135474_chr1_1313217	9	39	tggg	CCAA
V350256906L1C003R07101142221	chr1	1394743	50M	191	1394934	1394744	1394935	V350256906L1C003R07101142221_chr1_1394743	4	6	TGGA	ACAC
V350256906L1C003R07101235026	chr1	453428	50M	195	453623	453429	453624	V350256906L1C003R07101235026_chr1_453428	53	51	cgac	ccat
V350256906L1C003R07200226015	chr1	12583	50M	168	12751	12584	12752	V350256906L1C003R07200226015_chr1_12583	78	47	CACC	CTCC
V350256906L1C003R07200259615	chr1	1235780	50M	169	1235949	1235781	1235950	V350256906L1C003R07200259615_chr1_1235780	58	0	AGCA	GGGG
V350256906L1C003R07200317681	chr1	727753	50M	169	727922	727754	727923	V350256906L1C003R07200317681_chr1_727753	89	56	AATG	cctg
V350256906L1C003R07200506915	chr1	660971	50M	167	661138	660972	661139	V350256906L1C003R07200506915_chr1_660971	189	22	CCAG	CAAC
V350256906L1C003R07200745654	chr1	104274	50M	172	104446	104275	104447	V350256906L1C003R07200745654_chr1_104274	50	56	ACTG	ccct
V350256906L1C003R07200921848	chr1	725505	14S36M	200	725705	725506	725706	V350256906L1C003R07200921848_chr1_725505	0	178	ttga	ttcc
V350256906L1C003R07201070584	chr1	674440	50M	100	674540	674441	674541	V350256906L1C003R07201070584_chr1_674440	0	66	GGTT	CCAG
V350256906L1C003R07201154665	chr1	605408	50M	187	605595	605409	605596	V350256906L1C003R07201154665_chr1_605408	62	19	atgt	cagg
V350256906L1C004R00100037178	chr1	647088	50M	185	647273	647089	647274	V350256906L1C004R00100037178_chr1_647088	271	86	TACA	AAAT
V350256906L1C004R00100059354	chr1	753484	50M	260	753744	753485	753745	V350256906L1C004R00100059354_chr1_753484	72	0	ccac	CCCC
V350256906L1C004R00100242556	chr1	985687	50M	207	985894	985688	985895	V350256906L1C004R00100242556_chr1_985687	83	64	CACA	CCCT
V350256906L1C004R00100381313	chr1	645718	50M	176	645894	645719	645895	V350256906L1C004R00100381313_chr1_645718	0	110	ATCT	TATC
V350256906L1C004R00100629473	chr1	256504	50M	186	256690	256505	256691	V350256906L1C004R00100629473_chr1_256504	0	179	caaa	caat
V350256906L1C004R00100711309	chr1	111160	50M	248	111408	111161	111409	V350256906L1C004R00100711309_chr1_111160	79	0	cggg	CTTG
V350256906L1C004R00101028550	chr1	814714	50M	186	814900	814715	814901	V350256906L1C004R00101028550_chr1_814714	55	38	ggga	accg
V350256906L1C004R00101202664	chr1	552596	50M	166	552762	552597	552763	V350256906L1C004R00101202664_chr1_552596	0	2	caga	GCCT
V350256906L1C004R00101337608	chr1	1069062	50M	177	1069239	1069063	1069240	V350256906L1C004R00101337608_chr1_1069062	16	16	GATT	cccg
V350256906L1C004R00200060676	chr1	624733	50M	216	624949	624734	624950	V350256906L1C004R00200060676_chr1_624733	0	0	CTAA	TAAA
V350256906L1C004R00200234601	chr1	1354017	50M	133	1354150	1354018	1354151	V350256906L1C004R00200234601_chr1_1354017	6	55	caaa	ggca
V350256906L1C004R00200533946	chr1	1300388	50M	155	1300543	1300389	1300544	V350256906L1C004R00200533946_chr1_1300388	143	298	gcct	gatg
V350256906L1C004R00200687255	chr1	128650	50M	155	128805	128651	128806	V350256906L1C004R00200687255_chr1_128650	78	52	actg	tgac
V350256906L1C004R00200980840	chr1	42611	50M	204	42815	42612	42816	V350256906L1C004R00200980840_chr1_42611	0	114	CCCA	CCAG
V350256906L1C004R00201136052	chr1	1247727	50M	163	1247890	1247728	1247891	V350256906L1C004R00201136052_chr1_1247727	36	72	CTGA	CTCC
V350256906L1C004R00201177848	chr1	1347156	50M	188	1347344	1347157	1347345	V350256906L1C004R00201177848_chr1_1347156	215	254	ACAG	cctg
V350256906L1C004R00300071053	chr1	331534	50M	179	331713	331535	331714	V350256906L1C004R00300071053_chr1_331534	0	0	CATT	GGAT
V350256906L1C004R00300899336	chr1	562515	50M	164	562679	562516	562680	V350256906L1C004R00300899336_chr1_562515	8	59	gcca	CGTG
V350256906L1C004R00301056287	chr1	819434	50M	171	819605	819435	819606	V350256906L1C004R00301056287_chr1_819434	64	62	cctg	cctt
V350256906L1C004R00301133303	chr1	927491	50M	159	927650	927492	927651	V350256906L1C004R00301133303_chr1_927491	64	62	cgtt	gaga
V350256906L1C004R00301230676	chr1	1104974	50M	147	1105121	1104975	1105122	V350256906L1C004R00301230676_chr1_1104974	12	0	CCTC	CTCC
V350256906L1C004R00301271695	chr1	32075	50M	158	32233	32076	32234	V350256906L1C004R00301271695_chr1_32075	0	0	TGCC	TCAC
V350256906L1C004R00301406246	chr1	264951	50M	165	265116	264952	265117	V350256906L1C004R00301406246_chr1_264951	59	52	ccgt	tgta
V350256906L1C004R00400065984	chr1	753777	50M	175	753952	753778	753953	V350256906L1C004R00400065984_chr1_753777	0	0	TCAC	CCCA
V350256906L1C004R00400147518	chr1	796224	50M	157	796381	796225	796382	V350256906L1C004R00400147518_chr1_796224	35	62	ggtt	CCCC
V350256906L1C004R00400502297	chr1	1231784	50M	211	1231995	1231785	1231996	V350256906L1C004R00400502297_chr1_1231784	116	59	GCCT	CCCC
V350256906L1C004R00401212281	chr1	822410	22S26M2S	189	822599	822411	822600	V350256906L1C004R00401212281_chr1_822410	76	58	actt	TCTC
V350256906L1C004R00401295424	chr1	610143	50M	161	610304	610144	610305	V350256906L1C004R00401295424_chr1_610143	41	102	GGAA	CCTG
V350256906L1C004R00500204244	chr1	146560	50M	174	146734	146561	146735	V350256906L1C004R00500204244_chr1_146560	0	0	CTAC	CCTT
V350256906L1C004R00500604901	chr1	34185	50M	160	34345	34186	34346	V350256906L1C004R00500604901_chr1_34185	63	75	CAGG	CCTC
V350256906L1C004R00500972760	chr1	33469	50M	171	33640	33470	33641	V350256906L1C004R00500972760_chr1_33469	0	103	caga	aatg
V350256906L1C004R00600046370	chr1	1284941	5S45M	171	1285112	1284942	1285113	V350256906L1C004R00600046370_chr1_1284941	54	63	TCCG	CCCC
V350256906L1C004R00600321860	chr1	332801	50M	145	332946	332802	332947	V350256906L1C004R00600321860_chr1_332801	56	39	tgca	gaat
V350256906L1C004R00700079748	chr1	818658	50M	169	818827	818659	818828	V350256906L1C004R00700079748_chr1_818658	120	2	gatg	acac
V350256906L1C004R00700524220	chr1	46419	50M	136	46555	46420	46556	V350256906L1C004R00700524220_chr1_46419	117	0	gcag	tgAT
V350256906L1C004R00700620731	chr1	68133	50M	177	68310	68134	68311	V350256906L1C004R00700620731_chr1_68133	9	46	aatc	ATAG
V350256906L1C004R00700677505	chr1	1004165	50M	196	1004361	1004166	1004362	V350256906L1C004R00700677505_chr1_1004165	80	0	ggcc	CGGA
V350256906L1C004R00700801297	chr1	1267452	50M	194	1267646	1267453	1267647	V350256906L1C004R00700801297_chr1_1267452	0	77	CCCT	AGCG
V350256906L1C004R00700862745	chr1	537359	50M	178	537537	537360	537538	V350256906L1C004R00700862745_chr1_537359	231	53	CACA	GGCT
V350256906L1C004R00700903025	chr1	1097730	50M	176	1097906	1097731	1097907	V350256906L1C004R00700903025_chr1_1097730	41	33	CCAA	CCTT
V350256906L1C004R00800582298	chr1	136418	50M	155	136573	136419	136574	V350256906L1C004R00800582298_chr1_136418	10	91	CTGT	CGCT
V350256906L1C004R00800594211	chr1	1264292	50M	189	1264481	1264293	1264482	V350256906L1C004R00800594211_chr1_1264292	62	72	CCTG	CACA
V350256906L1C004R00800908273	chr1	746893	50M	187	747080	746894	747081	V350256906L1C004R00800908273_chr1_746893	61	95	TGAG	CCAC
V350256906L1C004R00801068959	chr1	753828	50M	192	754020	753829	754021	V350256906L1C004R00801068959_chr1_753828	36	32	ACCA	tcta
V350256906L1C004R00801113403	chr1	321414	50M	160	321574	321415	321575	V350256906L1C004R00801113403_chr1_321414	0	120	cgag	TAAA
V350256906L1C004R00801255837	chr1	674879	50M	172	675051	674880	675052	V350256906L1C004R00801255837_chr1_674879	40	17	GTTC	cccc
V350256906L1C004R00801380951	chr1	1246585	50M	181	1246766	1246586	1246767	V350256906L1C004R00801380951_chr1_1246585	31	44	CCTC	CCAG
V350256906L1C004R00900160030	chr1	165925	50M	187	166112	165926	166113	V350256906L1C004R00900160030_chr1_165925	0	3	GAAT	cctg
V350256906L1C004R00900164229	chr1	150209	50M	198	150407	150210	150408	V350256906L1C004R00900164229_chr1_150209	73	47	tggt	ggct
V350256906L1C004R00900239746	chr1	1153825	50M	147	1153972	1153826	1153973	V350256906L1C004R00900239746_chr1_1153825	63	63	CGCC	CCCT
V350256906L1C004R00900350586	chr1	23449	50M	153	23602	23450	23603	V350256906L1C004R00900350586_chr1_23449	144	197	CCCA	CACA
V350256906L1C004R00900416402	chr1	1060276	50M	183	1060459	1060277	1060460	V350256906L1C004R00900416402_chr1_1060276	21	4	CCCA	CCCC
V350256906L1C004R00900437893	chr1	1129766	50M	187	1129953	1129767	1129954	V350256906L1C004R00900437893_chr1_1129766	63	95	atac	gctt
V350256906L1C004R00900645480	chr1	1056290	50M	187	1056477	1056291	1056478	V350256906L1C004R00900645480_chr1_1056290	0	0	aaca	ACCG
V350256906L1C004R00900762862	chr1	1062499	50M	173	1062672	1062500	1062673	V350256906L1C004R00900762862_chr1_1062499	4	34	gcta	CGCG
V350256906L1C004R00900793450	chr1	597728	50M	180	597908	597729	597909	V350256906L1C004R00900793450_chr1_597728	57	22	ccca	aaaa
V350256906L1C004R00901078053	chr1	942347	50M	193	942540	942348	942541	V350256906L1C004R00901078053_chr1_942347	55	51	CCTG	TGTG
V350256906L1C004R00901079470	chr1	589051	50M	200	589251	589052	589252	V350256906L1C004R00901079470_chr1_589051	23	95	ggag	gtat
V350256906L1C004R00901162609	chr1	39563	50M	165	39728	39564	39729	V350256906L1C004R00901162609_chr1_39563	200	35	tgct	tgcc
V350256906L1C004R00901201179	chr1	425543	50M	177	425720	425544	425721	V350256906L1C004R00901201179_chr1_425543	39	59	caca	CACT
V350256906L1C004R00901255482	chr1	718565	50M	192	718757	718566	718758	V350256906L1C004R00901255482_chr1_718565	169	166	GGAG	ATAA
V350256906L1C004R01000792058	chr1	432364	50M	152	432516	432365	432517	V350256906L1C004R01000792058_chr1_432364	8	7	gatc	GGCA
V350256906L1C004R01001094328	chr1	725508	6S41M3S	176	725684	725509	725685	V350256906L1C004R01001094328_chr1_725508	0	168	aatg	tcca
V350256906L1C004R01001119396	chr1	230648	50M	157	230805	230649	230806	V350256906L1C004R01001119396_chr1_230648	40	81	ccca	gtcc
V350256906L1C004R01001154143	chr1	138803	50M	196	138999	138804	139000	V350256906L1C004R01001154143_chr1_138803	27	9	GGGC	AGTC
V350256906L1C004R01001162626	chr1	1363727	50M	127	1363854	1363728	1363855	V350256906L1C004R01001162626_chr1_1363727	130	3	CCAG	ACCA
V350256906L1C004R01001318952	chr1	920758	50M	110	920868	920759	920869	V350256906L1C004R01001318952_chr1_920758	24	15	ggac	ccaa
V350256906L1C004R01001345572	chr1	95415	50M	145	95560	95416	95561	V350256906L1C004R01001345572_chr1_95415	3	148	GTTA	gttg
V350256906L1C004R01100011525	chr1	854934	50M	138	855072	854935	855073	V350256906L1C004R01100011525_chr1_854934	0	57	TGCT	CGAG
V350256906L1C004R01100052887	chr1	695700	50M	143	695843	695701	695844	V350256906L1C004R01100052887_chr1_695700	0	23	CTAA	CATT
V350256906L1C004R01100551331	chr1	1099654	50M	163	1099817	1099655	1099818	V350256906L1C004R01100551331_chr1_1099654	32	56	GGTT	CGTT
V350256906L1C004R01100767762	chr1	875005	50M	153	875158	875006	875159	V350256906L1C004R01100767762_chr1_875005	55	7	CCCC	CATA
V350256906L1C004R01100917036	chr1	795272	50M	163	795435	795273	795436	V350256906L1C004R01100917036_chr1_795272	32	43	TGAA	GAAT
V350256906L1C004R01101021417	chr1	671369	50M	207	671576	671370	671577	V350256906L1C004R01101021417_chr1_671369	32	0	GCAA	AAAA
V350256906L1C004R01101371751	chr1	1368059	50M	177	1368236	1368060	1368237	V350256906L1C004R01101371751_chr1_1368059	87	37	CCCA	ACTT
V350256906L1C004R01200372181	chr1	1205983	50M	174	1206157	1205984	1206158	V350256906L1C004R01200372181_chr1_1205983	62	61	CCCA	GTTG
V350256906L1C004R01200396564	chr1	232483	50M	159	232642	232484	232643	V350256906L1C004R01200396564_chr1_232483	66	30	aaac	GTTT
V350256906L1C004R01200487961	chr1	1321114	50M	189	1321303	1321115	1321304	V350256906L1C004R01200487961_chr1_1321114	0	0	cata	ccct
V350256906L1C004R01200592226	chr1	1034522	50M	173	1034695	1034523	1034696	V350256906L1C004R01200592226_chr1_1034522	11	0	tgtt	agaa
V350256906L1C004R01200683922	chr1	99325	50M	180	99505	99326	99506	V350256906L1C004R01200683922_chr1_99325	83	64	cctg	TGTG
V350256906L1C004R01200718140	chr1	813922	50M	154	814076	813923	814077	V350256906L1C004R01200718140_chr1_813922	83	60	TACC	CAGG
V350256906L1C004R01201010235	chr1	859059	50M	263	859322	859060	859323	V350256906L1C004R01201010235_chr1_859059	0	48	CCCA	CTTG
V350256906L1C004R01201108009	chr1	48574	50M	193	48767	48575	48768	V350256906L1C004R01201108009_chr1_48574	52	53	ccta	tcag
V350256906L1C004R01300045594	chr1	164335	50M	254	164589	164336	164590	V350256906L1C004R01300045594_chr1_164335	3	36	GCCT	aaga
V350256906L1C004R01300373209	chr1	1320787	50M	169	1320956	1320788	1320957	V350256906L1C004R01300373209_chr1_1320787	17	34	cccg	ctca
V350256906L1C004R01300431797	chr1	1045813	50M	165	1045978	1045814	1045979	V350256906L1C004R01300431797_chr1_1045813	53	52	ggaa	AGTG
V350256906L1C004R01300547716	chr1	58700	50M	157	58857	58701	58858	V350256906L1C004R01300547716_chr1_58700	220	63	GAAA	ATTT
V350256906L1C004R01300591304	chr1	814004	50M	139	814143	814005	814144	V350256906L1C004R01300591304_chr1_814004	1	95	CTGT	CCCA
V350256906L1C004R01300841522	chr1	1101588	50M	203	1101791	1101589	1101792	V350256906L1C004R01300841522_chr1_1101588	96	50	CGGC	CAGG
V350256906L1C004R01301308292	chr1	995085	50M	143	995228	995086	995229	V350256906L1C004R01301308292_chr1_995085	2	0	CGCG	CCTG
V350256906L1C004R01400126647	chr1	883216	50M	176	883392	883217	883393	V350256906L1C004R01400126647_chr1_883216	58	70	TGCT	ACTG
V350256906L1C004R01400207448	chr1	469625	50M	193	469818	469626	469819	V350256906L1C004R01400207448_chr1_469625	2	195	cttt	cccg
V350256906L1C004R01400840085	chr1	916782	50M	224	917006	916783	917007	V350256906L1C004R01400840085_chr1_916782	71	41	CACC	TGGC
V350256906L1C004R01400945340	chr1	1102649	50M	163	1102812	1102650	1102813	V350256906L1C004R01400945340_chr1_1102649	50	54	CCGC	CCAG
V350256906L1C004R01500356458	chr1	679843	50M	183	680026	679844	680027	V350256906L1C004R01500356458_chr1_679843	1	184	CCCA	cctg
V350256906L1C004R01500605914	chr1	97811	50M	203	98014	97812	98015	V350256906L1C004R01500605914_chr1_97811	68	84	cttc	ctgc
V350256906L1C004R01500907535	chr1	1387074	50M	191	1387265	1387075	1387266	V350256906L1C004R01500907535_chr1_1387074	149	0	TGTG	GCCG
V350256906L1C004R01501243250	chr1	1055247	50M	172	1055419	1055248	1055420	V350256906L1C004R01501243250_chr1_1055247	52	56	ccat	ggtt
V350256906L1C004R01600111865	chr1	694657	50M	169	694826	694658	694827	V350256906L1C004R01600111865_chr1_694657	281	112	ctac	ttga
V350256906L1C004R01600379624	chr1	724327	50M	178	724505	724328	724506	V350256906L1C004R01600379624_chr1_724327	20	198	ggat	ttcc
V350256906L1C004R01600460537	chr1	150745	50M	167	150912	150746	150913	V350256906L1C004R01600460537_chr1_150745	51	0	catc	gaga
V350256906L1C004R01600552780	chr1	1019260	50M	162	1019422	1019261	1019423	V350256906L1C004R01600552780_chr1_1019260	26	10	GTGT	CCCC
V350256906L1C004R01600667938	chr1	231008	50M	169	231177	231009	231178	V350256906L1C004R01600667938_chr1_231008	14	54	cccg	taca
V350256906L1C004R01600850182	chr1	967811	50M	152	967963	967812	967964	V350256906L1C004R01600850182_chr1_967811	209	57	GACA	CACA
V350256906L1C004R01600870228	chr1	905948	50M	198	906146	905949	906147	V350256906L1C004R01600870228_chr1_905948	54	78	CCAG	CAAA
V350256906L1C004R01601043195	chr1	36217	50M	159	36376	36218	36377	V350256906L1C004R01601043195_chr1_36217	9	37	AAGG	GCCA
V350256906L1C004R01700147876	chr1	987939	50M	156	988095	987940	988096	V350256906L1C004R01700147876_chr1_987939	47	68	gAGG	tata
V350256906L1C004R01701068963	chr1	1314459	15M1D35M	172	1314631	1314460	1314632	V350256906L1C004R01701068963_chr1_1314459	2	141	ATCA	tttg
V350256906L1C004R01800351723	chr1	875224	50M	178	875402	875225	875403	V350256906L1C004R01800351723_chr1_875224	69	65	GGCC	GGCT
V350256906L1C004R01800646481	chr1	143261	50M	166	143427	143262	143428	V350256906L1C004R01800646481_chr1_143261	91	257	gctc	tggt
V350256906L1C004R01801144451	chr1	106297	50M	164	106461	106298	106462	V350256906L1C004R01801144451_chr1_106297	171	7	GTTT	ctac
V350256906L1C004R01801230641	chr1	1349084	50M	213	1349297	1349085	1349298	V350256906L1C004R01801230641_chr1_1349084	58	51	ccca	agct
V350256906L1C004R01900298445	chr1	1393984	50M	181	1394165	1393985	1394166	V350256906L1C004R01900298445_chr1_1393984	0	0	gtag	cacc
V350256906L1C004R01900467904	chr1	891560	50M	183	891743	891561	891744	V350256906L1C004R01900467904_chr1_891560	54	6	TACC	TATC
V350256906L1C004R01900748725	chr1	854103	50M	202	854305	854104	854306	V350256906L1C004R01900748725_chr1_854103	71	59	TGAG	CTTC
V350256906L1C004R01900752703	chr1	726825	31S19M	147	726972	726826	726973	V350256906L1C004R01900752703_chr1_726825	0	23	gaat	tcca
V350256906L1C004R01900791644	chr1	36064	50M	154	36218	36065	36219	V350256906L1C004R01900791644_chr1_36064	162	8	CCGA	TCCA
V350256906L1C004R01900825073	chr1	1096028	50M	169	1096197	1096029	1096198	V350256906L1C004R01900825073_chr1_1096028	0	69	GCCT	GGGC
V350256906L1C004R01901255579	chr1	557175	50M	184	557359	557176	557360	V350256906L1C004R01901255579_chr1_557175	248	280	TGTG	AGAG
V350256906L1C004R02000089601	chr1	1105338	50M	175	1105513	1105339	1105514	V350256906L1C004R02000089601_chr1_1105338	5	1	GCAA	TCAT
V350256906L1C004R02000256876	chr1	668230	50M	171	668401	668231	668402	V350256906L1C004R02000256876_chr1_668230	16	14	ggaa	CCTG
V350256906L1C004R02000292158	chr1	638111	50M	162	638273	638112	638274	V350256906L1C004R02000292158_chr1_638111	15	83	GTTT	ccct
V350256906L1C004R02000321245	chr1	744713	50M	154	744867	744714	744868	V350256906L1C004R02000321245_chr1_744713	49	21	cagt	ttat
V350256906L1C004R02000537070	chr1	1116892	50M	177	1117069	1116893	1117070	V350256906L1C004R02000537070_chr1_1116892	73	242	CCCG	GGAG
V350256906L1C004R02000605969	chr1	997676	50M	178	997854	997677	997855	V350256906L1C004R02000605969_chr1_997676	64	73	TGCC	CATG
V350256906L1C004R02000609225	chr1	1074035	50M	246	1074281	1074036	1074282	V350256906L1C004R02000609225_chr1_1074035	18	74	TGGT	CTAG
V350256906L1C004R02000695487	chr1	1117995	50M	182	1118177	1117996	1118178	V350256906L1C004R02000695487_chr1_1117995	38	0	CTGA	CCTC
V350256906L1C004R02000988410	chr1	107416	50M	174	107590	107417	107591	V350256906L1C004R02000988410_chr1_107416	63	59	GGAA	cctt
V350256906L1C004R02001098837	chr1	886071	50M	185	886256	886072	886257	V350256906L1C004R02001098837_chr1_886071	0	20	ccag	TGCC
V350256906L1C004R02001162929	chr1	745246	50M	150	745396	745247	745397	V350256906L1C004R02001162929_chr1_745246	55	45	CTTA	TAAA
V350256906L1C004R02100278968	chr1	750397	50M	134	750531	750398	750532	V350256906L1C004R02100278968_chr1_750397	8	39	AATC	GTAA
V350256906L1C004R02100613442	chr1	523534	50M	164	523698	523535	523699	V350256906L1C004R02100613442_chr1_523534	8	172	CTGC	CTGA
V350256906L1C004R02100822652	chr1	667182	50M	131	667313	667183	667314	V350256906L1C004R02100822652_chr1_667182	252	121	tgtg	TTTA
V350256906L1C004R02101092522	chr1	449713	50M	183	449896	449714	449897	V350256906L1C004R02101092522_chr1_449713	130	23	GGCA	AGCA
V350256906L1C004R02101177275	chr1	379542	50M	165	379707	379543	379708	V350256906L1C004R02101177275_chr1_379542	70	67	CCCT	tgtc
V350256906L1C004R02200275936	chr1	750112	50M	188	750300	750113	750301	V350256906L1C004R02200275936_chr1_750112	64	97	CAGC	CTGT
V350256906L1C004R02200279670	chr1	837490	50M	143	837633	837491	837634	V350256906L1C004R02200279670_chr1_837490	8	42	CCTC	CCTG
V350256906L1C004R02201283981	chr1	1365021	50M	142	1365163	1365022	1365164	V350256906L1C004R02201283981_chr1_1365021	15	77	ccaa	GCCA
V350256906L1C004R02201298161	chr1	831509	50M	182	831691	831510	831692	V350256906L1C004R02201298161_chr1_831509	54	95	gttt	actt
V350256906L1C004R02300322599	chr1	371337	50M	152	371489	371338	371490	V350256906L1C004R02300322599_chr1_371337	5	33	CATC	CAAG
V350256906L1C004R02300828450	chr1	412955	50M	166	413121	412956	413122	V350256906L1C004R02300828450_chr1_412955	303	137	CCTT	CAGG
V350256906L1C004R02301045384	chr1	1390551	50M	179	1390730	1390552	1390731	V350256906L1C004R02301045384_chr1_1390551	74	42	cacg	CCAG
V350256906L1C004R02301177201	chr1	925371	50M	168	925539	925372	925540	V350256906L1C004R02301177201_chr1_925371	11	0	tttt	ccgg
V350256906L1C004R02301212574	chr1	589359	50M	184	589543	589360	589544	V350256906L1C004R02301212574_chr1_589359	0	0	tttt	aaca
V350256906L1C004R02301382558	chr1	817183	50M	194	817377	817184	817378	V350256906L1C004R02301382558_chr1_817183	78	272	GAGA	AGAA
V350256906L1C004R02301402583	chr1	570339	50M	150	570489	570340	570490	V350256906L1C004R02301402583_chr1_570339	8	0	TCAA	GCTA
V350256906L1C004R02400422669	chr1	1333251	50M	196	1333447	1333252	1333448	V350256906L1C004R02400422669_chr1_1333251	69	46	aaaa	CAGT
V350256906L1C004R02400603617	chr1	634107	50M	160	634267	634108	634268	V350256906L1C004R02400603617_chr1_634107	197	37	ccac	tgag
V350256906L1C004R02400658518	chr1	241127	50M	164	241291	241128	241292	V350256906L1C004R02400658518_chr1_241127	37	42	aaag	cttg
V350256906L1C004R02400694328	chr1	621545	50M	221	621766	621546	621767	V350256906L1C004R02400694328_chr1_621545	0	28	CAAG	AGTC
V350256906L1C004R02400779180	chr1	53959	50M	186	54145	53960	54146	V350256906L1C004R02400779180_chr1_53959	0	35	AGAC	TTAT
V350256906L1C004R02400956500	chr1	240420	50M	156	240576	240421	240577	V350256906L1C004R02400956500_chr1_240420	248	92	cccc	gaga
V350256906L1C004R02401122014	chr1	588126	50M	150	588276	588127	588277	V350256906L1C004R02401122014_chr1_588126	0	24	caaa	tctt
V350256906L1C004R02500338290	chr1	972126	50M	168	972294	972127	972295	V350256906L1C004R02500338290_chr1_972126	58	64	CCCA	CCCA
V350256906L1C004R02500460227	chr1	443164	50M	174	443338	443165	443339	V350256906L1C004R02500460227_chr1_443164	11	0	ggag	caag
V350256906L1C004R02500911159	chr1	1066949	50M	170	1067119	1066950	1067120	V350256906L1C004R02500911159_chr1_1066949	109	35	acca	CAAC
V350256906L1C004R02501028029	chr1	429361	50M	167	429528	429362	429529	V350256906L1C004R02501028029_chr1_429361	68	57	CTTG	TCCC
V350256906L1C004R02501242858	chr1	22881	50M	171	23052	22882	23053	V350256906L1C004R02501242858_chr1_22881	167	0	CAAG	CAAA
V350256906L1C004R02600091660	chr1	1202465	50M	170	1202635	1202466	1202636	V350256906L1C004R02600091660_chr1_1202465	118	127	cacc	TACT
V350256906L1C004R02600107331	chr1	700466	50M	243	700709	700467	700710	V350256906L1C004R02600107331_chr1_700466	126	19	tgcg	AAAG
V350256906L1C004R02600467030	chr1	60278	50M	201	60479	60279	60480	V350256906L1C004R02600467030_chr1_60278	0	26	GTTC	gcca
V350256906L1C004R02600700252	chr1	1084319	50M	156	1084475	1084320	1084476	V350256906L1C004R02600700252_chr1_1084319	0	7	GAAG	CGGG
V350256906L1C004R02600710702	chr1	1105221	50M	174	1105395	1105222	1105396	V350256906L1C004R02600710702_chr1_1105221	69	24	AGCT	CCCT
V350256906L1C004R02600822619	chr1	1302720	34M3I13M	188	1302908	1302721	1302909	V350256906L1C004R02600822619_chr1_1302720	89	24	gaat	cacc
V350256906L1C004R02601010115	chr1	662212	50M	225	662437	662213	662438	V350256906L1C004R02601010115_chr1_662212	169	39	AGTG	CTGC
V350256906L1C004R02601047600	chr1	1195392	50M	175	1195567	1195393	1195568	V350256906L1C004R02601047600_chr1_1195392	45	41	AAAA	CGCC
V350256906L1C004R02601196472	chr1	1226286	50M	145	1226431	1226287	1226432	V350256906L1C004R02601196472_chr1_1226286	57	40	GGCC	AGGC
V350256906L1C004R02700610226	chr1	698484	50M	154	698638	698485	698639	V350256906L1C004R02700610226_chr1_698484	44	30	ccca	TATG
V350256906L1C004R02700688741	chr1	1110386	50M	185	1110571	1110387	1110572	V350256906L1C004R02700688741_chr1_1110386	0	0	ctca	CACA
V350256906L1C004R02700781010	chr1	906700	50M	169	906869	906701	906870	V350256906L1C004R02700781010_chr1_906700	33	31	CCAG	TACA
V350256906L1C004R02700983703	chr1	354530	50M	164	354694	354531	354695	V350256906L1C004R02700983703_chr1_354530	150	0	agag	cttg
V350256906L1C004R02800233584	chr1	523725	50M	138	523863	523726	523864	V350256906L1C004R02800233584_chr1_523725	199	185	AGCC	AAAA
V350256906L1C004R02800673511	chr1	14427	50M	202	14629	14428	14630	V350256906L1C004R02800673511_chr1_14427	58	36	TGGT	GACA
V350256906L1C004R02800822442	chr1	357842	50M	168	358010	357843	358011	V350256906L1C004R02800822442_chr1_357842	64	73	taag	ccca
V350256906L1C004R02900150977	chr1	1238468	50M	179	1238647	1238469	1238648	V350256906L1C004R02900150977_chr1_1238468	0	5	CGCC	AGTG
V350256906L1C004R02900172398	chr1	86182	50M	168	86350	86183	86351	V350256906L1C004R02900172398_chr1_86182	47	90	ctct	tcaa
V350256906L1C004R02900407282	chr1	65657	50M	179	65836	65658	65837	V350256906L1C004R02900407282_chr1_65657	0	161	AGTA	CCCA
V350256906L1C004R02901152954	chr1	702550	50M	190	702740	702551	702741	V350256906L1C004R02901152954_chr1_702550	0	0	TGAG	TGAT
V350256906L1C004R02901206269	chr1	715638	50M	133	715771	715639	715772	V350256906L1C004R02901206269_chr1_715638	58	55	GGGt	tgta
V350256906L1C004R03000253975	chr1	881749	50M	166	881915	881750	881916	V350256906L1C004R03000253975_chr1_881749	4	0	CCTC	CCTC
V350256906L1C004R03000310812	chr1	726169	50M	189	726358	726170	726359	V350256906L1C004R03000310812_chr1_726169	80	53	aatg	attc
V350256906L1C004R03000444164	chr1	1348904	50M	173	1349077	1348905	1349078	V350256906L1C004R03000444164_chr1_1348904	56	51	ctta	tgta
V350256906L1C004R03000633529	chr1	868641	50M	176	868817	868642	868818	V350256906L1C004R03000633529_chr1_868641	52	33	GCTC	CCTA
V350256906L1C004R03000926077	chr1	363581	50M	185	363766	363582	363767	V350256906L1C004R03000926077_chr1_363581	0	0	ccct	GGCC
V350256906L1C004R03001156503	chr1	1332251	50M	171	1332422	1332252	1332423	V350256906L1C004R03001156503_chr1_1332251	61	58	ccca	ggtg
V350256906L1C004R03100092633	chr1	1393074	50M	169	1393243	1393075	1393244	V350256906L1C004R03100092633_chr1_1393074	25	0	tttt	ctac
V350256906L1C004R03100563927	chr1	61319	32M1D18M	192	61511	61320	61512	V350256906L1C004R03100563927_chr1_61319	0	58	CCTT	CTTA
V350256906L1C004R03101036609	chr1	467948	50M	160	468108	467949	468109	V350256906L1C004R03101036609_chr1_467948	116	7	ggta	ccca
V350256906L1C004R03101392461	chr1	265476	50M	166	265642	265477	265643	V350256906L1C004R03101392461_chr1_265476	113	35	AATA	AATT
V350256906L1C004R03200342466	chr1	931768	50M	186	931954	931769	931955	V350256906L1C004R03200342466_chr1_931768	80	187	GAGG	CCTG
V350256906L1C004R03200635706	chr1	949051	50M	220	949271	949052	949272	V350256906L1C004R03200635706_chr1_949051	50	53	AGCG	GACA
V350256906L1C004R03200690906	chr1	458669	32M14D18M	213	458882	458670	458883	V350256906L1C004R03200690906_chr1_458669	23	14	aaaa	tgag
V350256906L1C004R03200691761	chr1	683938	50M	170	684108	683939	684109	V350256906L1C004R03200691761_chr1_683938	82	39	ccca	ctat
V350256906L1C004R03200827738	chr1	124780	50M	145	124925	124781	124926	V350256906L1C004R03200827738_chr1_124780	265	129	aggc	CTAA
V350256906L1C004R03200952589	chr1	820764	50M	166	820930	820765	820931	V350256906L1C004R03200952589_chr1_820764	57	64	caca	aaca
V350256906L1C004R03201171545	chr1	1411778	50M	165	1411943	1411779	1411944	V350256906L1C004R03201171545_chr1_1411778	70	69	CTCT	cact
V350256906L1C004R03201267316	chr1	26414	50M	170	26584	26415	26585	V350256906L1C004R03201267316_chr1_26414	18	0	AGAT	gCAG
V350256906L1C004R03201360964	chr1	93629	50M	148	93777	93630	93778	V350256906L1C004R03201360964_chr1_93629	31	83	TGCT	ggtg
V350256906L1C004R03300025576	chr1	866995	50M	172	867167	866996	867168	V350256906L1C004R03300025576_chr1_866995	44	82	TCAT	CCTG
V350256906L1C004R03300853858	chr1	97939	50M	164	98103	97940	98104	V350256906L1C004R03300853858_chr1_97939	9	173	agag	ATAC
V350256906L1C004R03300897503	chr1	1043561	50M	179	1043740	1043562	1043741	V350256906L1C004R03300897503_chr1_1043561	0	130	CACC	CCAA
V350256906L1C004R03300908403	chr1	923674	50M	164	923838	923675	923839	V350256906L1C004R03300908403_chr1_923674	0	25	aaag	catg
V350256906L1C004R03400009121	chr1	82104	50M	132	82236	82105	82237	V350256906L1C004R03400009121_chr1_82104	56	23	agaa	aacc
V350256906L1C004R03400021503	chr1	12164	50M	163	12327	12165	12328	V350256906L1C004R03400021503_chr1_12164	41	2	GGCA	TGGG
V350256906L1C004R03400230164	chr1	1314412	50M	182	1314594	1314413	1314595	V350256906L1C004R03400230164_chr1_1314412	49	104	AATC	gcca
V350256906L1C004R03400349501	chr1	107021	50M	144	107165	107022	107166	V350256906L1C004R03400349501_chr1_107021	78	32	CACA	GTTC
V350256906L1C004R03400429573	chr1	1110235	50M	166	1110401	1110236	1110402	V350256906L1C004R03400429573_chr1_1110235	42	1	cgcc	cctc
V350256906L1C004R03400451735	chr1	150369	50M	148	150517	150370	150518	V350256906L1C004R03400451735_chr1_150369	45	27	tcaa	gcaa
V350256906L1C004R03400685711	chr1	639127	50M	148	639275	639128	639276	V350256906L1C004R03400685711_chr1_639127	8	0	GAAA	AAAT
V350256906L1C004R03400780930	chr1	956189	50M	131	956320	956190	956321	V350256906L1C004R03400780930_chr1_956189	44	28	CCAA	CAGG
V350256906L1C004R03400940586	chr1	806412	50M	175	806587	806413	806588	V350256906L1C004R03400940586_chr1_806412	62	57	AGTG	taaa
V350256906L1C004R03401403693	chr1	627976	50M	187	628163	627977	628164	V350256906L1C004R03401403693_chr1_627976	96	36	GAAA	CATG
V350256906L1C004R03401406765	chr1	1033867	50M	161	1034028	1033868	1034029	V350256906L1C004R03401406765_chr1_1033867	46	71	taat	aaac
V350256906L1C004R03500095302	chr1	670646	50M	176	670822	670647	670823	V350256906L1C004R03500095302_chr1_670646	27	0	TTCT	agag
V350256906L1C004R03500657228	chr1	1063317	50M	150	1063467	1063318	1063468	V350256906L1C004R03500657228_chr1_1063317	0	32	CCCT	TCAG
V350256906L1C004R03500722452	chr1	618738	50M	165	618903	618739	618904	V350256906L1C004R03500722452_chr1_618738	0	27	ttaa	tgct
V350256906L1C004R03500952394	chr1	149109	50M	167	149276	149110	149277	V350256906L1C004R03500952394_chr1_149109	0	11	cttt	TTTC
V350256906L1C004R03501183169	chr1	1162908	50M	157	1163065	1162909	1163066	V350256906L1C004R03501183169_chr1_1162908	18	3	CGCA	GGTG
V350256906L1C004R03600931885	chr1	113313	50M	141	113454	113314	113455	V350256906L1C004R03600931885_chr1_113313	172	33	AGTC	ACCA
V350256906L1C004R03601066141	chr1	104907	50M	178	105085	104908	105086	V350256906L1C004R03601066141_chr1_104907	0	16	ctag	CACT
V350256906L1C004R03601268864	chr1	623528	50M	178	623706	623529	623707	V350256906L1C004R03601268864_chr1_623528	403	272	ATCA	GGCA
V350256906L1C004R03601323661	chr1	821303	23M4D27M	181	821484	821304	821485	V350256906L1C004R03601323661_chr1_821303	66	31	tgtt	cttg
V350256906L1C004R03601377728	chr1	731886	50M	148	732034	731887	732035	V350256906L1C004R03601377728_chr1_731886	30	58	TAAA	ctag
V350256906L1C004R03700757482	chr1	1276552	50M	180	1276732	1276553	1276733	V350256906L1C004R03700757482_chr1_1276552	30	89	cctg	cctg
V350256906L1C004R03700769734	chr1	173412	50M	176	173588	173413	173589	V350256906L1C004R03700769734_chr1_173412	32	4	CACA	ACAT
V350256906L1C004R03700980544	chr1	1063182	50M	172	1063354	1063183	1063355	V350256906L1C004R03700980544_chr1_1063182	43	21	AGGA	CTGG
V350256906L1C004R03701002918	chr1	1411046	50M	178	1411224	1411047	1411225	V350256906L1C004R03701002918_chr1_1411046	59	92	CACT	CTGG
V350256906L1C004R03800133722	chr1	725510	10S40M	147	725657	725511	725658	V350256906L1C004R03800133722_chr1_725510	0	141	tgga	aatt
V350256906L1C004R03800280512	chr1	248175	50M	189	248364	248176	248365	V350256906L1C004R03800280512_chr1_248175	232	43	tttg	actg
V350256906L1C004R03800849716	chr1	229260	50M	161	229421	229261	229422	V350256906L1C004R03800849716_chr1_229260	4	18	agaa	ctga
V350256906L1C004R03800887193	chr1	652327	50M	175	652502	652328	652503	V350256906L1C004R03800887193_chr1_652327	45	41	aaat	ggat
V350256906L1C004R03800938401	chr1	824128	50M	181	824309	824129	824310	V350256906L1C004R03800938401_chr1_824128	55	53	GTTT	ACAG
V350256906L1C004R03801036294	chr1	1428977	50M	177	1429154	1428978	1429155	V350256906L1C004R03801036294_chr1_1428977	0	0	gtga	ggat
V350256906L1C004R03801070575	chr1	1119381	50M	190	1119571	1119382	1119572	V350256906L1C004R03801070575_chr1_1119381	148	338	CATG	TTCT
V350256906L1C004R03900287751	chr1	1051311	50M	156	1051467	1051312	1051468	V350256906L1C004R03900287751_chr1_1051311	54	73	TCCC	CGAA
V350256906L1C004R03900308241	chr1	95420	50M	160	95580	95421	95581	V350256906L1C004R03900308241_chr1_95420	8	168	TTTA	CCCA
V350256906L1C004R03900476418	chr1	789372	50M	185	789557	789373	789558	V350256906L1C004R03900476418_chr1_789372	260	82	CCAT	TGTT
V350256906L1C004R03900722353	chr1	1099284	50M	173	1099457	1099285	1099458	V350256906L1C004R03900722353_chr1_1099284	20	38	GCTG	TAAA
V350256906L1C004R03901224411	chr1	42334	50M	172	42506	42335	42507	V350256906L1C004R03901224411_chr1_42334	214	42	AGAT	Tagt
V350256906L1C004R04000299444	chr1	136787	50M	183	136970	136788	136971	V350256906L1C004R04000299444_chr1_136787	305	190	GCAA	CTCC
V350256906L1C004R04000880978	chr1	970895	50M	176	971071	970896	971072	V350256906L1C004R04000880978_chr1_970895	0	16	CGCC	TGCT
V350256906L1C004R04001317140	chr1	933985	50M	164	934149	933986	934150	V350256906L1C004R04001317140_chr1_933985	52	57	ACCG	ctcc
V350256906L1C004R04100350168	chr1	1261577	50M	175	1261752	1261578	1261753	V350256906L1C004R04100350168_chr1_1261577	56	46	GGAG	TCTG
V350256906L1C004R04100530899	chr1	645802	50M	128	645930	645803	645931	V350256906L1C004R04100530899_chr1_645802	18	146	TCtt	ACTA
V350256906L1C004R04100536039	chr1	175715	50M	174	175889	175716	175890	V350256906L1C004R04100536039_chr1_175715	64	96	cctg	tagg
V350256906L1C004R04100732337	chr1	1189842	50M	168	1190010	1189843	1190011	V350256906L1C004R04100732337_chr1_1189842	65	66	CCCC	ATTC
V350256906L1C004R04100985320	chr1	159224	50M	173	159397	159225	159398	V350256906L1C004R04100985320_chr1_159224	56	229	CCAG	ccca
V350256906L1C004R04101074991	chr1	1207059	50M	180	1207239	1207060	1207240	V350256906L1C004R04101074991_chr1_1207059	184	4	aaaa	ggga
V350256906L1C004R04101221885	chr1	19467	50M	187	19654	19468	19655	V350256906L1C004R04101221885_chr1_19467	185	0	GCTG	GCCA
V350256906L1C004R04101256769	chr1	1068000	50M	171	1068171	1068001	1068172	V350256906L1C004R04101256769_chr1_1068000	8	13	GTGC	ctga
V350256906L1C004R04200144544	chr1	246213	50M	191	246404	246214	246405	V350256906L1C004R04200144544_chr1_246213	55	28	aata	taca
V350256906L1C004R04200700538	chr1	958534	50M	183	958717	958535	958718	V350256906L1C004R04200700538_chr1_958534	16	52	GGAT	CACA
V350256906L1C004R04201174446	chr1	967181	50M	192	967373	967182	967374	V350256906L1C004R04201174446_chr1_967181	24	0	CCAT	CCAG
V350256906L1C004R04201249811	chr1	1028921	50M	174	1029095	1028922	1029096	V350256906L1C004R04201249811_chr1_1028921	76	57	GACC	cagg
V350256906L1C004R04201377894	chr1	725928	45M5S	216	726144	725929	726145	V350256906L1C004R04201377894_chr1_725928	3	105	actc	ccat
V350256906L1C004R04300332456	chr1	827527	50M	152	827679	827528	827680	V350256906L1C004R04300332456_chr1_827527	17	0	tatt	ttta
V350256906L1C004R04300349475	chr1	170900	50M	164	171064	170901	171065	V350256906L1C004R04300349475_chr1_170900	482	318	ctta	agag
V350256906L1C004R04300406319	chr1	534905	50M	192	535097	534906	535098	V350256906L1C004R04300406319_chr1_534905	164	170	ctcg	tctc
V350256906L1C004R04300744914	chr1	93989	50M	195	94184	93990	94185	V350256906L1C004R04300744914_chr1_93989	53	31	ccca	tgaa
V350256906L1C004R04300921106	chr1	543657	50M	165	543822	543658	543823	V350256906L1C004R04300921106_chr1_543657	100	41	GGAT	CTTG
V350256906L1C004R04400162755	chr1	435165	50M	214	435379	435166	435380	V350256906L1C004R04400162755_chr1_435165	8	26	AGAG	CTGG
V350256906L1C004R04400595173	chr1	548918	50M	171	549089	548919	549090	V350256906L1C004R04400595173_chr1_548918	52	2	TATG	TGTT
V350256906L1C004R04400642004	chr1	36625	50M	124	36749	36626	36750	V350256906L1C004R04400642004_chr1_36625	0	38	AGAC	CATA
V350256906L1C004R04400749323	chr1	119433	50M	168	119601	119434	119602	V350256906L1C004R04400749323_chr1_119433	24	0	TCtt	gcag
V350256906L1C004R04401008051	chr1	965701	6M2I42M	161	965862	965702	965863	V350256906L1C004R04401008051_chr1_965701	174	39	tggt	CCAT
V350256906L1C004R04500000957	chr1	17340	50M	172	17512	17341	17513	V350256906L1C004R04500000957_chr1_17340	31	41	GGGG	CCAG
V350256906L1C004R04500265029	chr1	141608	39M	179	141787	141609	141788	V350256906L1C004R04500265029_chr1_141608	59	14	cttt	gtat
V350256906L1C004R04500354569	chr1	547488	50M	167	547655	547489	547656	V350256906L1C004R04500354569_chr1_547488	0	148	tgtg	ACAC
V350256906L1C004R04500708369	chr1	747661	50M	180	747841	747662	747842	V350256906L1C004R04500708369_chr1_747661	262	82	ctca	tatg
V350256906L1C004R04500764535	chr1	943408	50M	191	943599	943409	943600	V350256906L1C004R04500764535_chr1_943408	170	0	ctgg	CCAG
V350256906L1C004R04500943247	chr1	679459	50M	171	679630	679460	679631	V350256906L1C004R04500943247_chr1_679459	95	0	tatg	TCCT
V350256906L1C004R04500975024	chr1	1295950	50M	178	1296128	1295951	1296129	V350256906L1C004R04500975024_chr1_1295950	66	55	GGGA	CCAG
V350256906L1C004R04600312020	chr1	1068504	50M	158	1068662	1068505	1068663	V350256906L1C004R04600312020_chr1_1068504	86	42	CCTG	CCAC
V350256906L1C004R04700149985	chr1	1092074	50M	160	1092234	1092075	1092235	V350256906L1C004R04700149985_chr1_1092074	42	55	ACAG	CCTT
V350256906L1C004R04700249376	chr1	257906	50M	199	258105	257907	258106	V350256906L1C004R04700249376_chr1_257906	8	0	AGTA	TGTA
V350256906L1C004R04700307933	chr1	1308998	50M	179	1309177	1308999	1309178	V350256906L1C004R04700307933_chr1_1308998	1	0	GGAC	GGCG
V350256906L1C004R04700607851	chr1	231947	50M	172	232119	231948	232120	V350256906L1C004R04700607851_chr1_231947	67	66	tgtg	gaat
V350256906L1C004R04700915068	chr1	237161	50M	170	237331	237162	237332	V350256906L1C004R04700915068_chr1_237161	76	69	CCTC	tctt
V350256906L1C004R04701049111	chr1	671679	50M	159	671838	671680	671839	V350256906L1C004R04701049111_chr1_671679	0	132	acaa	CATC
V350256906L1C004R04701130309	chr1	666108	50M	167	666275	666109	666276	V350256906L1C004R04701130309_chr1_666108	5	7	ccag	agtg
V350256906L1C004R04701207541	chr1	666145	50M	182	666327	666146	666328	V350256906L1C004R04701207541_chr1_666145	0	0	ccct	TGTG
V350256906L1C004R04701223556	chr1	469570	50M	175	469745	469571	469746	V350256906L1C004R04701223556_chr1_469570	0	122	ccca	ctga
V350256906L1C004R04701274928	chr1	1387656	50M	166	1387822	1387657	1387823	V350256906L1C004R04701274928_chr1_1387656	75	100	GCTG	TGTT
V350256906L1C004R04701404054	chr1	642972	50M	178	643150	642973	643151	V350256906L1C004R04701404054_chr1_642972	28	77	ccct	gaat
V350256906L1C004R04800862901	chr1	881212	50M	177	881389	881213	881390	V350256906L1C004R04800862901_chr1_881212	59	38	AGAG	CCAG
V350256906L1C004R04801078111	chr1	36162	50M	152	36314	36163	36315	V350256906L1C004R04801078111_chr1_36162	64	56	GCTG	CATA
V350256906L1C004R04900429107	chr1	102011	50M	171	102182	102012	102183	V350256906L1C004R04900429107_chr1_102011	30	26	ggag	tagt
V350256906L1C004R04900492032	chr1	707544	50M	177	707721	707545	707722	V350256906L1C004R04900492032_chr1_707544	64	59	CCTG	GCCT
V350256906L1C004R04900583792	chr1	1413821	50M	157	1413978	1413822	1413979	V350256906L1C004R04900583792_chr1_1413821	30	86	CTGC	CTGC
V350256906L1C004R04900884704	chr1	110959	50M	179	111138	110960	111139	V350256906L1C004R04900884704_chr1_110959	71	71	TCCT	acca
V350256906L1C004R04901060711	chr1	127798	50M	175	127973	127799	127974	V350256906L1C004R04901060711_chr1_127798	17	70	atgg	cgag
V350256906L1C004R04901130904	chr1	1238634	50M	173	1238807	1238635	1238808	V350256906L1C004R04901130904_chr1_1238634	18	42	CCAC	AGCT
V350256906L1C004R04901256376	chr1	32619	50M	166	32785	32620	32786	V350256906L1C004R04901256376_chr1_32619	110	60	CCAG	TGGT
V350256906L1C004R05000328931	chr1	639850	50M	184	640034	639851	640035	V350256906L1C004R05000328931_chr1_639850	0	9	CATC	CTTA
V350256906L1C004R05000554595	chr1	1221813	50M	153	1221966	1221814	1221967	V350256906L1C004R05000554595_chr1_1221813	66	4	GTGC	CCGC
V350256906L1C004R05000861398	chr1	1178253	50M	153	1178406	1178254	1178407	V350256906L1C004R05000861398_chr1_1178253	64	39	CCCT	CCGG
V350256906L1C004R05100046905	chr1	32658	50M	169	32827	32659	32828	V350256906L1C004R05100046905_chr1_32658	149	18	TCAG	ACCC
V350256906L1C004R05100505066	chr1	13057	50M	170	13227	13058	13228	V350256906L1C004R05100505066_chr1_13057	18	0	GCCT	CCCT
V350256906L1C004R05100602746	chr1	658947	50M	173	659120	658948	659121	V350256906L1C004R05100602746_chr1_658947	63	50	CCCC	TGGG
V350256906L1C004R05100830157	chr1	1092781	25M25S	129	1092910	1092782	1092911	V350256906L1C004R05100830157_chr1_1092781	167	38	catc	CGGC
V350256906L1C004R05200079693	chr1	430075	50M	144	430219	430076	430220	V350256906L1C004R05200079693_chr1_430075	0	0	GGAG	caaa
V350256906L1C004R05200425560	chr1	655259	50M	159	655418	655260	655419	V350256906L1C004R05200425560_chr1_655259	63	58	cacg	AACA
V350256906L1C004R05200524676	chr1	917006	50M	188	917194	917007	917195	V350256906L1C004R05200524676_chr1_917006	41	45	GGCT	CTGA
V350256906L1C004R05200855504	chr1	734827	50M	188	735015	734828	735016	V350256906L1C004R05200855504_chr1_734827	29	31	CAGC	ctgg
V350256906L1C004R05300209765	chr1	56770	50M	198	56968	56771	56969	V350256906L1C004R05300209765_chr1_56770	34	68	CCTG	ATTG
V350256906L1C004R05300723852	chr1	242396	50M	187	242583	242397	242584	V350256906L1C004R05300723852_chr1_242396	0	0	TGAG	GGCA
V350256906L1C004R05301297638	chr1	457474	50M	166	457640	457475	457641	V350256906L1C004R05301297638_chr1_457474	64	48	caat	agac
V350256906L1C004R05301323285	chr1	134807	50M	166	134973	134808	134974	V350256906L1C004R05301323285_chr1_134807	0	127	GCCA	ATCT
V350256906L1C004R05400207943	chr1	470095	50M	153	470248	470096	470249	V350256906L1C004R05400207943_chr1_470095	164	11	tgtg	cctg
V350256906L1C004R05400748328	chr1	707117	50M	230	707347	707118	707348	V350256906L1C004R05400748328_chr1_707117	29	69	cggt	TGCA
V350256906L1C004R05401199189	chr1	954270	50M	155	954425	954271	954426	V350256906L1C004R05401199189_chr1_954270	77	81	tcac	agga
V350256906L1C004R05500551487	chr1	1262147	50M	172	1262319	1262148	1262320	V350256906L1C004R05500551487_chr1_1262147	29	25	CCAT	GATT
V350256906L1C004R05500567644	chr1	435688	50M	166	435854	435689	435855	V350256906L1C004R05500567644_chr1_435688	30	75	TATC	gact
V350256906L1C004R05500638681	chr1	1383819	50M	221	1384040	1383820	1384041	V350256906L1C004R05500638681_chr1_1383819	1	44	gcta	cgag
V350256906L1C004R05501093538	chr1	668629	50M	114	668743	668630	668744	V350256906L1C004R05501093538_chr1_668629	0	111	aggc	ggga
V350256906L1C004R05600356069	chr1	896319	50M	167	896486	896320	896487	V350256906L1C004R05600356069_chr1_896319	56	61	CCCG	CTGC
V350256906L1C004R05600380663	chr1	726199	24M26S	156	726355	726200	726356	V350256906L1C004R05600380663_chr1_726199	50	56	actc	ccat
V350256906L1C004R05600437232	chr1	1135434	50M	137	1135571	1135435	1135572	V350256906L1C004R05600437232_chr1_1135434	0	8	CCCC	TCCA
V350256906L1C004R05600492458	chr1	669168	50M	157	669325	669169	669326	V350256906L1C004R05600492458_chr1_669168	19	18	CCTA	gtgg
V350256906L1C004R05600545900	chr1	1113262	50M	177	1113439	1113263	1113440	V350256906L1C004R05600545900_chr1_1113262	67	0	CCAT	GAGG
V350256906L1C004R05601112578	chr1	1412480	50M	180	1412660	1412481	1412661	V350256906L1C004R05601112578_chr1_1412480	3	31	ccgg	CGTA
V350256906L1C004R05601218262	chr1	1342133	50M	161	1342294	1342134	1342295	V350256906L1C004R05601218262_chr1_1342133	54	36	TGCC	GGAC
V350256906L1C004R05601358436	chr1	748635	50M	160	748795	748636	748796	V350256906L1C004R05601358436_chr1_748635	46	65	CCAC	GAGT
V350256906L1C004R05700508707	chr1	86500	50M	157	86657	86501	86658	V350256906L1C004R05700508707_chr1_86500	0	3	cccc	CCAT
V350256906L1C004R05700613300	chr1	404743	50M	171	404914	404744	404915	V350256906L1C004R05700613300_chr1_404743	121	0	aaga	caag
V350256906L1C004R05700673038	chr1	22915	50M	150	23065	22916	23066	V350256906L1C004R05700673038_chr1_22915	133	0	CCTC	CCAC
V350256906L1C004R05700698289	chr1	644551	50M	203	644754	644552	644755	V350256906L1C004R05700698289_chr1_644551	46	36	aaaa	ctaa
V350256906L1C004R05701075826	chr1	141603	50M	155	141758	141604	141759	V350256906L1C004R05701075826_chr1_141603	54	0	cgtc	ggct
V350256906L1C004R05701160665	chr1	654176	50M	179	654355	654177	654356	V350256906L1C004R05701160665_chr1_654176	110	220	tctg	ggcg
V350256906L1C004R05800093752	chr1	979262	50M	203	979465	979263	979466	V350256906L1C004R05800093752_chr1_979262	76	93	TGTC	CCCA
V350256906L1C004R05800552819	chr1	82660	50M	122	82782	82661	82783	V350256906L1C004R05800552819_chr1_82660	0	93	tcaa	tagt
V350256906L1C004R05900095218	chr1	441030	50M	206	441236	441031	441237	V350256906L1C004R05900095218_chr1_441030	56	58	GGTT	CATG
V350256906L1C004R05900305335	chr1	134778	50M	151	134929	134779	134930	V350256906L1C004R05900305335_chr1_134778	0	83	GGCG	CCAC
V350256906L1C004R05900582770	chr1	1403249	50M	166	1403415	1403250	1403416	V350256906L1C004R05900582770_chr1_1403249	4	0	GCCT	CGGG
V350256906L1C004R05900797233	chr1	1028391	50M	157	1028548	1028392	1028549	V350256906L1C004R05900797233_chr1_1028391	52	45	cagc	caaa
V350256906L1C004R05900926911	chr1	751482	7M1I42M	164	751646	751483	751647	V350256906L1C004R05900926911_chr1_751482	34	20	TGAT	ctat
V350256906L1C004R05901259262	chr1	17949	50M	174	18123	17950	18124	V350256906L1C004R05901259262_chr1_17949	12	45	CTCT	CAAG
V350256906L1C004R06000383128	chr1	823200	50M	164	823364	823201	823365	V350256906L1C004R06000383128_chr1_823200	71	48	accc	TGTG
V350256906L1C004R06000408727	chr1	902974	50M	153	903127	902975	903128	V350256906L1C004R06000408727_chr1_902974	30	52	TCCT	CCTC
V350256906L1C004R06000448710	chr1	907066	50M	171	907237	907067	907238	V350256906L1C004R06000448710_chr1_907066	39	18	TGAG	CCAC
V350256906L1C004R06000742972	chr1	430130	50M	177	430307	430131	430308	V350256906L1C004R06000742972_chr1_430130	47	50	ACCC	cgac
V350256906L1C004R06000769557	chr1	468360	50M	193	468553	468361	468554	V350256906L1C004R06000769557_chr1_468360	17	46	ggtt	aaga
V350256906L1C004R06001128132	chr1	241106	50M	186	241292	241107	241293	V350256906L1C004R06001128132_chr1_241106	58	41	ccca	actt
V350256906L1C004R06001136702	chr1	1161993	50M	133	1162126	1161994	1162127	V350256906L1C004R06001136702_chr1_1161993	0	33	CCCG	CCAA
V350256906L1C004R06100084228	chr1	60736	50M	174	60910	60737	60911	V350256906L1C004R06100084228_chr1_60736	2	40	CTAG	ACAA
V350256906L1C004R06100117315	chr1	10306	24M1D26M	143	10449	10307	10450	V350256906L1C004R06100117315_chr1_10306	217	74	cccc	ggtt
V350256906L1C004R06100237217	chr1	57452	50M	170	57622	57453	57623	V350256906L1C004R06100237217_chr1_57452	27	149	CCCA	GGAG
V350256906L1C004R06100241855	chr1	1194778	50M	195	1194973	1194779	1194974	V350256906L1C004R06100241855_chr1_1194778	2	158	GAGG	ctag
V350256906L1C004R06100258627	chr1	118813	50M	141	118954	118814	118955	V350256906L1C004R06100258627_chr1_118813	149	65	aaaa	tgtt
V350256906L1C004R06100881206	chr1	1245355	50M	170	1245525	1245356	1245526	V350256906L1C004R06100881206_chr1_1245355	55	56	TGGA	GAAC
V350256906L1C004R06100894039	chr1	74153	50M	110	74263	74154	74264	V350256906L1C004R06100894039_chr1_74153	22	64	tgtc	aacc
V350256906L1C004R06101206220	chr1	808501	50M	183	808684	808502	808685	V350256906L1C004R06101206220_chr1_808501	14	0	CAGG	CCCC
V350256906L1C004R06101391421	chr1	158466	50M	159	158625	158467	158626	V350256906L1C004R06101391421_chr1_158466	193	166	CAAT	CCAG
V350256906L1C004R06200368332	chr1	50924	50M	163	51087	50925	51088	V350256906L1C004R06200368332_chr1_50924	62	39	AATG	AAAT
V350256906L1C004R06201098317	chr1	531002	50M	170	531172	531003	531173	V350256906L1C004R06201098317_chr1_531002	0	0	GGTT	GCAT
V350256906L1C004R06201279580	chr1	48636	50M	165	48801	48637	48802	V350256906L1C004R06201279580_chr1_48636	51	56	ctat	ctca
V350256906L1C004R06300802283	chr1	776083	50M	156	776239	776084	776240	V350256906L1C004R06300802283_chr1_776083	63	49	CCCA	ACGC
V350256906L1C004R06301166938	chr1	725616	30M20S	204	725820	725617	725821	V350256906L1C004R06301166938_chr1_725616	100	63	ggaa	gtcc
V350256906L1C004R06301340745	chr1	372696	50M	171	372867	372697	372868	V350256906L1C004R06301340745_chr1_372696	223	243	tgtg	ccag
V350256906L1C004R06301391493	chr1	93462	50M	176	93638	93463	93639	V350256906L1C004R06301391493_chr1_93462	43	22	CTCT	GGGA
V350256906L1C004R06400092014	chr1	1387939	50M	207	1388146	1387940	1388147	V350256906L1C004R06400092014_chr1_1387939	0	7	AGCC	gtgc
V350256906L1C004R06400120452	chr1	1062207	50M	177	1062384	1062208	1062385	V350256906L1C004R06400120452_chr1_1062207	35	30	GGGT	gcct
V350256906L1C004R06400278574	chr1	810006	50M	187	810193	810007	810194	V350256906L1C004R06400278574_chr1_810006	32	84	TTCC	TTAA
V350256906L1C004R06400362716	chr1	232342	50M	182	232524	232343	232525	V350256906L1C004R06400362716_chr1_232342	0	28	ttat	AACA
V350256906L1C004R06400744010	chr1	16213	50M	170	16383	16214	16384	V350256906L1C004R06400744010_chr1_16213	9	138	GCCA	CCCC
V350256906L1C004R06400830715	chr1	600428	50M	190	600618	600429	600619	V350256906L1C004R06400830715_chr1_600428	46	53	caat	caca
V350256906L1C004R06401227807	chr1	1423908	50M	179	1424087	1423909	1424088	V350256906L1C004R06401227807_chr1_1423908	0	0	aggc	gctc
V350256906L1C004R06500024903	chr1	1346185	50M	172	1346357	1346186	1346358	V350256906L1C004R06500024903_chr1_1346185	69	58	cggt	ccca
V350256906L1C004R06500025603	chr1	415389	50M	164	415553	415390	415554	V350256906L1C004R06500025603_chr1_415389	10	174	CTTA	CCCT
V350256906L1C004R06500171509	chr1	1187047	50M	170	1187217	1187048	1187218	V350256906L1C004R06500171509_chr1_1187047	0	0	TATT	ccag
V350256906L1C004R06500213032	chr1	237212	50M	176	237388	237213	237389	V350256906L1C004R06500213032_chr1_237212	25	25	TGCT	ggct
V350256906L1C004R06500392664	chr1	60167	50M	192	60359	60168	60360	V350256906L1C004R06500392664_chr1_60167	32	45	CCAA	ACTA
V350256906L1C004R06500400139	chr1	1110082	50M	160	1110242	1110083	1110243	V350256906L1C004R06500400139_chr1_1110082	71	49	AAAG	acag
V350256906L1C004R06501124872	chr1	136162	50M	188	136350	136163	136351	V350256906L1C004R06501124872_chr1_136162	55	54	CCCG	CCTC
V350256906L1C004R06501191136	chr1	644318	50M	188	644506	644319	644507	V350256906L1C004R06501191136_chr1_644318	24	26	ccac	aggt
V350256906L1C004R06600532608	chr1	1029944	50M	198	1030142	1029945	1030143	V350256906L1C004R06600532608_chr1_1029944	24	25	ctaa	tttc
V350256906L1C004R06600936428	chr1	82963	50M	179	83142	82964	83143	V350256906L1C004R06600936428_chr1_82963	0	54	ctga	taaa
V350256906L1C004R06700108931	chr1	407741	50M	115	407856	407742	407857	V350256906L1C004R06700108931_chr1_407741	1	99	gcta	tgta
V350256906L1C004R06700121287	chr1	256807	50M	182	256989	256808	256990	V350256906L1C004R06700121287_chr1_256807	173	0	taca	gcta
V350256906L1C004R06700336009	chr1	1113698	50M	171	1113869	1113699	1113870	V350256906L1C004R06700336009_chr1_1113698	39	29	caga	ccca
V350256906L1C004R06700428498	chr1	1299898	50M	148	1300046	1299899	1300047	V350256906L1C004R06700428498_chr1_1299898	0	1	CCTG	ggat
V350256906L1C004R06700609408	chr1	454796	50M	197	454993	454797	454994	V350256906L1C004R06700609408_chr1_454796	122	38	GCAG	ccaa
V350256906L1C004R06700917309	chr1	726936	14S36M	89	727025	726937	727026	V350256906L1C004R06700917309_chr1_726936	59	0	aatg	catt
V350256906L1C004R06701039898	chr1	1158668	50M	145	1158813	1158669	1158814	V350256906L1C004R06701039898_chr1_1158668	33	178	GCAA	CAAG
V350256906L1C004R06701134322	chr1	95280	50M	163	95443	95281	95444	V350256906L1C004R06701134322_chr1_95280	63	31	AGAG	TAGA
V350256906L1C004R06800018400	chr1	31595	50M	190	31785	31596	31786	V350256906L1C004R06800018400_chr1_31595	45	223	gtag	TATA
V350256906L1C004R06800028320	chr1	1048983	50M	168	1049151	1048984	1049152	V350256906L1C004R06800028320_chr1_1048983	17	5	ctca	ccct
V350256906L1C004R06800214410	chr1	1146361	50M	193	1146554	1146362	1146555	V350256906L1C004R06800214410_chr1_1146361	12	101	CGCA	GGGA
V350256906L1C004R06800454241	chr1	370450	50M	176	370626	370451	370627	V350256906L1C004R06800454241_chr1_370450	46	45	cagt	caaa
V350256906L1C004R06800468679	chr1	112265	50M	174	112439	112266	112440	V350256906L1C004R06800468679_chr1_112265	52	51	cttt	ccaa
V350256906L1C004R06800694226	chr1	692232	50M	163	692395	692233	692396	V350256906L1C004R06800694226_chr1_692232	42	57	taaa	CCTT
V350256906L1C004R06800808165	chr1	1031320	50M	194	1031514	1031321	1031515	V350256906L1C004R06800808165_chr1_1031320	57	58	tcct	ctaa
V350256906L1C004R06800948023	chr1	1097481	50M	160	1097641	1097482	1097642	V350256906L1C004R06800948023_chr1_1097481	68	39	CCAA	ACCC
V350256906L1C004R06800975565	chr1	350071	50M	174	350245	350072	350246	V350256906L1C004R06800975565_chr1_350071	56	8	TGTA	CTTT
V350256906L1C004R06801278681	chr1	350183	50M	169	350352	350184	350353	V350256906L1C004R06801278681_chr1_350183	15	30	CAAG	CTAT
V350256906L1C004R06900693702	chr1	725913	46M4S	244	726157	725914	726158	V350256906L1C004R06900693702_chr1_725913	0	92	aatg	attc
V350256906L1C004R06900949017	chr1	982394	50M	199	982593	982395	982594	V350256906L1C004R06900949017_chr1_982394	42	241	CTGC	GATG
V350256906L1C004R06901317751	chr1	123388	50M	157	123545	123389	123546	V350256906L1C004R06901317751_chr1_123388	61	23	CCCT	CCGT
V350256906L1C004R06901359987	chr1	239031	50M	167	239198	239032	239199	V350256906L1C004R06901359987_chr1_239031	96	38	gcat	CCAT
V350256906L1C004R07000175272	chr1	258038	50M	177	258215	258039	258216	V350256906L1C004R07000175272_chr1_258038	58	66	AGTA	cttt
V350256906L1C004R07000730118	chr1	818669	50M	153	818822	818670	818823	V350256906L1C004R07000730118_chr1_818669	109	0	gctt	tgca
V350256906L1C004R07000966243	chr1	586244	50M	185	586429	586245	586430	V350256906L1C004R07000966243_chr1_586244	20	20	ccca	GGAA
V350256906L1C004R07001245453	chr1	1089336	50M	175	1089511	1089337	1089512	V350256906L1C004R07001245453_chr1_1089336	49	44	TGCT	GCAC
V350256906L1C004R07001270042	chr1	1416770	50M	161	1416931	1416771	1416932	V350256906L1C004R07001270042_chr1_1416770	0	84	gtct	ACTC
V350256906L1C004R07100406868	chr1	135623	50M	163	135786	135624	135787	V350256906L1C004R07100406868_chr1_135623	151	21	TGTC	GACT
V350256906L1C004R07100587473	chr1	802804	50M	170	802974	802805	802975	V350256906L1C004R07100587473_chr1_802804	32	50	GGCA	AATC
V350256906L1C004R07100736484	chr1	150466	50M	173	150639	150467	150640	V350256906L1C004R07100736484_chr1_150466	0	38	tatt	TGCT
V350256906L1C004R07200293488	chr1	135046	50M	167	135213	135047	135214	V350256906L1C004R07200293488_chr1_135046	200	110	GGGC	CCTG
V350256906L1C004R07200772011	chr1	917192	50M	151	917343	917193	917344	V350256906L1C004R07200772011_chr1_917192	47	58	AGAG	GGTG
V350256906L1C004R07200983033	chr1	408877	50M	163	409040	408878	409041	V350256906L1C004R07200983033_chr1_408877	62	53	tctc	aatc
V350256906L1C004R07201315352	chr1	425650	50M	160	425810	425651	425811	V350256906L1C004R07201315352_chr1_425650	0	4	CATT	CTGC
V350256906L1C004R07201323360	chr1	917024	50M	177	917201	917025	917202	V350256906L1C004R07201323360_chr1_917024	23	38	CCAG	TGCT
V350256906L1C005R00100148734	chr1	1038824	50M	160	1038984	1038825	1038985	V350256906L1C005R00100148734_chr1_1038824	22	45	tgat	gccg
V350256906L1C005R00100616929	chr1	1396400	50M	168	1396568	1396401	1396569	V350256906L1C005R00100616929_chr1_1396400	0	77	GGCA	AGGT
V350256906L1C005R00100646012	chr1	907714	50M	183	907897	907715	907898	V350256906L1C005R00100646012_chr1_907714	37	46	CTAC	tggg
V350256906L1C005R00200365766	chr1	124281	50M	162	124443	124282	124444	V350256906L1C005R00200365766_chr1_124281	0	3	ccca	CCAT
V350256906L1C005R00200713323	chr1	647853	50M	146	647999	647854	648000	V350256906L1C005R00200713323_chr1_647853	34	41	cctc	aaag
V350256906L1C005R00201104813	chr1	470148	50M	181	470329	470149	470330	V350256906L1C005R00201104813_chr1_470148	111	29	ctgt	caaa
V350256906L1C005R00201186503	chr1	38416	50M	176	38592	38417	38593	V350256906L1C005R00201186503_chr1_38416	45	221	taag	tgac
V350256906L1C005R00300515565	chr1	729904	50M	203	730107	729905	730108	V350256906L1C005R00300515565_chr1_729904	68	43	CCCT	tctc
V350256906L1C005R00300563457	chr1	927605	50M	249	927854	927606	927855	V350256906L1C005R00300563457_chr1_927605	17	34	tctc	gaga
V350256906L1C005R00300649337	chr1	1377775	50M	167	1377942	1377776	1377943	V350256906L1C005R00300649337_chr1_1377775	32	48	GGTG	AGCG
V350256906L1C005R00300858637	chr1	147933	50M	171	148104	147934	148105	V350256906L1C005R00300858637_chr1_147933	50	28	ggag	ctag
V350256906L1C005R00300913856	chr1	1382574	50M	162	1382736	1382575	1382737	V350256906L1C005R00300913856_chr1_1382574	71	61	ccac	cgag
V350256906L1C005R00301308135	chr1	1211535	50M	164	1211699	1211536	1211700	V350256906L1C005R00301308135_chr1_1211535	0	43	gcct	caca
V350256906L1C005R00301396663	chr1	939548	50M	171	939719	939549	939720	V350256906L1C005R00301396663_chr1_939548	351	180	CCCC	GGAG
V350256906L1C005R00400466959	chr1	382569	50M	194	382763	382570	382764	V350256906L1C005R00400466959_chr1_382569	47	15	ctaa	taac
V350256906L1C005R00400810072	chr1	1078096	50M	184	1078280	1078097	1078281	V350256906L1C005R00400810072_chr1_1078096	7	0	CTAA	CTGG
V350256906L1C005R00401270983	chr1	827517	50M	169	827686	827518	827687	V350256906L1C005R00401270983_chr1_827517	7	0	aatg	gcta
V350256906L1C005R00500027033	chr1	381248	50M	172	381420	381249	381421	V350256906L1C005R00500027033_chr1_381248	110	217	ccca	attt
V350256906L1C005R00500039686	chr1	332997	50M	159	333156	332998	333157	V350256906L1C005R00500039686_chr1_332997	56	61	acct	cttg
V350256906L1C005R00500088653	chr1	830100	50M	162	830262	830101	830263	V350256906L1C005R00500088653_chr1_830100	35	85	CCAG	aaaa
V350256906L1C005R00500479845	chr1	58578	50M	191	58769	58579	58770	V350256906L1C005R00500479845_chr1_58578	178	151	TCCC	CACT
V350256906L1C005R00501160154	chr1	1097025	50M	170	1097195	1097026	1097196	V350256906L1C005R00501160154_chr1_1097025	0	0	CCCG	CCTG
V350256906L1C005R00501257275	chr1	1160215	50M	190	1160405	1160216	1160406	V350256906L1C005R00501257275_chr1_1160215	52	120	cctg	CCCA
V350256906L1C005R00501313333	chr1	723841	50M	175	724016	723842	724017	V350256906L1C005R00501313333_chr1_723841	74	71	CAAA	aCAT
V350256906L1C005R00501391612	chr1	979813	50M	158	979971	979814	979972	V350256906L1C005R00501391612_chr1_979813	105	23	TGCC	GCAC
V350256906L1C005R00600120703	chr1	791224	50M	164	791388	791225	791389	V350256906L1C005R00600120703_chr1_791224	0	0	AACA	AGAA
V350256906L1C005R00600453483	chr1	1131659	50M	156	1131815	1131660	1131816	V350256906L1C005R00600453483_chr1_1131659	17	33	caca	CCAG
V350256906L1C005R00600504791	chr1	1099064	50M	198	1099262	1099065	1099263	V350256906L1C005R00600504791_chr1_1099064	81	42	CACT	GTAC
V350256906L1C005R00600562120	chr1	1370940	50M	167	1371107	1370941	1371108	V350256906L1C005R00600562120_chr1_1370940	25	44	CCGG	CTCG
V350256906L1C005R00600731025	chr1	1387079	50M	163	1387242	1387080	1387243	V350256906L1C005R00600731025_chr1_1387079	154	0	GCAT	GATG
V350256906L1C005R00601384054	chr1	1374623	50M	134	1374757	1374624	1374758	V350256906L1C005R00601384054_chr1_1374623	9	0	CCAC	CCCC
V350256906L1C005R00700146696	chr1	234055	50M	195	234250	234056	234251	V350256906L1C005R00700146696_chr1_234055	0	0	TACA	TCCC
V350256906L1C005R00700639357	chr1	1095896	50M	167	1096063	1095897	1096064	V350256906L1C005R00700639357_chr1_1095896	18	30	CCAA	CCAG
V350256906L1C005R00701332951	chr1	118172	50M	185	118357	118173	118358	V350256906L1C005R00701332951_chr1_118172	61	65	ccag	tgta
V350256906L1C005R00800170313	chr1	996838	50M	157	996995	996839	996996	V350256906L1C005R00800170313_chr1_996838	50	32	CCCC	ccag
V350256906L1C005R00800240935	chr1	568141	50M	174	568315	568142	568316	V350256906L1C005R00800240935_chr1_568141	51	56	CACA	CCTG
V350256906L1C005R00800354344	chr1	893742	50M	171	893913	893743	893914	V350256906L1C005R00800354344_chr1_893742	37	40	cctg	cacg
V350256906L1C005R00800493555	chr1	1397511	50M	189	1397700	1397512	1397701	V350256906L1C005R00800493555_chr1_1397511	0	21	GGTT	GGCA
V350256906L1C005R00800705034	chr1	726825	23S22M5S	148	726973	726826	726974	V350256906L1C005R00800705034_chr1_726825	0	22	gaat	ttcc
V350256906L1C005R00800805090	chr1	1205463	50M	164	1205627	1205464	1205628	V350256906L1C005R00800805090_chr1_1205463	39	0	ctct	tgag
V350256906L1C005R00800887646	chr1	429528	50M	157	429685	429529	429686	V350256906L1C005R00800887646_chr1_429528	57	21	CAAA	CCCT
V350256906L1C005R00801318926	chr1	108360	50M	158	108518	108361	108519	V350256906L1C005R00801318926_chr1_108360	64	24	ccac	agag
V350256906L1C005R00900005103	chr1	869095	27M1I22M	164	869259	869096	869260	V350256906L1C005R00900005103_chr1_869095	106	270	CCCA	GCTA
V350256906L1C005R00900125454	chr1	1004636	50M	210	1004846	1004637	1004847	V350256906L1C005R00900125454_chr1_1004636	48	39	CGGC	CCAC
V350256906L1C005R00900489936	chr1	690109	50M	155	690264	690110	690265	V350256906L1C005R00900489936_chr1_690109	72	59	cctt	ggcc
V350256906L1C005R00900687984	chr1	656167	50M	173	656340	656168	656341	V350256906L1C005R00900687984_chr1_656167	66	45	gctt	ttct
V350256906L1C005R00900703828	chr1	873918	50M	165	874083	873919	874084	V350256906L1C005R00900703828_chr1_873918	40	73	CCTC	TTTT
V350256906L1C005R00901228618	chr1	977821	50M	139	977960	977822	977961	V350256906L1C005R00901228618_chr1_977821	100	137	CGCT	ACAC
V350256906L1C005R01000195764	chr1	153522	50M	269	153791	153523	153792	V350256906L1C005R01000195764_chr1_153522	0	0	gggc	ctct
V350256906L1C005R01000468094	chr1	243484	50M	133	243617	243485	243618	V350256906L1C005R01000468094_chr1_243484	24	57	AAAT	CTTA
V350256906L1C005R01000710351	chr1	112126	50M	198	112324	112127	112325	V350256906L1C005R01000710351_chr1_112126	31	10	cctg	acct
V350256906L1C005R01001279585	chr1	447871	50M	182	448053	447872	448054	V350256906L1C005R01001279585_chr1_447871	32	31	gaaa	tgtg
V350256906L1C005R01100318481	chr1	1257712	50M	167	1257879	1257713	1257880	V350256906L1C005R01100318481_chr1_1257712	65	49	CCTG	GGTT
V350256906L1C005R01100559982	chr1	419282	50M	150	419432	419283	419433	V350256906L1C005R01100559982_chr1_419282	52	0	ccct	ggca
V350256906L1C005R01100615415	chr1	965683	2S45M3S	148	965831	965684	965832	V350256906L1C005R01100615415_chr1_965683	156	70	gtgt	CACA
V350256906L1C005R01100665949	chr1	1236117	50M	135	1236252	1236118	1236253	V350256906L1C005R01100665949_chr1_1236117	101	58	CTGC	tgaa
V350256906L1C005R01100703210	chr1	872011	50M	171	872182	872012	872183	V350256906L1C005R01100703210_chr1_872011	125	19	TGTG	CCAA
V350256906L1C005R01100758833	chr1	60051	50M	171	60222	60052	60223	V350256906L1C005R01100758833_chr1_60051	37	45	TCTT	TCCC
V350256906L1C005R01100791128	chr1	949868	50M	131	949999	949869	950000	V350256906L1C005R01100791128_chr1_949868	12	0	CCAG	CCTG
V350256906L1C005R01100900761	chr1	1138254	50M	162	1138416	1138255	1138417	V350256906L1C005R01100900761_chr1_1138254	62	66	CCTT	TGGA
V350256906L1C005R01101155620	chr1	241457	50M	187	241644	241458	241645	V350256906L1C005R01101155620_chr1_241457	58	68	CTGT	TCTT
V350256906L1C005R01200309617	chr1	1386382	50M	167	1386549	1386383	1386550	V350256906L1C005R01200309617_chr1_1386382	2	0	GATC	ctca
V350256906L1C005R01200514379	chr1	978011	50M	207	978218	978012	978219	V350256906L1C005R01200514379_chr1_978011	86	70	CGTC	CACG
V350256906L1C005R01200595267	chr1	19488	50M	164	19652	19489	19653	V350256906L1C005R01200595267_chr1_19488	164	0	GGAA	CATG
V350256906L1C005R01200886690	chr1	852234	50M	192	852426	852235	852427	V350256906L1C005R01200886690_chr1_852234	41	54	CTGT	CCCT
V350256906L1C005R01201287989	chr1	884002	50M	127	884129	884003	884130	V350256906L1C005R01201287989_chr1_884002	5	42	CAGG	CCTC
V350256906L1C005R01201399237	chr1	959669	50M	131	959800	959670	959801	V350256906L1C005R01201399237_chr1_959669	389	258	GTGC	TCCA
V350256906L1C005R01300311447	chr1	114187	50M	180	114367	114188	114368	V350256906L1C005R01300311447_chr1_114187	64	97	TTGA	acct
V350256906L1C005R01300333482	chr1	1357351	50M	170	1357521	1357352	1357522	V350256906L1C005R01300333482_chr1_1357351	34	64	CCTG	CCCT
V350256906L1C005R01300492104	chr1	1354512	50M	135	1354647	1354513	1354648	V350256906L1C005R01300492104_chr1_1354512	69	44	TCTC	GAGG
V350256906L1C005R01300779870	chr1	664261	50M	168	664429	664262	664430	V350256906L1C005R01300779870_chr1_664261	79	247	ACAT	TGTC
V350256906L1C005R01301045712	chr1	1169932	50M	133	1170065	1169933	1170066	V350256906L1C005R01301045712_chr1_1169932	83	9	CCAG	GCCC
V350256906L1C005R01301100651	chr1	43782	15M1I34M	175	43957	43783	43958	V350256906L1C005R01301100651_chr1_43782	0	0	cctt	tttt
V350256906L1C005R01301157524	chr1	1318044	50M	96	1318140	1318045	1318141	V350256906L1C005R01301157524_chr1_1318044	187	91	CCCC	TGGA
V350256906L1C005R01400599121	chr1	552063	50M	188	552251	552064	552252	V350256906L1C005R01400599121_chr1_552063	23	36	cata	catg
V350256906L1C005R01400799329	chr1	89564	50M	134	89698	89565	89699	V350256906L1C005R01400799329_chr1_89564	11	17	CACG	GGAC
V350256906L1C005R01400828020	chr1	1228123	50M	214	1228337	1228124	1228338	V350256906L1C005R01400828020_chr1_1228123	41	47	GGCT	CCCA
V350256906L1C005R01401252541	chr1	63121	50M	184	63305	63122	63306	V350256906L1C005R01401252541_chr1_63121	0	93	CCAT	GCCA
V350256906L1C005R01500236191	chr1	1402074	50M	146	1402220	1402075	1402221	V350256906L1C005R01500236191_chr1_1402074	7	46	actg	ccac
V350256906L1C005R01500380633	chr1	135095	50M	169	135264	135096	135265	V350256906L1C005R01500380633_chr1_135095	228	59	CGAA	CCTC
V350256906L1C005R01500821196	chr1	418742	50M	190	418932	418743	418933	V350256906L1C005R01500821196_chr1_418742	57	46	ccac	caaa
V350256906L1C005R01500943616	chr1	906213	50M	174	906387	906214	906388	V350256906L1C005R01500943616_chr1_906213	11	1	CGGA	CTGT
V350256906L1C005R01501090223	chr1	889836	50M	184	890020	889837	890021	V350256906L1C005R01501090223_chr1_889836	74	75	CTCA	gctg
V350256906L1C005R01501126372	chr1	962256	50M	178	962434	962257	962435	V350256906L1C005R01501126372_chr1_962256	57	84	CCTG	CCCA
V350256906L1C005R01600007608	chr1	325221	50M	173	325394	325222	325395	V350256906L1C005R01600007608_chr1_325221	28	56	TCAG	GGAG
V350256906L1C005R01600096542	chr1	879180	50M	183	879363	879181	879364	V350256906L1C005R01600096542_chr1_879180	27	130	CGGG	CAGG
V350256906L1C005R01600192013	chr1	1166245	50M	189	1166434	1166246	1166435	V350256906L1C005R01600192013_chr1_1166245	68	48	AGAC	gacg
V350256906L1C005R01600207575	chr1	754652	50M	157	754809	754653	754810	V350256906L1C005R01600207575_chr1_754652	94	25	agcc	CCAG
V350256906L1C005R01600345300	chr1	1114381	50M	179	1114560	1114382	1114561	V350256906L1C005R01600345300_chr1_1114381	2	51	CACA	AGAT
V350256906L1C005R01600664488	chr1	711596	50M	159	711755	711597	711756	V350256906L1C005R01600664488_chr1_711596	0	0	actc	ccac
V350256906L1C005R01600779515	chr1	712277	50M	152	712429	712278	712430	V350256906L1C005R01600779515_chr1_712277	71	29	CCAC	TCTA
V350256906L1C005R01600931787	chr1	971760	50M	155	971915	971761	971916	V350256906L1C005R01600931787_chr1_971760	56	57	TGTG	TGGG
V350256906L1C005R01601345429	chr1	792593	50M	178	792771	792594	792772	V350256906L1C005R01601345429_chr1_792593	25	118	CCCA	AAAA
V350256906L1C005R01700032113	chr1	788203	50M	185	788388	788204	788389	V350256906L1C005R01700032113_chr1_788203	6	22	AGTA	ctgg
V350256906L1C005R01700240102	chr1	730577	50M	175	730752	730578	730753	V350256906L1C005R01700240102_chr1_730577	37	33	caga	ttgg
V350256906L1C005R01700364469	chr1	366251	50M	161	366412	366252	366413	V350256906L1C005R01700364469_chr1_366251	322	483	TGCA	TGAG
V350256906L1C005R01700511742	chr1	1241880	50M	159	1242039	1241881	1242040	V350256906L1C005R01700511742_chr1_1241880	94	7	CCAG	CGCT
V350256906L1C005R01700512982	chr1	12001	50M	154	12155	12002	12156	V350256906L1C005R01700512982_chr1_12001	75	32	CATC	TATT
V350256906L1C005R01700666360	chr1	366762	50M	174	366936	366763	366937	V350256906L1C005R01700666360_chr1_366762	650	476	AACT	TGCC
V350256906L1C005R01700985116	chr1	1098408	50M	242	1098650	1098409	1098651	V350256906L1C005R01700985116_chr1_1098408	82	0	TTGC	CCCG
V350256906L1C005R01800440252	chr1	124476	50M	183	124659	124477	124660	V350256906L1C005R01800440252_chr1_124476	13	144	GGTC	ctca
V350256906L1C005R01800600376	chr1	896964	50M	184	897148	896965	897149	V350256906L1C005R01800600376_chr1_896964	20	17	CCGT	GGTG
V350256906L1C005R01801211379	chr1	1204182	50M	165	1204347	1204183	1204348	V350256906L1C005R01801211379_chr1_1204182	52	44	tgag	Cgtg
V350256906L1C005R01900147103	chr1	546670	50M	198	546868	546671	546869	V350256906L1C005R01900147103_chr1_546670	47	49	ctac	caca
V350256906L1C005R01900219524	chr1	1395849	50M	139	1395988	1395850	1395989	V350256906L1C005R01900219524_chr1_1395849	0	93	CCCG	ACGC
V350256906L1C005R01900594939	chr1	973102	50M	153	973255	973103	973256	V350256906L1C005R01900594939_chr1_973102	80	233	CCAT	CCCG
V350256906L1C005R01900855457	chr1	598544	50M	162	598706	598545	598707	V350256906L1C005R01900855457_chr1_598544	276	145	ctga	ttga
V350256906L1C005R01900900501	chr1	644887	50M	173	645060	644888	645061	V350256906L1C005R01900900501_chr1_644887	65	238	gata	tatt
V350256906L1C005R01900901148	chr1	833371	50M	159	833530	833372	833531	V350256906L1C005R01900901148_chr1_833371	25	77	cctc	cgac
V350256906L1C005R01901006386	chr1	788601	50M	188	788789	788602	788790	V350256906L1C005R01901006386_chr1_788601	32	88	ccca	gaca
V350256906L1C005R01901199308	chr1	781542	50M	189	781731	781543	781732	V350256906L1C005R01901199308_chr1_781542	9	0	gggg	acac
V350256906L1C005R01901260335	chr1	538073	50M	163	538236	538074	538237	V350256906L1C005R01901260335_chr1_538073	160	0	AGCA	agca
V350256906L1C005R01901284021	chr1	138610	50M	181	138791	138611	138792	V350256906L1C005R01901284021_chr1_138610	35	39	CCTG	GCTA
V350256906L1C005R01901346773	chr1	1117351	50M	170	1117521	1117352	1117522	V350256906L1C005R01901346773_chr1_1117351	0	0	GACC	CCCG
V350256906L1C005R02000813804	chr1	1299574	50M	153	1299727	1299575	1299728	V350256906L1C005R02000813804_chr1_1299574	117	24	cggc	CCCG
V350256906L1C005R02000844623	chr1	126696	50M	164	126860	126697	126861	V350256906L1C005R02000844623_chr1_126696	23	44	taaa	ccta
V350256906L1C005R02001019253	chr1	177126	50M	164	177290	177127	177291	V350256906L1C005R02001019253_chr1_177126	183	347	GATG	ATTT
V350256906L1C005R02100233890	chr1	127670	50M	170	127840	127671	127841	V350256906L1C005R02100233890_chr1_127670	145	0	AGTA	gcag
V350256906L1C005R02100461829	chr1	922910	50M	148	923058	922911	923059	V350256906L1C005R02100461829_chr1_922910	122	83	ccca	aaaa
V350256906L1C005R02100944675	chr1	777307	50M	149	777456	777308	777457	V350256906L1C005R02100944675_chr1_777307	17	6	TAGA	CCTT
V350256906L1C005R02200000749	chr1	678983	50M	173	679156	678984	679157	V350256906L1C005R02200000749_chr1_678983	70	135	caag	CTCT
V350256906L1C005R02200187753	chr1	78813	50M	183	78996	78814	78997	V350256906L1C005R02200187753_chr1_78813	140	0	agac	gcag
V350256906L1C005R02200204103	chr1	358232	50M	155	358387	358233	358388	V350256906L1C005R02200204103_chr1_358232	60	53	catt	caat
V350256906L1C005R02200610794	chr1	1080568	50M	152	1080720	1080569	1080721	V350256906L1C005R02200610794_chr1_1080568	50	60	ACCT	TCCT
V350256906L1C005R02200656748	chr1	810895	50M	124	811019	810896	811020	V350256906L1C005R02200656748_chr1_810895	19	1	GTGT	CATC
V350256906L1C005R02200774833	chr1	727615	50M	208	727823	727616	727824	V350256906L1C005R02200774833_chr1_727615	0	19	AGTA	aaag
V350256906L1C005R02200842656	chr1	1129392	50M	153	1129545	1129393	1129546	V350256906L1C005R02200842656_chr1_1129392	14	75	gcat	ttta
V350256906L1C005R02200855733	chr1	251485	50M	182	251667	251486	251668	V350256906L1C005R02200855733_chr1_251485	36	41	CTGA	GTTG
V350256906L1C005R02201040695	chr1	1109115	50M	108	1109223	1109116	1109224	V350256906L1C005R02201040695_chr1_1109115	46	0	TGTG	GCCG
V350256906L1C005R02201219597	chr1	121340	50M	169	121509	121341	121510	V350256906L1C005R02201219597_chr1_121340	231	87	cacc	ggat
V350256906L1C005R02300121340	chr1	770015	50M	171	770186	770016	770187	V350256906L1C005R02300121340_chr1_770015	56	45	TGAG	cctt
V350256906L1C005R02300245454	chr1	1400466	50M	166	1400632	1400467	1400633	V350256906L1C005R02300245454_chr1_1400466	52	32	atgt	aaag
V350256906L1C005R02300301507	chr1	855622	50M	171	855793	855623	855794	V350256906L1C005R02300301507_chr1_855622	48	97	GGAC	CAGC
V350256906L1C005R02300976259	chr1	163880	50M	96	163976	163881	163977	V350256906L1C005R02300976259_chr1_163880	32	0	agca	gtat
V350256906L1C005R02301202979	chr1	1409208	50M	187	1409395	1409209	1409396	V350256906L1C005R02301202979_chr1_1409208	0	0	GGGA	CCTG
V350256906L1C005R02400013036	chr1	1366198	50M	161	1366359	1366199	1366360	V350256906L1C005R02400013036_chr1_1366198	63	41	CGGA	CCTT
V350256906L1C005R02400226752	chr1	1104483	50M	172	1104655	1104484	1104656	V350256906L1C005R02400226752_chr1_1104483	61	59	GGAG	CCAG
V350256906L1C005R02400276702	chr1	831346	50M	155	831501	831347	831502	V350256906L1C005R02400276702_chr1_831346	217	62	gcat	gcct
V350256906L1C005R02400507936	chr1	1368286	50M	180	1368466	1368287	1368467	V350256906L1C005R02400507936_chr1_1368286	79	55	TCTA	GATg
V350256906L1C005R02400597930	chr1	822075	50M	175	822250	822076	822251	V350256906L1C005R02400597930_chr1_822075	165	236	cact	ggcc
V350256906L1C005R02401166121	chr1	53352	50M	180	53532	53353	53533	V350256906L1C005R02401166121_chr1_53352	86	266	AGCA	GGTG
V350256906L1C005R02500087237	chr1	831418	50M	174	831592	831419	831593	V350256906L1C005R02500087237_chr1_831418	145	0	ggaa	caga
V350256906L1C005R02500089342	chr1	448851	50M	168	449019	448852	449020	V350256906L1C005R02500089342_chr1_448851	109	0	gccc	ctca
V350256906L1C005R02500322217	chr1	917956	50M	169	918125	917957	918126	V350256906L1C005R02500322217_chr1_917956	62	38	CACG	AGAG
V350256906L1C005R02500378246	chr1	675747	50M	163	675910	675748	675911	V350256906L1C005R02500378246_chr1_675747	0	68	taaa	TGGT
V350256906L1C005R02500603051	chr1	1404989	50M	174	1405163	1404990	1405164	V350256906L1C005R02500603051_chr1_1404989	49	42	caag	ccag
V350256906L1C005R02500620089	chr1	74211	50M	168	74379	74212	74380	V350256906L1C005R02500620089_chr1_74211	12	180	tata	ccca
V350256906L1C005R02500641581	chr1	1261615	50M	170	1261785	1261616	1261786	V350256906L1C005R02500641581_chr1_1261615	44	37	GCCC	GGGT
V350256906L1C005R02501070930	chr1	1120213	50M	197	1120410	1120214	1120411	V350256906L1C005R02501070930_chr1_1120213	256	59	CCAG	CCAT
V350256906L1C005R02501188510	chr1	847124	50M	172	847296	847125	847297	V350256906L1C005R02501188510_chr1_847124	26	82	GGCA	tgta
V350256906L1C005R02501259032	chr1	1298077	50M	186	1298263	1298078	1298264	V350256906L1C005R02501259032_chr1_1298077	80	70	cttg	ctcc
V350256906L1C005R02600364541	chr1	592909	50M	175	593084	592910	593085	V350256906L1C005R02600364541_chr1_592909	39	45	CAGG	tCTT
V350256906L1C005R02600455809	chr1	1126513	50M	148	1126661	1126514	1126662	V350256906L1C005R02600455809_chr1_1126513	11	111	aatt	tgaa
V350256906L1C005R02600566915	chr1	1268945	50M	187	1269132	1268946	1269133	V350256906L1C005R02600566915_chr1_1268945	0	0	TGCT	ggcc
V350256906L1C005R02600703098	chr1	1021461	50M	168	1021629	1021462	1021630	V350256906L1C005R02600703098_chr1_1021461	27	36	CCCC	CTGA
V350256906L1C005R02600751490	chr1	227856	50M	197	228053	227857	228054	V350256906L1C005R02600751490_chr1_227856	11	31	gtat	acta
V350256906L1C005R02600893303	chr1	726604	7S43M	146	726750	726605	726751	V350256906L1C005R02600893303_chr1_726604	0	63	tcga	catt
V350256906L1C005R02601222014	chr1	1252275	50M	176	1252451	1252276	1252452	V350256906L1C005R02601222014_chr1_1252275	0	0	gcct	cgtg
V350256906L1C005R02700068837	chr1	1124854	50M	188	1125042	1124855	1125043	V350256906L1C005R02700068837_chr1_1124854	67	71	tatg	caat
V350256906L1C005R02700076469	chr1	724289	50M	180	724469	724290	724470	V350256906L1C005R02700076469_chr1_724289	0	162	cacg	ccca
V350256906L1C005R02700155464	chr1	26370	50M	199	26569	26371	26570	V350256906L1C005R02700155464_chr1_26370	0	0	ctca	ACCA
V350256906L1C005R02700525569	chr1	817413	50M	155	817568	817414	817569	V350256906L1C005R02700525569_chr1_817413	239	84	TGTT	TCCC
V350256906L1C005R02700647003	chr1	842609	50M	165	842774	842610	842775	V350256906L1C005R02700647003_chr1_842609	81	63	ccta	tgct
V350256906L1C005R02700917700	chr1	262419	50M	174	262593	262420	262594	V350256906L1C005R02700917700_chr1_262419	0	0	ggtt	ATCA
V350256906L1C005R02701387829	chr1	536390	50M	145	536535	536391	536536	V350256906L1C005R02701387829_chr1_536390	0	144	ATGT	TATA
V350256906L1C005R02800214171	chr1	817590	50M	181	817771	817591	817772	V350256906L1C005R02800214171_chr1_817590	62	63	TCTG	CTGA
V350256906L1C005R02800855830	chr1	1297311	50M	185	1297496	1297312	1297497	V350256906L1C005R02800855830_chr1_1297311	49	46	TCTC	GGCC
V350256906L1C005R02800895562	chr1	1256072	50M	133	1256205	1256073	1256206	V350256906L1C005R02800895562_chr1_1256072	38	15	GCAT	GGTG
V350256906L1C005R02800974257	chr1	652252	50M	171	652423	652253	652424	V350256906L1C005R02800974257_chr1_652252	37	0	GGTA	ttta
V350256906L1C005R02801073555	chr1	159797	50M	166	159963	159798	159964	V350256906L1C005R02801073555_chr1_159797	53	74	GGCG	CTAT
V350256906L1C005R02801240545	chr1	131443	50M	176	131619	131444	131620	V350256906L1C005R02801240545_chr1_131443	0	0	GCTC	GTTC
V350256906L1C005R02900070323	chr1	1028617	50M	142	1028759	1028618	1028760	V350256906L1C005R02900070323_chr1_1028617	0	44	caca	atct
V350256906L1C005R02900308458	chr1	812864	50M	196	813060	812865	813061	V350256906L1C005R02900308458_chr1_812864	0	63	GAGA	TCCA
V350256906L1C005R02900764479	chr1	115013	50M	169	115182	115014	115183	V350256906L1C005R02900764479_chr1_115013	64	62	CACT	tcag
V350256906L1C005R02900836878	chr1	1376233	50M	159	1376392	1376234	1376393	V350256906L1C005R02900836878_chr1_1376233	63	47	GTCC	CCTG
V350256906L1C005R02900949175	chr1	1121793	43M2I5M	186	1121979	1121794	1121980	V350256906L1C005R02900949175_chr1_1121793	139	19	cgtc	tcag
V350256906L1C005R02900989410	chr1	1237787	50M	191	1237978	1237788	1237979	V350256906L1C005R02900989410_chr1_1237787	183	50	CTGG	ATGG
V350256906L1C005R02901092704	chr1	408048	50M	181	408229	408049	408230	V350256906L1C005R02901092704_chr1_408048	0	49	TAAA	AAAG
V350256906L1C005R03000096487	chr1	1151137	50M	175	1151312	1151138	1151313	V350256906L1C005R03000096487_chr1_1151137	72	59	GCCC	ACAG
V350256906L1C005R03000286818	chr1	1138561	50M	116	1138677	1138562	1138678	V350256906L1C005R03000286818_chr1_1138561	0	46	GGGC	TCAG
V350256906L1C005R03000302873	chr1	1324687	50M	183	1324870	1324688	1324871	V350256906L1C005R03000302873_chr1_1324687	66	44	tgca	CCTG
V350256906L1C005R03000331240	chr1	1380642	50M	147	1380789	1380643	1380790	V350256906L1C005R03000331240_chr1_1380642	6	0	TGCA	tcac
V350256906L1C005R03000462337	chr1	1170410	50M	195	1170605	1170411	1170606	V350256906L1C005R03000462337_chr1_1170410	6	114	TATC	CACG
V350256906L1C005R03000483005	chr1	1005538	50M	126	1005664	1005539	1005665	V350256906L1C005R03000483005_chr1_1005538	18	28	CCCT	CCTG
V350256906L1C005R03001140517	chr1	389430	50M	180	389610	389431	389611	V350256906L1C005R03001140517_chr1_389430	68	70	ccca	ctga
V350256906L1C005R03001178463	chr1	1398833	50M	184	1399017	1398834	1399018	V350256906L1C005R03001178463_chr1_1398833	83	58	TGAA	catg
V350256906L1C005R03100730944	chr1	682201	50M	151	682352	682202	682353	V350256906L1C005R03100730944_chr1_682201	115	20	gaag	CCCA
V350256906L1C005R03100862097	chr1	742866	50M	185	743051	742867	743052	V350256906L1C005R03100862097_chr1_742866	77	60	CCTC	CTTA
V350256906L1C005R03101060722	chr1	23902	50M	154	24056	23903	24057	V350256906L1C005R03101060722_chr1_23902	24	0	gctt	CTGC
V350256906L1C005R03101119816	chr1	1045254	50M	190	1045444	1045255	1045445	V350256906L1C005R03101119816_chr1_1045254	81	85	acca	agaa
V350256906L1C005R03101305547	chr1	901771	50M	177	901948	901772	901949	V350256906L1C005R03101305547_chr1_901771	0	16	CAGG	CCTG
V350256906L1C005R03200045366	chr1	800340	50M	161	800501	800341	800502	V350256906L1C005R03200045366_chr1_800340	45	82	CCCT	TGTC
V350256906L1C005R03200131124	chr1	1411803	50M	171	1411974	1411804	1411975	V350256906L1C005R03200131124_chr1_1411803	45	50	GGGC	gagc
V350256906L1C005R03200276134	chr1	1258225	50M	218	1258443	1258226	1258444	V350256906L1C005R03200276134_chr1_1258225	45	39	CCCT	CCCT
V350256906L1C005R03200279198	chr1	1292078	50M	169	1292247	1292079	1292248	V350256906L1C005R03200279198_chr1_1292078	255	104	GCAG	GGAG
V350256906L1C005R03200398358	chr1	1250524	50M	188	1250712	1250525	1250713	V350256906L1C005R03200398358_chr1_1250524	0	0	CACC	CCAG
V350256906L1C005R03200610871	chr1	1061681	50M	168	1061849	1061682	1061850	V350256906L1C005R03200610871_chr1_1061681	200	100	AAtt	tgtg
V350256906L1C005R03200647761	chr1	440962	50M	141	441103	440963	441104	V350256906L1C005R03200647761_chr1_440962	25	0	CGAG	GAAC
V350256906L1C005R03200886652	chr1	814523	50M	186	814709	814524	814710	V350256906L1C005R03200886652_chr1_814523	78	50	ccat	tgtt
V350256906L1C005R03201056523	chr1	815276	50M	239	815515	815277	815516	V350256906L1C005R03201056523_chr1_815276	75	150	ctaa	tcca
V350256906L1C005R03201215031	chr1	679771	50M	166	679937	679772	679938	V350256906L1C005R03201215031_chr1_679771	54	95	CCTG	tgag
V350256906L1C005R03300113309	chr1	1223211	50M	161	1223372	1223212	1223373	V350256906L1C005R03300113309_chr1_1223211	73	54	CGAG	TCCC
V350256906L1C005R03300294716	chr1	1304567	50M	129	1304696	1304568	1304697	V350256906L1C005R03300294716_chr1_1304567	1	130	cact	cagg
V350256906L1C005R03300772628	chr1	1419044	50M	184	1419228	1419045	1419229	V350256906L1C005R03300772628_chr1_1419044	76	78	ggtg	CCTG
V350256906L1C005R03400469434	chr1	467474	50M	189	467663	467475	467664	V350256906L1C005R03400469434_chr1_467474	5	0	cata	ggag
V350256906L1C005R03500153462	chr1	854319	50M	149	854468	854320	854469	V350256906L1C005R03500153462_chr1_854319	45	59	CAAA	TCCA
V350256906L1C005R03500377582	chr1	1217486	50M	118	1217604	1217487	1217605	V350256906L1C005R03500377582_chr1_1217486	0	74	TGTG	cgtc
V350256906L1C005R03500397528	chr1	350339	50M	176	350515	350340	350516	V350256906L1C005R03500397528_chr1_350339	43	62	TCTC	agag
V350256906L1C005R03500547938	chr1	847424	50M	150	847574	847425	847575	V350256906L1C005R03500547938_chr1_847424	0	0	TGGA	CTTA
V350256906L1C005R03500634415	chr1	868555	50M	160	868715	868556	868716	V350256906L1C005R03500634415_chr1_868555	0	22	ATGC	CCTG
V350256906L1C005R03500739733	chr1	1413219	50M	137	1413356	1413220	1413357	V350256906L1C005R03500739733_chr1_1413219	117	132	ggga	tccc
V350256906L1C005R03500938159	chr1	835196	50M	146	835342	835197	835343	V350256906L1C005R03500938159_chr1_835196	42	19	CCCA	CACA
V350256906L1C005R03500994402	chr1	1094879	50M	183	1095062	1094880	1095063	V350256906L1C005R03500994402_chr1_1094879	183	0	CCAT	AGGT
V350256906L1C005R03501318485	chr1	444768	50M	170	444938	444769	444939	V350256906L1C005R03501318485_chr1_444768	81	4	CCTT	CCTG
V350256906L1C005R03600647372	chr1	849329	50M	160	849489	849330	849490	V350256906L1C005R03600647372_chr1_849329	59	65	TCTA	ACCC
V350256906L1C005R03600723630	chr1	726825	23S22M5S	147	726972	726826	726973	V350256906L1C005R03600723630_chr1_726825	0	23	gaat	tcca
V350256906L1C005R03600791145	chr1	621118	50M	161	621279	621119	621280	V350256906L1C005R03600791145_chr1_621118	32	64	ACTA	CCAC
V350256906L1C005R03601220317	chr1	648800	50M	177	648977	648801	648978	V350256906L1C005R03601220317_chr1_648800	89	228	CAAA	AAAG
V350256906L1C005R03601289537	chr1	1294780	50M	190	1294970	1294781	1294971	V350256906L1C005R03601289537_chr1_1294780	136	0	GCCT	GGGC
V350256906L1C005R03700355826	chr1	115335	50M	157	115492	115336	115493	V350256906L1C005R03700355826_chr1_115335	1	0	AATA	CCAA
V350256906L1C005R03700369610	chr1	150022	50M	190	150212	150023	150213	V350256906L1C005R03700369610_chr1_150022	45	76	AAAA	ccac
V350256906L1C005R03700617404	chr1	994188	50M	164	994352	994189	994353	V350256906L1C005R03700617404_chr1_994188	0	156	GGGT	GGGC
V350256906L1C005R03700635745	chr1	381216	50M	166	381382	381217	381383	V350256906L1C005R03700635745_chr1_381216	78	244	tttg	gcca
V350256906L1C005R03700739143	chr1	243725	50M	230	243955	243726	243956	V350256906L1C005R03700739143_chr1_243725	0	61	AGAA	TAAT
V350256906L1C005R03700899233	chr1	1084392	50M	165	1084557	1084393	1084558	V350256906L1C005R03700899233_chr1_1084392	37	20	GGTG	CTTT
V350256906L1C005R03701175199	chr1	1281085	50M	174	1281259	1281086	1281260	V350256906L1C005R03701175199_chr1_1281085	0	0	CCCA	CCCA
V350256906L1C005R03800101076	chr1	911516	50M	125	911641	911517	911642	V350256906L1C005R03800101076_chr1_911516	0	0	TCCT	CCAA
V350256906L1C005R03800946799	chr1	1188080	50M	169	1188249	1188081	1188250	V350256906L1C005R03800946799_chr1_1188080	62	56	gcaa	caaa
V350256906L1C005R03801243646	chr1	724238	50M	168	724406	724239	724407	V350256906L1C005R03801243646_chr1_724238	2	99	aacg	attc
V350256906L1C005R03900062613	chr1	1253623	50M	174	1253797	1253624	1253798	V350256906L1C005R03900062613_chr1_1253623	39	32	tccc	caaa
V350256906L1C005R03900920943	chr1	1326004	50M	195	1326199	1326005	1326200	V350256906L1C005R03900920943_chr1_1326004	44	28	GGAC	AGCC
V350256906L1C005R03900923570	chr1	1426117	50M	151	1426268	1426118	1426269	V350256906L1C005R03900923570_chr1_1426117	34	74	CCAG	CCAA
V350256906L1C005R04000007941	chr1	1081722	50M	152	1081874	1081723	1081875	V350256906L1C005R04000007941_chr1_1081722	0	18	CGTG	CCAA
V350256906L1C005R04000072080	chr1	94472	50M	206	94678	94473	94679	V350256906L1C005R04000072080_chr1_94472	1	31	ACCC	gtct
V350256906L1C005R04000552255	chr1	80146	50M	187	80333	80147	80334	V350256906L1C005R04000552255_chr1_80146	0	0	ccca	gtct
V350256906L1C005R04000858635	chr1	990017	50M	160	990177	990018	990178	V350256906L1C005R04000858635_chr1_990017	16	0	TGAG	GGCT
V350256906L1C005R04001211135	chr1	88492	50M	141	88633	88493	88634	V350256906L1C005R04001211135_chr1_88492	36	27	gctt	actt
V350256906L1C005R04001270916	chr1	1182200	50M	155	1182355	1182201	1182356	V350256906L1C005R04001270916_chr1_1182200	3	46	CTGC	GCCT
V350256906L1C005R04100122077	chr1	671357	50M	163	671520	671358	671521	V350256906L1C005R04100122077_chr1_671357	44	0	TAAC	CAGA
V350256906L1C005R04100159913	chr1	707705	50M	200	707905	707706	707906	V350256906L1C005R04100159913_chr1_707705	73	60	CACA	aaac
V350256906L1C005R04100330647	chr1	551947	50M	199	552146	551948	552147	V350256906L1C005R04100330647_chr1_551947	58	17	cttc	AGAG
V350256906L1C005R04100359994	chr1	376196	50M	160	376356	376197	376357	V350256906L1C005R04100359994_chr1_376196	0	6	ggct	aagg
V350256906L1C005R04100679510	chr1	883457	50M	191	883648	883458	883649	V350256906L1C005R04100679510_chr1_883457	5	0	CCCG	CCCT
V350256906L1C005R04101250709	chr1	795433	50M	171	795604	795434	795605	V350256906L1C005R04101250709_chr1_795433	45	58	TCCA	ccct
V350256906L1C005R04101325238	chr1	806984	50M	202	807186	806985	807187	V350256906L1C005R04101325238_chr1_806984	18	0	tgca	CTAC
V350256906L1C005R04200202551	chr1	464091	50M	206	464297	464092	464298	V350256906L1C005R04200202551_chr1_464091	36	69	AACA	TGTC
V350256906L1C005R04200384879	chr1	230968	50M	191	231159	230969	231160	V350256906L1C005R04200384879_chr1_230968	25	69	cccc	tcaa
V350256906L1C005R04200490713	chr1	258973	50M	189	259162	258974	259163	V350256906L1C005R04200490713_chr1_258973	61	58	CACG	CCAA
V350256906L1C005R04200669185	chr1	561840	50M	150	561990	561841	561991	V350256906L1C005R04200669185_chr1_561840	54	26	AGTT	caca
V350256906L1C005R04200765995	chr1	416060	50M	139	416199	416061	416200	V350256906L1C005R04200765995_chr1_416060	24	0	GACA	CCTT
V350256906L1C005R04200834471	chr1	1315091	50M	177	1315268	1315092	1315269	V350256906L1C005R04200834471_chr1_1315091	15	33	tgaa	agtc
V350256906L1C005R04201201148	chr1	320484	50M	199	320683	320485	320684	V350256906L1C005R04201201148_chr1_320484	165	0	CTTA	ccct
V350256906L1C005R04300147066	chr1	666157	50M	172	666329	666158	666330	V350256906L1C005R04300147066_chr1_666157	0	0	ccaa	GTTG
V350256906L1C005R04300178475	chr1	105715	50M	187	105902	105716	105903	V350256906L1C005R04300178475_chr1_105715	155	9	caat	TTTA
V350256906L1C005R04300372444	chr1	102425	50M	213	102638	102426	102639	V350256906L1C005R04300372444_chr1_102425	118	0	CCCT	gaaa
V350256906L1C005R04300423760	chr1	430378	50M	173	430551	430379	430552	V350256906L1C005R04300423760_chr1_430378	0	141	gttt	tgag
V350256906L1C005R04300947109	chr1	555474	50M	142	555616	555475	555617	V350256906L1C005R04300947109_chr1_555474	81	37	aCAG	ctga
V350256906L1C005R04301047024	chr1	1191792	50M	183	1191975	1191793	1191976	V350256906L1C005R04301047024_chr1_1191792	0	0	CGCC	GCCT
V350256906L1C005R04301188668	chr1	51334	50M	210	51544	51335	51545	V350256906L1C005R04301188668_chr1_51334	40	12	CCCT	ACAC
V350256906L1C005R04301201180	chr1	784857	50M	180	785037	784858	785038	V350256906L1C005R04301201180_chr1_784857	29	16	CTTT	cttc
V350256906L1C005R04301201873	chr1	730187	50M	176	730363	730188	730364	V350256906L1C005R04301201873_chr1_730187	0	0	TGTG	CAAG
V350256906L1C005R04400158546	chr1	673107	50M	201	673308	673108	673309	V350256906L1C005R04400158546_chr1_673107	26	44	caga	ccca
V350256906L1C005R04400361527	chr1	92946	50M	134	93080	92947	93081	V350256906L1C005R04400361527_chr1_92946	45	62	GCTG	ACAG
V350256906L1C005R04400761839	chr1	844236	50M	249	844485	844237	844486	V350256906L1C005R04400761839_chr1_844236	630	381	GGCC	CCCC
V350256906L1C005R04400834118	chr1	1109815	50M	174	1109989	1109816	1109990	V350256906L1C005R04400834118_chr1_1109815	0	0	TCTT	AAGC
V350256906L1C005R04500614782	chr1	74372	50M	171	74543	74373	74544	V350256906L1C005R04500614782_chr1_74372	173	344	ggct	gtta
V350256906L1C005R04500633269	chr1	73228	50M	146	73374	73229	73375	V350256906L1C005R04500633269_chr1_73228	38	23	cgat	caaa
V350256906L1C005R04501100894	chr1	75532	50M	166	75698	75533	75699	V350256906L1C005R04501100894_chr1_75532	106	233	catg	tagg
V350256906L1C005R04600213833	chr1	1388440	50M	223	1388663	1388441	1388664	V350256906L1C005R04600213833_chr1_1388440	4	0	CGTG	tgca
V350256906L1C005R04600622902	chr1	559877	50M	154	560031	559878	560032	V350256906L1C005R04600622902_chr1_559877	59	11	aagg	tact
V350256906L1C005R04600822331	chr1	49452	50M	157	49609	49453	49610	V350256906L1C005R04600822331_chr1_49452	17	15	catg	AAAA
V350256906L1C005R04600983780	chr1	747845	50M	210	748055	747846	748056	V350256906L1C005R04600983780_chr1_747845	78	96	ccag	gtca
V350256906L1C005R04601007726	chr1	109853	50M	170	110023	109854	110024	V350256906L1C005R04601007726_chr1_109853	40	51	gata	AAAG
V350256906L1C005R04601390749	chr1	558888	50M	197	559085	558889	559086	V350256906L1C005R04601390749_chr1_558888	54	14	CACT	GCTC
V350256906L1C005R04700137323	chr1	699013	50M	173	699186	699014	699187	V350256906L1C005R04700137323_chr1_699013	60	50	GAGA	CTTT
V350256906L1C005R04700249478	chr1	161291	50M	150	161441	161292	161442	V350256906L1C005R04700249478_chr1_161291	163	13	CAAA	tcat
V350256906L1C005R04700533330	chr1	424743	50M	170	424913	424744	424914	V350256906L1C005R04700533330_chr1_424743	53	91	tcct	tgtg
V350256906L1C005R04700581013	chr1	1423057	50M	165	1423222	1423058	1423223	V350256906L1C005R04700581013_chr1_1423057	43	84	CGTG	AGCA
V350256906L1C005R04700618245	chr1	97629	50M	201	97830	97630	97831	V350256906L1C005R04700618245_chr1_97629	59	60	CCAT	ccta
V350256906L1C005R04700767945	chr1	872852	50M	141	872993	872853	872994	V350256906L1C005R04700767945_chr1_872852	67	17	CCAC	CGGT
V350256906L1C005R04701357371	chr1	759453	50M	162	759615	759454	759616	V350256906L1C005R04701357371_chr1_759453	62	43	aCAA	ACAC
V350256906L1C005R04800441482	chr1	725787	5S45M	183	725970	725788	725971	V350256906L1C005R04800441482_chr1_725787	96	45	gact	ttcc
V350256906L1C005R04800620930	chr1	626215	50M	176	626391	626216	626392	V350256906L1C005R04800620930_chr1_626215	59	55	atta	tgtg
V350256906L1C005R04800913928	chr1	470499	50M	205	470704	470500	470705	V350256906L1C005R04800913928_chr1_470499	22	67	ccag	cttt
V350256906L1C005R04900349066	chr1	259311	50M	173	259484	259312	259485	V350256906L1C005R04900349066_chr1_259311	51	35	TAAT	CCTG
V350256906L1C005R04900687109	chr1	591282	50M	172	591454	591283	591455	V350256906L1C005R04900687109_chr1_591282	68	90	ttaa	tgtt
V350256906L1C005R04900820056	chr1	749919	50M	147	750066	749920	750067	V350256906L1C005R04900820056_chr1_749919	257	110	AGAA	TCCT
V350256906L1C005R04901050344	chr1	1228861	50M	163	1229024	1228862	1229025	V350256906L1C005R04901050344_chr1_1228861	66	48	CCGC	CCCT
V350256906L1C005R05000325205	chr1	1207440	50M	174	1207614	1207441	1207615	V350256906L1C005R05000325205_chr1_1207440	0	10	ggga	GGGG
V350256906L1C005R05000839602	chr1	100087	50M	172	100259	100088	100260	V350256906L1C005R05000839602_chr1_100087	56	33	gtaa	tgat
V350256906L1C005R05001035537	chr1	972936	50M	175	973111	972937	973112	V350256906L1C005R05001035537_chr1_972936	55	89	GGAG	CCCA
V350256906L1C005R05100053735	chr1	1150883	50M	163	1151046	1150884	1151047	V350256906L1C005R05100053735_chr1_1150883	2	0	CCCA	CCCC
V350256906L1C005R05100682965	chr1	1083860	50M	222	1084082	1083861	1084083	V350256906L1C005R05100682965_chr1_1083860	66	46	gaGG	CCTC
V350256906L1C005R05100738410	chr1	917328	50M	260	917588	917329	917589	V350256906L1C005R05100738410_chr1_917328	43	70	TGGT	CCCT
V350256906L1C005R05100858785	chr1	1425972	50M	177	1426149	1425973	1426150	V350256906L1C005R05100858785_chr1_1425972	0	2	GGAG	CCCA
V350256906L1C005R05100957405	chr1	1363966	50M	167	1364133	1363967	1364134	V350256906L1C005R05100957405_chr1_1363966	66	55	GTCC	ctgg
V350256906L1C005R05101398555	chr1	1006720	50M	161	1006881	1006721	1006882	V350256906L1C005R05101398555_chr1_1006720	79	56	ggct	tgag
V350256906L1C005R05200474015	chr1	14765	50M	141	14906	14766	14907	V350256906L1C005R05200474015_chr1_14765	172	268	GTCT	CCTG
V350256906L1C005R05200526470	chr1	34616	50M	159	34775	34617	34776	V350256906L1C005R05200526470_chr1_34616	8	133	gctt	ctcc
V350256906L1C005R05200833190	chr1	636043	50M	191	636234	636044	636235	V350256906L1C005R05200833190_chr1_636043	135	0	cgga	tgga
V350256906L1C005R05201345095	chr1	399849	50M	164	400013	399850	400014	V350256906L1C005R05201345095_chr1_399849	9	104	atgt	ttta
V350256906L1C005R05300262179	chr1	85259	50M	178	85437	85260	85438	V350256906L1C005R05300262179_chr1_85259	0	165	tcac	accc
V350256906L1C005R05300306279	chr1	1424723	50M	168	1424891	1424724	1424892	V350256906L1C005R05300306279_chr1_1424723	57	0	AGGG	GGCG
V350256906L1C005R05300355719	chr1	1389192	50M	168	1389360	1389193	1389361	V350256906L1C005R05300355719_chr1_1389192	28	51	tgta	ACCC
V350256906L1C005R05300375518	chr1	769441	50M	233	769674	769442	769675	V350256906L1C005R05300375518_chr1_769441	155	242	TGTT	GTGC
V350256906L1C005R05300547454	chr1	576912	50M	180	577092	576913	577093	V350256906L1C005R05300547454_chr1_576912	33	30	CCAA	AGGC
V350256906L1C005R05300577540	chr1	1337332	50M	187	1337519	1337333	1337520	V350256906L1C005R05300577540_chr1_1337332	66	68	CTGT	TGGG
V350256906L1C005R05301020636	chr1	350921	50M	144	351065	350922	351066	V350256906L1C005R05301020636_chr1_350921	0	50	gata	cttt
V350256906L1C005R05301108149	chr1	235527	50M	177	235704	235528	235705	V350256906L1C005R05301108149_chr1_235527	123	124	CACC	CCAG
V350256906L1C005R05400027618	chr1	787011	50M	188	787199	787012	787200	V350256906L1C005R05400027618_chr1_787011	50	25	TGAG	ATTA
V350256906L1C005R05400410003	chr1	779024	50M	165	779189	779025	779190	V350256906L1C005R05400410003_chr1_779024	46	148	AGAT	CCTG
V350256906L1C005R05400501592	chr1	80220	50M	175	80395	80221	80396	V350256906L1C005R05400501592_chr1_80220	53	47	acac	tcta
V350256906L1C005R05400550531	chr1	1385589	50M	131	1385720	1385590	1385721	V350256906L1C005R05400550531_chr1_1385589	93	2	cagc	tttt
V350256906L1C005R05400690870	chr1	523395	50M	162	523557	523396	523558	V350256906L1C005R05400690870_chr1_523395	62	31	ATGG	GCCT
V350256906L1C005R05400867776	chr1	67918	50M	169	68087	67919	68088	V350256906L1C005R05400867776_chr1_67918	39	55	TCCC	cttt
V350256906L1C005R05401363314	chr1	718914	50M	183	719097	718915	719098	V350256906L1C005R05401363314_chr1_718914	9	42	AAAT	gttt
V350256906L1C005R05401389524	chr1	1267392	50M	183	1267575	1267393	1267576	V350256906L1C005R05401389524_chr1_1267392	46	81	TGGC	CTGC
V350256906L1C005R05500177669	chr1	151416	50M	176	151592	151417	151593	V350256906L1C005R05500177669_chr1_151416	77	76	aaca	gagg
V350256906L1C005R05500857696	chr1	953615	50M	162	953777	953616	953778	V350256906L1C005R05500857696_chr1_953615	182	20	gccc	cctg
V350256906L1C005R05500885885	chr1	111257	50M	170	111427	111258	111428	V350256906L1C005R05500885885_chr1_111257	0	0	ggga	ACAC
V350256906L1C005R05500939072	chr1	793564	50M	189	793753	793565	793754	V350256906L1C005R05500939072_chr1_793564	22	9	GGTA	TACA
V350256906L1C005R05501216010	chr1	229805	4S46M	185	229990	229806	229991	V350256906L1C005R05501216010_chr1_229805	6	0	taaa	cagc
V350256906L1C005R05600194523	chr1	774361	50M	144	774505	774362	774506	V350256906L1C005R05600194523_chr1_774361	111	255	caat	attc
V350256906L1C005R05600246391	chr1	232433	50M	187	232620	232434	232621	V350256906L1C005R05600246391_chr1_232433	16	8	gctt	GCAC
V350256906L1C005R05600250254	chr1	64184	50M	163	64347	64185	64348	V350256906L1C005R05600250254_chr1_64184	53	70	CCTA	CTTA
V350256906L1C005R05600336616	chr1	1101978	50M	159	1102137	1101979	1102138	V350256906L1C005R05600336616_chr1_1101978	33	38	GAGA	CCCC
V350256906L1C005R05600538093	chr1	1329662	50M	162	1329824	1329663	1329825	V350256906L1C005R05600538093_chr1_1329662	64	42	TCCA	CTTT
V350256906L1C005R05600762777	chr1	451897	50M	166	452063	451898	452064	V350256906L1C005R05600762777_chr1_451897	9	34	gtag	ctca
V350256906L1C005R05600780099	chr1	708096	50M	162	708258	708097	708259	V350256906L1C005R05600780099_chr1_708096	66	49	GGGT	CTTC
V350256906L1C005R05700142752	chr1	824497	50M	190	824687	824498	824688	V350256906L1C005R05700142752_chr1_824497	77	50	ggga	tagg
V350256906L1C005R05700360793	chr1	115879	50M	191	116070	115880	116071	V350256906L1C005R05700360793_chr1_115879	24	12	cctg	caga
V350256906L1C005R05700511017	chr1	562913	50M	176	563089	562914	563090	V350256906L1C005R05700511017_chr1_562913	24	47	AGAA	GTCT
V350256906L1C005R05700511440	chr1	144957	50M	168	145125	144958	145126	V350256906L1C005R05700511440_chr1_144957	427	259	gaca	ctaa
V350256906L1C005R05700663570	chr1	54644	50M	160	54804	54645	54805	V350256906L1C005R05700663570_chr1_54644	21	181	ccct	tgaa
V350256906L1C005R05700768667	chr1	351117	50M	204	351321	351118	351322	V350256906L1C005R05700768667_chr1_351117	0	148	aaaa	TATA
V350256906L1C005R05700853564	chr1	777540	50M	183	777723	777541	777724	V350256906L1C005R05700853564_chr1_777540	56	0	CTCA	CCTC
V350256906L1C005R05700860462	chr1	873687	50M	173	873860	873688	873861	V350256906L1C005R05700860462_chr1_873687	121	29	CCTG	CGTC
V350256906L1C005R05701082013	chr1	175102	50M	113	175215	175103	175216	V350256906L1C005R05701082013_chr1_175102	125	238	TACA	cggc
V350256906L1C005R05701232391	chr1	1255171	50M	178	1255349	1255172	1255350	V350256906L1C005R05701232391_chr1_1255171	17	20	cgcg	CCTC
V350256906L1C005R05701258797	chr1	820297	50M	196	820493	820298	820494	V350256906L1C005R05701258797_chr1_820297	54	122	acaa	tgac
V350256906L1C005R05701298005	chr1	14796	50M	179	14975	14797	14976	V350256906L1C005R05701298005_chr1_14796	203	199	CCCT	CAAG
V350256906L1C005R05800027776	chr1	117435	50M	169	117604	117436	117605	V350256906L1C005R05800027776_chr1_117435	55	76	gctt	ccta
V350256906L1C005R05800233103	chr1	115687	50M	173	115860	115688	115861	V350256906L1C005R05800233103_chr1_115687	59	43	caag	gcag
V350256906L1C005R05800632658	chr1	170116	50M	156	170272	170117	170273	V350256906L1C005R05800632658_chr1_170116	88	244	gctg	CACT
V350256906L1C005R05800925926	chr1	1031449	50M	126	1031575	1031450	1031576	V350256906L1C005R05800925926_chr1_1031449	28	0	gcca	ccta
V350256906L1C005R05801366593	chr1	21230	50M	169	21399	21231	21400	V350256906L1C005R05801366593_chr1_21230	85	52	GGCT	AGAG
V350256906L1C005R05801395064	chr1	1383307	50M	182	1383489	1383308	1383490	V350256906L1C005R05801395064_chr1_1383307	48	14	ggct	ctca
V350256906L1C005R05900090097	chr1	22415	50M	172	22587	22416	22588	V350256906L1C005R05900090097_chr1_22415	38	43	CACC	CACC
V350256906L1C005R05900498631	chr1	1047709	50M	180	1047889	1047710	1047890	V350256906L1C005R05900498631_chr1_1047709	17	197	acag	CGTG
V350256906L1C005R05900993025	chr1	96697	50M	197	96894	96698	96895	V350256906L1C005R05900993025_chr1_96697	37	62	CCAG	CCCA
V350256906L1C005R05901055852	chr1	143321	50M	171	143492	143322	143493	V350256906L1C005R05901055852_chr1_143321	151	246	ctta	cctg
V350256906L1C005R06000195605	chr1	621899	50M	151	622050	621900	622051	V350256906L1C005R06000195605_chr1_621899	0	7	CAAT	CAGT
V350256906L1C005R06001089895	chr1	139285	50M	180	139465	139286	139466	V350256906L1C005R06001089895_chr1_139285	3	161	TGGC	AAGT
V350256906L1C005R06001119388	chr1	253298	50M	129	253427	253299	253428	V350256906L1C005R06001119388_chr1_253298	25	0	CTTG	GAAG
V350256906L1C005R06100476875	chr1	245255	50M	178	245433	245256	245434	V350256906L1C005R06100476875_chr1_245255	79	12	CAGG	ccaa
V350256906L1C005R06100612262	chr1	1366990	50M	175	1367165	1366991	1367166	V350256906L1C005R06100612262_chr1_1366990	11	26	CGAG	AGTG
V350256906L1C005R06101104776	chr1	935338	50M	132	935470	935339	935471	V350256906L1C005R06101104776_chr1_935338	56	4	GCGT	GGAG
V350256906L1C005R06101214246	chr1	165282	50M	160	165442	165283	165443	V350256906L1C005R06101214246_chr1_165282	55	82	acct	CTTG
V350256906L1C005R06200282875	chr1	255354	50M	161	255515	255355	255516	V350256906L1C005R06200282875_chr1_255354	28	0	CTTG	GGGC
V350256906L1C005R06200302861	chr1	534482	50M	126	534608	534483	534609	V350256906L1C005R06200302861_chr1_534482	6	44	agtc	aagg
V350256906L1C005R06200518073	chr1	726006	50M	157	726163	726007	726164	V350256906L1C005R06200518073_chr1_726006	81	86	ggac	catg
V350256906L1C005R06200583123	chr1	1322055	50M	169	1322224	1322056	1322225	V350256906L1C005R06200583123_chr1_1322055	45	62	GGAT	AGAT
V350256906L1C005R06201244478	chr1	144884	50M	170	145054	144885	145055	V350256906L1C005R06201244478_chr1_144884	355	330	tctc	caag
V350256906L1C005R06300025212	chr1	727522	50M	217	727739	727523	727740	V350256906L1C005R06300025212_chr1_727522	63	84	ATTA	GCCC
V350256906L1C005R06300532172	chr1	922781	50M	171	922952	922782	922953	V350256906L1C005R06300532172_chr1_922781	0	164	cctc	gctc
V350256906L1C005R06300950040	chr1	733270	50M	170	733440	733271	733441	V350256906L1C005R06300950040_chr1_733270	243	107	CCTA	TAAC
V350256906L1C005R06301143387	chr1	632463	50M	217	632680	632464	632681	V350256906L1C005R06301143387_chr1_632463	60	123	tata	cctt
V350256906L1C005R06400052119	chr1	590000	50M	110	590110	590001	590111	V350256906L1C005R06400052119_chr1_590000	20	19	aaat	caat
V350256906L1C005R06400229309	chr1	1353615	50M	176	1353791	1353616	1353792	V350256906L1C005R06400229309_chr1_1353615	41	58	accc	tgag
V350256906L1C005R06400527724	chr1	35825	50M	185	36010	35826	36011	V350256906L1C005R06400527724_chr1_35825	30	133	CACA	GCCA
V350256906L1C005R06401178504	chr1	237735	50M	225	237960	237736	237961	V350256906L1C005R06401178504_chr1_237735	57	71	CCTC	ccag
V350256906L1C005R06401256472	chr1	260361	50M	167	260528	260362	260529	V350256906L1C005R06401256472_chr1_260361	17	46	aaga	gtaa
V350256906L1C005R06500206436	chr1	942823	50M	155	942978	942824	942979	V350256906L1C005R06500206436_chr1_942823	23	0	gctg	tttc
V350256906L1C005R06500662607	chr1	148859	50M	168	149027	148860	149028	V350256906L1C005R06500662607_chr1_148859	57	75	cttg	tcat
V350256906L1C005R06500738083	chr1	744165	50M	173	744338	744166	744339	V350256906L1C005R06500738083_chr1_744165	60	81	TCTT	ACAG
V350256906L1C005R06500829409	chr1	13634	50M	171	13805	13635	13806	V350256906L1C005R06500829409_chr1_13634	225	54	CATT	GGAC
V350256906L1C005R06500846469	chr1	719694	50M	193	719887	719695	719888	V350256906L1C005R06500846469_chr1_719694	0	0	agag	gctt
V350256906L1C005R06501122756	chr1	834854	50M	160	835014	834855	835015	V350256906L1C005R06501122756_chr1_834854	67	45	CCAA	GGCT
V350256906L1C005R06501140119	chr1	741596	50M	157	741753	741597	741754	V350256906L1C005R06501140119_chr1_741596	57	36	TAAA	CCAT
V350256906L1C005R06501400708	chr1	396137	50M	164	396301	396138	396302	V350256906L1C005R06501400708_chr1_396137	50	0	agat	gaat
V350256906L1C005R06600095623	chr1	817193	50M	196	817389	817194	817390	V350256906L1C005R06600095623_chr1_817193	88	263	TCTT	CCCA
V350256906L1C005R06600407579	chr1	97375	50M	163	97538	97376	97539	V350256906L1C005R06600407579_chr1_97375	0	0	TTTG	TTAA
V350256906L1C005R06600714713	chr1	174062	50M	183	174245	174063	174246	V350256906L1C005R06600714713_chr1_174062	54	37	TGCT	TTTC
V350256906L1C005R06600855514	chr1	115687	50M	159	115846	115688	115847	V350256906L1C005R06600855514_chr1_115687	59	57	caag	tgct
V350256906L1C005R06700387145	chr1	699341	50M	176	699517	699342	699518	V350256906L1C005R06700387145_chr1_699341	21	23	CTGA	TAAT
V350256906L1C005R06700400674	chr1	765322	50M	182	765504	765323	765505	V350256906L1C005R06700400674_chr1_765322	230	48	cttg	tcac
V350256906L1C005R06701247581	chr1	1192526	50M	162	1192688	1192527	1192689	V350256906L1C005R06701247581_chr1_1192526	10	5	CCCG	GCTA
V350256906L1C005R06701390376	chr1	91179	50M	171	91350	91180	91351	V350256906L1C005R06701390376_chr1_91179	57	22	ggag	CTTT
V350256906L1C005R06800013243	chr1	1266446	50M	167	1266613	1266447	1266614	V350256906L1C005R06800013243_chr1_1266446	18	0	CCAC	TCCT
V350256906L1C005R06800014945	chr1	1067735	50M	149	1067884	1067736	1067885	V350256906L1C005R06800014945_chr1_1067735	67	34	TGGG	CCCT
V350256906L1C005R06800358020	chr1	1027996	50M	168	1028164	1027997	1028165	V350256906L1C005R06800358020_chr1_1027996	201	111	CCTA	CCTG
V350256906L1C005R06800727668	chr1	1140534	50M	192	1140726	1140535	1140727	V350256906L1C005R06800727668_chr1_1140534	47	64	GGAT	AGTC
V350256906L1C005R06800855542	chr1	24588	50M	134	24722	24589	24723	V350256906L1C005R06800855542_chr1_24588	186	52	TCTC	ACCC
V350256906L1C005R06800905712	chr1	638504	50M	170	638674	638505	638675	V350256906L1C005R06800905712_chr1_638504	34	80	gcac	gatg
V350256906L1C005R06801044271	chr1	1168967	50M	176	1169143	1168968	1169144	V350256906L1C005R06801044271_chr1_1168967	15	21	CTGC	ATGT
V350256906L1C005R06801112409	chr1	756917	50M	167	757084	756918	757085	V350256906L1C005R06801112409_chr1_756917	10	31	CCAC	GGCC
V350256906L1C005R06801245529	chr1	450862	50M	159	451021	450863	451022	V350256906L1C005R06801245529_chr1_450862	96	110	ctgg	cctt
V350256906L1C005R06900322362	chr1	237313	50M	159	237472	237314	237473	V350256906L1C005R06900322362_chr1_237313	51	15	aagg	gcaa
V350256906L1C005R06900834233	chr1	1149177	50M	175	1149352	1149178	1149353	V350256906L1C005R06900834233_chr1_1149177	19	35	GCCG	GGAG
V350256906L1C005R06900900337	chr1	1281272	50M	201	1281473	1281273	1281474	V350256906L1C005R06900900337_chr1_1281272	0	14	CCAA	cagc
V350256906L1C005R06900998844	chr1	176814	50M	202	177016	176815	177017	V350256906L1C005R06900998844_chr1_176814	54	73	GGGG	CCAC
V350256906L1C005R06901026095	chr1	1148326	50M	177	1148503	1148327	1148504	V350256906L1C005R06901026095_chr1_1148326	16	0	GCCG	GACC
V350256906L1C005R06901083541	chr1	815099	50M	165	815264	815100	815265	V350256906L1C005R06901083541_chr1_815099	59	66	tatt	cctg
V350256906L1C005R07000062577	chr1	1068504	50M	158	1068662	1068505	1068663	V350256906L1C005R07000062577_chr1_1068504	86	42	CCTG	CCAC
V350256906L1C005R07000138550	chr1	665686	50M	170	665856	665687	665857	V350256906L1C005R07000138550_chr1_665686	214	150	CCCA	CCCA
V350256906L1C005R07000843040	chr1	1183062	50M	183	1183245	1183063	1183246	V350256906L1C005R07000843040_chr1_1183062	24	12	CCGG	TGCA
V350256906L1C005R07000894498	chr1	724990	21S24M5S	139	725129	724991	725130	V350256906L1C005R07000894498_chr1_724990	20	140	tgga	ttca
V350256906L1C005R07000910495	chr1	132904	50M	201	133105	132905	133106	V350256906L1C005R07000910495_chr1_132904	45	0	AGGC	CACA
V350256906L1C005R07000982635	chr1	58842	50M	162	59004	58843	59005	V350256906L1C005R07000982635_chr1_58842	78	33	CTTC	CCCA
V350256906L1C005R07001102675	chr1	668031	50M	155	668186	668032	668187	V350256906L1C005R07001102675_chr1_668031	4	0	GTTT	CTTG
V350256906L1C005R07001147601	chr1	702667	50M	178	702845	702668	702846	V350256906L1C005R07001147601_chr1_702667	46	60	AATT	CACC
V350256906L1C005R07100138130	chr1	731657	50M	175	731832	731658	731833	V350256906L1C005R07100138130_chr1_731657	70	79	CACA	GGAC
V350256906L1C005R07100285679	chr1	33571	50M	196	33767	33572	33768	V350256906L1C005R07100285679_chr1_33571	34	140	taat	tctc
V350256906L1C005R07100589548	chr1	1263740	50M	197	1263937	1263741	1263938	V350256906L1C005R07100589548_chr1_1263740	100	69	TGCC	GCTC
V350256906L1C005R07100894294	chr1	1119342	50M	160	1119502	1119343	1119503	V350256906L1C005R07100894294_chr1_1119342	109	269	CGTG	AGGG
V350256906L1C005R07101140618	chr1	828867	50M	177	829044	828868	829045	V350256906L1C005R07101140618_chr1_828867	38	37	gcac	ctgg
V350256906L1C005R07200182193	chr1	241263	50M	183	241446	241264	241447	V350256906L1C005R07200182193_chr1_241263	57	66	cgcc	CACT
V350256906L1C005R07200314719	chr1	1114011	50M	158	1114169	1114012	1114170	V350256906L1C005R07200314719_chr1_1114011	0	0	GAAA	CCCA
V350256906L1C005R07200589606	chr1	1140684	50M	198	1140882	1140685	1140883	V350256906L1C005R07200589606_chr1_1140684	22	55	CTCT	CCTG
V350256906L1C005R07200671958	chr1	1182273	50M	169	1182442	1182274	1182443	V350256906L1C005R07200671958_chr1_1182273	17	0	CCAG	GTGG
V350256906L1C005R07200704648	chr1	1093903	50M	170	1094073	1093904	1094074	V350256906L1C005R07200704648_chr1_1093903	57	73	GGAG	CCAC
V350256906L1C005R07200819461	chr1	1116558	50M	186	1116744	1116559	1116745	V350256906L1C005R07200819461_chr1_1116558	60	49	CGTC	CCCA
V350256906L1C005R07201310848	chr1	1334717	50M	107	1334824	1334718	1334825	V350256906L1C005R07201310848_chr1_1334717	47	0	CCCT	GCCA
V350256906L1C006R00200091260	chr1	60978	50M	187	61165	60979	61166	V350256906L1C006R00200091260_chr1_60978	108	152	AGCA	GTTA
V350256906L1C006R00200200030	chr1	10243	50M	197	10440	10244	10441	V350256906L1C006R00200200030_chr1_10243	280	83	accc	ttag
V350256906L1C006R00200293013	chr1	1384678	50M	161	1384839	1384679	1384840	V350256906L1C006R00200293013_chr1_1384678	153	0	cctc	gaag
V350256906L1C006R00200465239	chr1	709813	50M	190	710003	709814	710004	V350256906L1C006R00200465239_chr1_709813	90	78	AGTT	TGAA
V350256906L1C006R00200702056	chr1	611087	50M	156	611243	611088	611244	V350256906L1C006R00200702056_chr1_611087	41	7	CTTG	CTGA
V350256906L1C006R00201101310	chr1	733605	50M	190	733795	733606	733796	V350256906L1C006R00201101310_chr1_733605	19	44	ATAT	CTGA
V350256906L1C006R00201377529	chr1	14745	50M	176	14921	14746	14922	V350256906L1C006R00201377529_chr1_14745	152	253	GGCG	TCCT
V350256906L1C006R00300228344	chr1	624511	50M	136	624647	624512	624648	V350256906L1C006R00300228344_chr1_624511	23	71	AACA	CCTC
V350256906L1C006R00301079708	chr1	1059119	50M	169	1059288	1059120	1059289	V350256906L1C006R00301079708_chr1_1059119	24	32	ccat	agtg
V350256906L1C006R00301270512	chr1	543253	50M	162	543415	543254	543416	V350256906L1C006R00301270512_chr1_543253	28	53	atca	CACG
V350256906L1C006R00301305683	chr1	1196512	50M	171	1196683	1196513	1196684	V350256906L1C006R00301305683_chr1_1196512	91	110	cggc	TTCA
V350256906L1C006R00400125851	chr1	759591	50M	171	759762	759592	759763	V350256906L1C006R00400125851_chr1_759591	47	0	AGAC	TTAT
V350256906L1C006R00400132986	chr1	876471	50M	175	876646	876472	876647	V350256906L1C006R00400132986_chr1_876471	37	23	GGGA	CCGG
V350256906L1C006R00400962417	chr1	634515	50M	164	634679	634516	634680	V350256906L1C006R00400962417_chr1_634515	0	82	gact	accg
V350256906L1C006R00400967550	chr1	961867	50M	167	962034	961868	962035	V350256906L1C006R00400967550_chr1_961867	60	64	CTGA	CAGA
V350256906L1C006R00401115541	chr1	944310	50M	155	944465	944311	944466	V350256906L1C006R00401115541_chr1_944310	62	55	ccat	cttt
V350256906L1C006R00401344020	chr1	235623	50M	205	235828	235624	235829	V350256906L1C006R00401344020_chr1_235623	205	0	GCCC	GACA
V350256906L1C006R00401378824	chr1	369341	50M	145	369486	369342	369487	V350256906L1C006R00401378824_chr1_369341	53	25	tttc	GGTA
V350256906L1C006R00500054403	chr1	390247	50M	168	390415	390248	390416	V350256906L1C006R00500054403_chr1_390247	26	44	tagc	acac
V350256906L1C006R00500217852	chr1	745598	50M	168	745766	745599	745767	V350256906L1C006R00500217852_chr1_745598	56	64	CATT	ATTC
V350256906L1C006R00500261528	chr1	1389347	50M	168	1389515	1389348	1389516	V350256906L1C006R00500261528_chr1_1389347	64	45	AGAG	GGGC
V350256906L1C006R00500557631	chr1	120243	50M	168	120411	120244	120412	V350256906L1C006R00500557631_chr1_120243	66	70	TAAT	TATT
V350256906L1C006R00500927357	chr1	1112693	50M	160	1112853	1112694	1112854	V350256906L1C006R00500927357_chr1_1112693	38	26	tCAt	gggc
V350256906L1C006R00501122757	chr1	1038209	50M	161	1038370	1038210	1038371	V350256906L1C006R00501122757_chr1_1038209	15	92	tgtt	gggc
V350256906L1C006R00600003110	chr1	46320	50M	156	46476	46321	46477	V350256906L1C006R00600003110_chr1_46320	56	60	ATGT	cctt
V350256906L1C006R00600145814	chr1	382148	50M	180	382328	382149	382329	V350256906L1C006R00600145814_chr1_382148	62	67	gctc	atac
V350256906L1C006R00600419336	chr1	663763	50M	161	663924	663764	663925	V350256906L1C006R00600419336_chr1_663763	6	0	TGAG	CTGT
V350256906L1C006R00600510124	chr1	232520	50M	195	232715	232521	232716	V350256906L1C006R00600510124_chr1_232520	32	23	TGTT	ACAA
V350256906L1C006R00600737336	chr1	727314	50M	163	727477	727315	727478	V350256906L1C006R00600737336_chr1_727314	63	18	ccag	GTTG
V350256906L1C006R00600944291	chr1	1193375	50M	179	1193554	1193376	1193555	V350256906L1C006R00600944291_chr1_1193375	80	74	AAGA	caac
V350256906L1C006R00600985561	chr1	1127345	50M	161	1127506	1127346	1127507	V350256906L1C006R00600985561_chr1_1127345	75	3	ttgc	aaca
V350256906L1C006R00601097485	chr1	981095	50M	157	981252	981096	981253	V350256906L1C006R00601097485_chr1_981095	8	0	CCCC	TCAC
V350256906L1C006R00601176959	chr1	809358	50M	169	809527	809359	809528	V350256906L1C006R00601176959_chr1_809358	46	0	CCCA	AGAG
V350256906L1C006R00700071938	chr1	1313759	50M	155	1313914	1313760	1313915	V350256906L1C006R00700071938_chr1_1313759	0	0	ttca	ctgg
V350256906L1C006R00700315513	chr1	171077	50M	149	171226	171078	171227	V350256906L1C006R00700315513_chr1_171077	305	156	ttac	gtgg
V350256906L1C006R00700394275	chr1	1108183	50M	208	1108391	1108184	1108392	V350256906L1C006R00700394275_chr1_1108183	0	153	atat	tttt
V350256906L1C006R00700572197	chr1	1195439	50M	183	1195622	1195440	1195623	V350256906L1C006R00700572197_chr1_1195439	53	31	GCAG	GTGT
V350256906L1C006R00700589213	chr1	76745	50M	200	76945	76746	76946	V350256906L1C006R00700589213_chr1_76745	0	0	tggc	cctc
V350256906L1C006R00800138566	chr1	790195	50M	211	790406	790196	790407	V350256906L1C006R00800138566_chr1_790195	65	68	GGTA	GGAG
V350256906L1C006R00800408363	chr1	101842	50M	158	102000	101843	102001	V350256906L1C006R00800408363_chr1_101842	105	19	atct	ccca
V350256906L1C006R00800489013	chr1	883768	50M	170	883938	883769	883939	V350256906L1C006R00800489013_chr1_883768	54	69	CATG	CCAA
V350256906L1C006R00800540950	chr1	595678	50M	182	595860	595679	595861	V350256906L1C006R00800540950_chr1_595678	44	87	ctca	agtg
V350256906L1C006R00800790345	chr1	702635	50M	118	702753	702636	702754	V350256906L1C006R00800790345_chr1_702635	46	0	GTTT	CCAG
V350256906L1C006R00800884800	chr1	248456	50M	174	248630	248457	248631	V350256906L1C006R00800884800_chr1_248456	7	0	agaa	CCTG
V350256906L1C006R00801042917	chr1	766328	50M	164	766492	766329	766493	V350256906L1C006R00801042917_chr1_766328	0	0	cgtc	ccaC
V350256906L1C006R00801276159	chr1	815197	50M	167	815364	815198	815365	V350256906L1C006R00801276159_chr1_815197	0	0	tgtc	gtat
V350256906L1C006R00801321171	chr1	18338	50M	127	18465	18339	18466	V350256906L1C006R00801321171_chr1_18338	45	58	GCCT	CCTG
V350256906L1C006R00900011229	chr1	266408	50M	189	266597	266409	266598	V350256906L1C006R00900011229_chr1_266408	27	43	TGTA	CTGA
V350256906L1C006R00900019213	chr1	1282532	50M	144	1282676	1282533	1282677	V350256906L1C006R00900019213_chr1_1282532	59	45	CCAG	CCAG
V350256906L1C006R00900033749	chr1	1005322	50M	260	1005582	1005323	1005583	V350256906L1C006R00900033749_chr1_1005322	46	9	CCAT	CCAC
V350256906L1C006R00900084819	chr1	781279	50M	164	781443	781280	781444	V350256906L1C006R00900084819_chr1_781279	66	54	CATC	tctt
V350256906L1C006R00900818762	chr1	831948	50M	181	832129	831949	832130	V350256906L1C006R00900818762_chr1_831948	5	46	tgtc	ctgt
V350256906L1C006R00900994844	chr1	72306	50M	177	72483	72307	72484	V350256906L1C006R00900994844_chr1_72306	161	202	ctaa	tgga
V350256906L1C006R00901131942	chr1	1336886	50M	181	1337067	1336887	1337068	V350256906L1C006R00901131942_chr1_1336886	0	0	TCAC	CTAC
V350256906L1C006R00901216333	chr1	987377	50M	187	987564	987378	987565	V350256906L1C006R00901216333_chr1_987377	77	47	CTGG	CTGC
V350256906L1C006R01000213883	chr1	67292	50M	188	67480	67293	67481	V350256906L1C006R01000213883_chr1_67292	45	21	TAAA	GCCA
V350256906L1C006R01000345757	chr1	107118	50M	176	107294	107119	107295	V350256906L1C006R01000345757_chr1_107118	0	0	ACAA	GCTA
V350256906L1C006R01000456278	chr1	115641	50M	162	115803	115642	115804	V350256906L1C006R01000456278_chr1_115641	105	37	catg	gcag
V350256906L1C006R01100001212	chr1	1010247	50M	170	1010417	1010248	1010418	V350256906L1C006R01100001212_chr1_1010247	82	58	CTCA	ACCA
V350256906L1C006R01100330979	chr1	16505	50M	173	16678	16506	16679	V350256906L1C006R01100330979_chr1_16505	168	0	CAAA	ACCC
V350256906L1C006R01100386527	chr1	27533	50M	153	27686	27534	27687	V350256906L1C006R01100386527_chr1_27533	0	130	TGAC	CCAT
V350256906L1C006R01100457914	chr1	1276711	50M	152	1276863	1276712	1276864	V350256906L1C006R01100457914_chr1_1276711	76	21	acat	GTTT
V350256906L1C006R01100819866	chr1	1136413	50M	200	1136613	1136414	1136614	V350256906L1C006R01100819866_chr1_1136413	45	0	CAAA	GCGG
V350256906L1C006R01100874984	chr1	76385	50M	159	76544	76386	76545	V350256906L1C006R01100874984_chr1_76385	163	168	gatc	cagt
V350256906L1C006R01200209225	chr1	250368	50M	171	250539	250369	250540	V350256906L1C006R01200209225_chr1_250368	60	42	ctca	ttag
V350256906L1C006R01200220637	chr1	854428	50M	179	854607	854429	854608	V350256906L1C006R01200220637_chr1_854428	19	12	TGGC	CCAG
V350256906L1C006R01200403177	chr1	798710	50M	189	798899	798711	798900	V350256906L1C006R01200403177_chr1_798710	0	0	CCTC	gagC
V350256906L1C006R01200649983	chr1	1421837	50M	152	1421989	1421838	1421990	V350256906L1C006R01200649983_chr1_1421837	69	38	AGGG	CCCA
V350256906L1C006R01200795959	chr1	1067355	50M	169	1067524	1067356	1067525	V350256906L1C006R01200795959_chr1_1067355	91	42	TGCT	TGAC
V350256906L1C006R01200800841	chr1	961431	50M	164	961595	961432	961596	V350256906L1C006R01200800841_chr1_961431	11	0	GGTC	CAGT
V350256906L1C006R01200838642	chr1	94777	50M	156	94933	94778	94934	V350256906L1C006R01200838642_chr1_94777	14	49	gccc	acgt
V350256906L1C006R01201393221	chr1	1090965	50M	205	1091170	1090966	1091171	V350256906L1C006R01201393221_chr1_1090965	34	20	GCCT	CACT
V350256906L1C006R01300506190	chr1	1350499	50M	159	1350658	1350500	1350659	V350256906L1C006R01300506190_chr1_1350499	2	20	tatt	aagg
V350256906L1C006R01301184833	chr1	1319957	50M	174	1320131	1319958	1320132	V350256906L1C006R01301184833_chr1_1319957	118	15	cttt	agag
V350256906L1C006R01400156763	chr1	671782	50M	193	671975	671783	671976	V350256906L1C006R01400156763_chr1_671782	76	10	CCTG	GGCC
V350256906L1C006R01400283312	chr1	726744	50M	180	726924	726745	726925	V350256906L1C006R01400283312_chr1_726744	69	71	cgaa	agtc
V350256906L1C006R01400336192	chr1	741184	50M	155	741339	741185	741340	V350256906L1C006R01400336192_chr1_741184	22	9	CCAC	AATT
V350256906L1C006R01400437468	chr1	710733	50M	183	710916	710734	710917	V350256906L1C006R01400437468_chr1_710733	0	0	GGCT	GATG
V350256906L1C006R01400570394	chr1	42687	50M	167	42854	42688	42855	V350256906L1C006R01400570394_chr1_42687	29	75	TGTG	GGAT
V350256906L1C006R01400607895	chr1	148867	50M	201	149068	148868	149069	V350256906L1C006R01400607895_chr1_148867	49	34	cagg	gcgt
V350256906L1C006R01400709217	chr1	978549	50M	155	978704	978550	978705	V350256906L1C006R01400709217_chr1_978549	17	0	TGGG	CATT
V350256906L1C006R01400927744	chr1	697170	50M	163	697333	697171	697334	V350256906L1C006R01400927744_chr1_697170	10	0	ccta	gctt
V350256906L1C006R01400977629	chr1	118479	50M	150	118629	118480	118630	V350256906L1C006R01400977629_chr1_118479	15	0	actc	caag
V350256906L1C006R01401133417	chr1	455780	50M	155	455935	455781	455936	V350256906L1C006R01401133417_chr1_455780	107	262	CCTG	GCCC
V350256906L1C006R01401149989	chr1	63413	50M	179	63592	63414	63593	V350256906L1C006R01401149989_chr1_63413	0	59	TGCT	TTAA
V350256906L1C006R01401254564	chr1	384209	50M	209	384418	384210	384419	V350256906L1C006R01401254564_chr1_384209	0	143	ATCA	acac
V350256906L1C006R01401264317	chr1	105737	50M	167	105904	105738	105905	V350256906L1C006R01401264317_chr1_105737	133	11	agaa	CTTT
V350256906L1C006R01401292923	chr1	1262028	50M	163	1262191	1262029	1262192	V350256906L1C006R01401292923_chr1_1262028	0	0	GGAG	CTGC
V350256906L1C006R01500972069	chr1	59793	50M	193	59986	59794	59987	V350256906L1C006R01500972069_chr1_59793	117	44	TGTT	AATT
V350256906L1C006R01501128423	chr1	834529	50M	160	834689	834530	834690	V350256906L1C006R01501128423_chr1_834529	39	58	cccg	tgcc
V350256906L1C006R01501344093	chr1	585339	50M	189	585528	585340	585529	V350256906L1C006R01501344093_chr1_585339	38	30	ccag	agct
V350256906L1C006R01600083913	chr1	65374	50M	167	65541	65375	65542	V350256906L1C006R01600083913_chr1_65374	78	67	GACT	TCAC
V350256906L1C006R01600450245	chr1	1021545	50M	185	1021730	1021546	1021731	V350256906L1C006R01600450245_chr1_1021545	28	67	GGCC	CCCT
V350256906L1C006R01600810151	chr1	1044866	50M	135	1045001	1044867	1045002	V350256906L1C006R01600810151_chr1_1044866	65	24	agag	tggt
V350256906L1C006R01600964648	chr1	124052	50M	156	124208	124053	124209	V350256906L1C006R01600964648_chr1_124052	0	10	tgtc	tata
V350256906L1C006R01601065709	chr1	746361	50M	149	746510	746362	746511	V350256906L1C006R01601065709_chr1_746361	61	52	TCAA	TGTT
V350256906L1C006R01601207794	chr1	785821	50M	173	785994	785822	785995	V350256906L1C006R01601207794_chr1_785821	32	0	TGCT	CTCA
V350256906L1C006R01700524701	chr1	798814	50M	179	798993	798815	798994	V350256906L1C006R01700524701_chr1_798814	60	74	GAGC	ccac
V350256906L1C006R01700634870	chr1	344791	50M	144	344935	344792	344936	V350256906L1C006R01700634870_chr1_344791	76	48	tttt	atga
V350256906L1C006R01700831738	chr1	1025285	50M	158	1025443	1025286	1025444	V350256906L1C006R01700831738_chr1_1025285	76	45	CAGG	CATG
V350256906L1C006R01701148306	chr1	133771	50M	153	133924	133772	133925	V350256906L1C006R01701148306_chr1_133771	148	174	GACC	CACC
V350256906L1C006R01800220316	chr1	143616	50M	196	143812	143617	143813	V350256906L1C006R01800220316_chr1_143616	122	19	ctgc	cccc
V350256906L1C006R01800424510	chr1	165038	50M	169	165207	165039	165208	V350256906L1C006R01800424510_chr1_165038	53	99	cact	caag
V350256906L1C006R01800645856	chr1	1084205	50M	164	1084369	1084206	1084370	V350256906L1C006R01800645856_chr1_1084205	33	14	CCTA	CCTT
V350256906L1C006R01800759104	chr1	168323	50M	151	168474	168324	168475	V350256906L1C006R01800759104_chr1_168323	0	0	GGTT	CTTA
V350256906L1C006R01801114627	chr1	988943	50M	204	989147	988944	989148	V350256906L1C006R01801114627_chr1_988943	94	67	CTCT	GCAG
V350256906L1C006R01801179712	chr1	919721	50M	167	919888	919722	919889	V350256906L1C006R01801179712_chr1_919721	88	43	CCAC	CCCC
V350256906L1C006R01900163089	chr1	264084	50M	150	264234	264085	264235	V350256906L1C006R01900163089_chr1_264084	39	0	aatc	ctag
V350256906L1C006R01900190760	chr1	918612	50M	170	918782	918613	918783	V350256906L1C006R01900190760_chr1_918612	26	60	GCCC	caag
V350256906L1C006R01900739297	chr1	561493	50M	181	561674	561494	561675	V350256906L1C006R01900739297_chr1_561493	0	45	CCCT	TCTG
V350256906L1C006R01901034371	chr1	344993	50M	184	345177	344994	345178	V350256906L1C006R01901034371_chr1_344993	58	46	gatt	atca
V350256906L1C006R01901296331	chr1	1142497	50M	179	1142676	1142498	1142677	V350256906L1C006R01901296331_chr1_1142497	122	36	CCAG	TGGA
V350256906L1C006R01901316610	chr1	236647	50M	187	236834	236648	236835	V350256906L1C006R01901316610_chr1_236647	43	61	TCCC	cagg
V350256906L1C006R02000946337	chr1	834300	50M	169	834469	834301	834470	V350256906L1C006R02000946337_chr1_834300	80	33	TGTG	cgcc
V350256906L1C006R02001175814	chr1	1157781	50M	151	1157932	1157782	1157933	V350256906L1C006R02001175814_chr1_1157781	50	22	CGCA	CCTG
V350256906L1C006R02100111642	chr1	819999	50M	191	820190	820000	820191	V350256906L1C006R02100111642_chr1_819999	63	22	ccat	caaa
V350256906L1C006R02100302396	chr1	980544	50M	181	980725	980545	980726	V350256906L1C006R02100302396_chr1_980544	36	55	CCAC	CAGG
V350256906L1C006R02100363800	chr1	1419518	50M	179	1419697	1419519	1419698	V350256906L1C006R02100363800_chr1_1419518	0	25	CGAA	ccca
V350256906L1C006R02100718003	chr1	587775	50M	167	587942	587776	587943	V350256906L1C006R02100718003_chr1_587775	0	42	ctaa	tgtt
V350256906L1C006R02200113215	chr1	595670	50M	171	595841	595671	595842	V350256906L1C006R02200113215_chr1_595670	52	68	taat	atac
V350256906L1C006R02200466400	chr1	440685	50M	159	440844	440686	440845	V350256906L1C006R02200466400_chr1_440685	135	58	TCTC	GGTG
V350256906L1C006R02200587421	chr1	344498	50M	199	344697	344499	344698	V350256906L1C006R02200587421_chr1_344498	199	170	tgtc	ccat
V350256906L1C006R02201276764	chr1	42371	50M	206	42577	42372	42578	V350256906L1C006R02201276764_chr1_42371	177	0	ttcc	TAAA
V350256906L1C006R02300751611	chr1	741770	50M	156	741926	741771	741927	V350256906L1C006R02300751611_chr1_741770	53	100	GCCA	CCCA
V350256906L1C006R02301013204	chr1	792762	50M	176	792938	792763	792939	V350256906L1C006R02301013204_chr1_792762	109	175	GCCT	TGCT
V350256906L1C006R02301015205	chr1	1089616	50M	206	1089822	1089617	1089823	V350256906L1C006R02301015205_chr1_1089616	22	54	ccct	taga
V350256906L1C006R02301144989	chr1	595527	50M	173	595700	595528	595701	V350256906L1C006R02301144989_chr1_595527	195	22	CTTG	acta
V350256906L1C006R02301160820	chr1	141485	50M	177	141662	141486	141663	V350256906L1C006R02301160820_chr1_141485	7	70	gaca	tttc
V350256906L1C006R02400072624	chr1	910305	50M	220	910525	910306	910526	V350256906L1C006R02400072624_chr1_910305	0	30	CAGA	ctct
V350256906L1C006R02400368880	chr1	836651	50M	175	836826	836652	836827	V350256906L1C006R02400368880_chr1_836651	62	67	CAAG	cagc
V350256906L1C006R02400853057	chr1	1127567	50M	174	1127741	1127568	1127742	V350256906L1C006R02400853057_chr1_1127567	64	38	gcgg	caca
V350256906L1C006R02401287214	chr1	524180	50M	142	524322	524181	524323	V350256906L1C006R02401287214_chr1_524180	43	0	AGGc	CCAA
V350256906L1C006R02401396431	chr1	792195	50M	178	792373	792196	792374	V350256906L1C006R02401396431_chr1_792195	61	56	GCAT	CTGG
V350256906L1C006R02500502934	chr1	1007926	50M	198	1008124	1007927	1008125	V350256906L1C006R02500502934_chr1_1007926	68	73	CACC	GCAC
V350256906L1C006R02500616917	chr1	357649	50M	177	357826	357650	357827	V350256906L1C006R02500616917_chr1_357649	59	79	acca	acta
V350256906L1C006R02500659636	chr1	899685	50M	190	899875	899686	899876	V350256906L1C006R02500659636_chr1_899685	79	57	ATGC	CCAG
V350256906L1C006R02501356001	chr1	725403	29S21M	199	725602	725404	725603	V350256906L1C006R02501356001_chr1_725403	66	86	aatg	catt
V350256906L1C006R02501374680	chr1	1299250	50M	183	1299433	1299251	1299434	V350256906L1C006R02501374680_chr1_1299250	55	85	tggg	ggtg
V350256906L1C006R02600395923	chr1	461126	50M	201	461327	461127	461328	V350256906L1C006R02600395923_chr1_461126	6	207	ccat	acct
V350256906L1C006R02600768628	chr1	988702	50M	173	988875	988703	988876	V350256906L1C006R02600768628_chr1_988702	18	162	TGGT	CCTG
V350256906L1C006R02600897322	chr1	1139303	50M	165	1139468	1139304	1139469	V350256906L1C006R02600897322_chr1_1139303	0	22	CTGG	CCCA
V350256906L1C006R02700016968	chr1	148062	50M	202	148264	148063	148265	V350256906L1C006R02700016968_chr1_148062	0	188	ccag	tttt
V350256906L1C006R02700367005	chr1	877441	50M	164	877605	877442	877606	V350256906L1C006R02700367005_chr1_877441	113	208	GGCG	CCCC
V350256906L1C006R02700534682	chr1	1335155	50M	154	1335309	1335156	1335310	V350256906L1C006R02700534682_chr1_1335155	41	34	TCCG	CCCA
V350256906L1C006R02700713264	chr1	455047	50M	160	455207	455048	455208	V350256906L1C006R02700713264_chr1_455047	52	90	CCAT	TGCC
V350256906L1C006R02701007930	chr1	1251741	50M	137	1251878	1251742	1251879	V350256906L1C006R02701007930_chr1_1251741	173	36	ggca	tctg
V350256906L1C006R02800133802	chr1	976993	50M	175	977168	976994	977169	V350256906L1C006R02800133802_chr1_976993	74	65	CCTA	GGCA
V350256906L1C006R02800222924	chr1	1199969	50M	186	1200155	1199970	1200156	V350256906L1C006R02800222924_chr1_1199969	0	0	tggc	cacc
V350256906L1C006R02800226957	chr1	36519	50M	188	36707	36520	36708	V350256906L1C006R02800226957_chr1_36519	61	68	CTCA	ACTT
V350256906L1C006R02800231537	chr1	595063	50M	166	595229	595064	595230	V350256906L1C006R02800231537_chr1_595063	56	65	acct	CCCA
V350256906L1C006R02800599822	chr1	1349721	50M	158	1349879	1349722	1349880	V350256906L1C006R02800599822_chr1_1349721	14	55	aact	cagg
V350256906L1C006R02800923099	chr1	115595	50M	149	115744	115596	115745	V350256906L1C006R02800923099_chr1_115595	78	2	aagg	GGAC
V350256906L1C006R02800981155	chr1	1258941	50M	166	1259107	1258942	1259108	V350256906L1C006R02800981155_chr1_1258941	79	64	cgcc	CCTA
V350256906L1C006R02801237643	chr1	1307597	50M	247	1307844	1307598	1307845	V350256906L1C006R02801237643_chr1_1307597	11	57	GCCC	TGAG
V350256906L1C006R02801339434	chr1	706151	50M	129	706280	706152	706281	V350256906L1C006R02801339434_chr1_706151	66	19	GGTC	CTCT
V350256906L1C006R02900073977	chr1	1294475	50M	165	1294640	1294476	1294641	V350256906L1C006R02900073977_chr1_1294475	0	21	GCTC	CCCT
V350256906L1C006R02900375511	chr1	696436	50M	146	696582	696437	696583	V350256906L1C006R02900375511_chr1_696436	0	114	AGCA	GGCA
V350256906L1C006R02900379720	chr1	334726	15M1I34M	155	334881	334727	334882	V350256906L1C006R02900379720_chr1_334726	156	33	gcaa	TGTT
V350256906L1C006R02900608887	chr1	552738	50M	216	552954	552739	552955	V350256906L1C006R02900608887_chr1_552738	26	33	CCGT	acct
V350256906L1C006R02900734898	chr1	116612	50M	188	116800	116613	116801	V350256906L1C006R02900734898_chr1_116612	1	60	gggt	ggaa
V350256906L1C006R02900929940	chr1	1117074	50M	170	1117244	1117075	1117245	V350256906L1C006R02900929940_chr1_1117074	237	67	CCAT	GGTC
V350256906L1C006R02901352095	chr1	1426076	50M	193	1426269	1426077	1426270	V350256906L1C006R02901352095_chr1_1426076	59	75	CCCA	ACCA
V350256906L1C006R03000248994	chr1	1425879	50M	169	1426048	1425880	1426049	V350256906L1C006R03000248994_chr1_1425879	45	31	GGCC	CAGG
V350256906L1C006R03000426645	chr1	612226	50M	180	612406	612227	612407	V350256906L1C006R03000426645_chr1_612226	156	0	gcac	gcct
V350256906L1C006R03000718127	chr1	100422	50M	260	100682	100423	100683	V350256906L1C006R03000718127_chr1_100422	51	84	CTGT	TGAA
V350256906L1C006R03000820986	chr1	338879	50M	153	339032	338880	339033	V350256906L1C006R03000820986_chr1_338879	24	133	AGCC	tttt
V350256906L1C006R03001124295	chr1	697471	50M	190	697661	697472	697662	V350256906L1C006R03001124295_chr1_697471	27	28	aaag	TGTA
V350256906L1C006R03001275233	chr1	133041	50M	150	133191	133042	133192	V350256906L1C006R03001275233_chr1_133041	0	0	TGCA	AGAG
V350256906L1C006R03001293973	chr1	1331044	50M	166	1331210	1331045	1331211	V350256906L1C006R03001293973_chr1_1331044	14	42	ACAC	TATC
V350256906L1C006R03100128759	chr1	261522	50M	174	261696	261523	261697	V350256906L1C006R03100128759_chr1_261522	18	43	TAAA	ctag
V350256906L1C006R03100352781	chr1	1394941	50M	183	1395124	1394942	1395125	V350256906L1C006R03100352781_chr1_1394941	0	8	TGCT	CACA
V350256906L1C006R03100860506	chr1	262596	50M	170	262766	262597	262767	V350256906L1C006R03100860506_chr1_262596	0	0	AGGT	ctct
V350256906L1C006R03100967484	chr1	249565	50M	170	249735	249566	249736	V350256906L1C006R03100967484_chr1_249565	2	0	ccgt	cctt
V350256906L1C006R03101042081	chr1	462761	50M	144	462905	462762	462906	V350256906L1C006R03101042081_chr1_462761	0	29	GGAC	gctc
V350256906L1C006R03101374114	chr1	1321403	50M	167	1321570	1321404	1321571	V350256906L1C006R03101374114_chr1_1321403	98	192	agta	TGGG
V350256906L1C006R03200393299	chr1	793276	50M	206	793482	793277	793483	V350256906L1C006R03200393299_chr1_793276	63	104	TGTT	ACTG
V350256906L1C006R03201086606	chr1	1288369	50M	180	1288549	1288370	1288550	V350256906L1C006R03201086606_chr1_1288369	17	2	AAGC	CATC
V350256906L1C006R03300043893	chr1	1317861	31M1I18M	192	1318053	1317862	1318054	V350256906L1C006R03300043893_chr1_1317861	291	178	CAAC	GGGA
V350256906L1C006R03300334896	chr1	1323569	50M	179	1323748	1323570	1323749	V350256906L1C006R03300334896_chr1_1323569	12	128	GGCT	tgta
V350256906L1C006R03300456860	chr1	1220165	50M	117	1220282	1220166	1220283	V350256906L1C006R03300456860_chr1_1220165	133	91	GTGT	TCTG
V350256906L1C006R03301043230	chr1	617102	50M	157	617259	617103	617260	V350256906L1C006R03301043230_chr1_617102	134	0	gtgg	cata
V350256906L1C006R03301280996	chr1	680767	50M	150	680917	680768	680918	V350256906L1C006R03301280996_chr1_680767	21	0	gtgc	atct
V350256906L1C006R03301365256	chr1	586048	50M	166	586214	586049	586215	V350256906L1C006R03301365256_chr1_586048	40	50	tagg	ctga
V350256906L1C006R03400003876	chr1	365643	50M	164	365807	365644	365808	V350256906L1C006R03400003876_chr1_365643	54	52	TACC	caga
V350256906L1C006R03400088075	chr1	536658	50M	184	536842	536659	536843	V350256906L1C006R03400088075_chr1_536658	267	451	caaa	caga
V350256906L1C006R03400411033	chr1	735171	50M	166	735337	735172	735338	V350256906L1C006R03400411033_chr1_735171	0	0	cata	gcat
V350256906L1C006R03400506953	chr1	934970	50M	196	935166	934971	935167	V350256906L1C006R03400506953_chr1_934970	44	63	CTCC	CTCC
V350256906L1C006R03500116260	chr1	938839	50M	160	938999	938840	939000	V350256906L1C006R03500116260_chr1_938839	95	255	TGAC	cggg
V350256906L1C006R03500205272	chr1	715105	50M	249	715354	715106	715355	V350256906L1C006R03500205272_chr1_715105	54	17	caat	agag
V350256906L1C006R03500355817	chr1	94611	50M	179	94790	94612	94791	V350256906L1C006R03500355817_chr1_94611	4	1	tggg	ccct
V350256906L1C006R03500473560	chr1	117587	50M	189	117776	117588	117777	V350256906L1C006R03500473560_chr1_117587	59	60	taat	catg
V350256906L1C006R03500769736	chr1	628961	50M	187	629148	628962	629149	V350256906L1C006R03500769736_chr1_628961	75	66	CCAT	CCCA
V350256906L1C006R03501033867	chr1	712736	50M	149	712885	712737	712886	V350256906L1C006R03501033867_chr1_712736	0	0	CTAC	agct
V350256906L1C006R03501147741	chr1	1330013	50M	187	1330200	1330014	1330201	V350256906L1C006R03501147741_chr1_1330013	30	62	ccag	ccca
V350256906L1C006R03501290922	chr1	874971	50M	169	875140	874972	875141	V350256906L1C006R03501290922_chr1_874971	21	0	CCCA	CACA
V350256906L1C006R03600407571	chr1	1392946	50M	157	1393103	1392947	1393104	V350256906L1C006R03600407571_chr1_1392946	51	54	agcc	tggc
V350256906L1C006R03600846188	chr1	1314758	50M	159	1314917	1314759	1314918	V350256906L1C006R03600846188_chr1_1314758	199	40	TGTA	ccca
V350256906L1C006R03701309267	chr1	1058225	50M	161	1058386	1058226	1058387	V350256906L1C006R03701309267_chr1_1058225	60	48	CACA	CTCC
V350256906L1C006R03800480450	chr1	1097467	50M	147	1097614	1097468	1097615	V350256906L1C006R03800480450_chr1_1097467	54	12	CCAC	CCCA
V350256906L1C006R03800732333	chr1	164063	50M	169	164232	164064	164233	V350256906L1C006R03800732333_chr1_164063	83	37	agag	TCTC
V350256906L1C006R03900299812	chr1	689993	50M	167	690160	689994	690161	V350256906L1C006R03900299812_chr1_689993	0	21	cccc	agag
V350256906L1C006R03900392381	chr1	573040	50M	211	573251	573041	573252	V350256906L1C006R03900392381_chr1_573040	33	7	TGTG	gcta
V350256906L1C006R03900496937	chr1	263743	50M	180	263923	263744	263924	V350256906L1C006R03900496937_chr1_263743	71	85	TGTT	TGCC
V350256906L1C006R03900688744	chr1	363873	50M	181	364054	363874	364055	V350256906L1C006R03900688744_chr1_363873	84	49	GGAA	TACA
V350256906L1C006R03900699334	chr1	1382574	50M	180	1382754	1382575	1382755	V350256906L1C006R03900699334_chr1_1382574	71	79	ccac	ccca
V350256906L1C006R03900837181	chr1	693627	50M	215	693842	693628	693843	V350256906L1C006R03900837181_chr1_693627	59	63	cttc	TAAA
V350256906L1C006R03901318997	chr1	1030674	50M	167	1030841	1030675	1030842	V350256906L1C006R03901318997_chr1_1030674	0	0	gagt	aatc
V350256906L1C006R04000178903	chr1	1389593	50M	162	1389755	1389594	1389756	V350256906L1C006R04000178903_chr1_1389593	26	64	CCTG	CCCG
V350256906L1C006R04000403173	chr1	783315	50M	162	783477	783316	783478	V350256906L1C006R04000403173_chr1_783315	41	46	GACA	CTTG
V350256906L1C006R04100079944	chr1	1393679	50M	175	1393854	1393680	1393855	V350256906L1C006R04100079944_chr1_1393679	116	33	gaca	accc
V350256906L1C006R04100285795	chr1	725588	47M3S	260	725848	725589	725849	V350256906L1C006R04100285795_chr1_725588	72	35	aatg	tgag
V350256906L1C006R04101104461	chr1	256855	50M	162	257017	256856	257018	V350256906L1C006R04101104461_chr1_256855	125	7	aacc	attt
V350256906L1C006R04200126820	chr1	389556	50M	110	389666	389557	389667	V350256906L1C006R04200126820_chr1_389556	16	27	ataa	tttc
V350256906L1C006R04200154098	chr1	1317927	41M1I8M	176	1318103	1317928	1318104	V350256906L1C006R04200154098_chr1_1317927	304	128	CCAC	ACTG
V350256906L1C006R04200179887	chr1	803109	50M	168	803277	803110	803278	V350256906L1C006R04200179887_chr1_803109	53	37	CGAT	GGAA
V350256906L1C006R04200778928	chr1	1347939	50M	180	1348119	1347940	1348120	V350256906L1C006R04200778928_chr1_1347939	25	128	agtt	agtc
V350256906L1C006R04201215543	chr1	252581	50M	160	252741	252582	252742	V350256906L1C006R04201215543_chr1_252581	215	304	AAGT	ccag
V350256906L1C006R04201377067	chr1	924108	50M	182	924290	924109	924291	V350256906L1C006R04201377067_chr1_924108	187	174	GATT	CCCA
V350256906L1C006R04300142497	chr1	143061	50M	167	143228	143062	143229	V350256906L1C006R04300142497_chr1_143061	74	58	GACA	acca
V350256906L1C006R04300333545	chr1	963218	50M	178	963396	963219	963397	V350256906L1C006R04300333545_chr1_963218	56	39	GGCA	CCTG
V350256906L1C006R04301035481	chr1	159183	50M	166	159349	159184	159350	V350256906L1C006R04301035481_chr1_159183	15	181	GAAA	TCAG
V350256906L1C006R04301058007	chr1	429787	50M	191	429978	429788	429979	V350256906L1C006R04301058007_chr1_429787	46	22	CCTG	ctct
V350256906L1C006R04301240346	chr1	961807	50M	162	961969	961808	961970	V350256906L1C006R04301240346_chr1_961807	8	0	TGCC	CCTG
V350256906L1C006R04301261021	chr1	682528	50M	164	682692	682529	682693	V350256906L1C006R04301261021_chr1_682528	37	43	gctt	ggct
V350256906L1C006R04301305524	chr1	96072	50M	201	96273	96073	96274	V350256906L1C006R04301305524_chr1_96072	0	154	TCCT	TGAG
V350256906L1C006R04400322713	chr1	779719	50M	167	779886	779720	779887	V350256906L1C006R04400322713_chr1_779719	0	0	caag	CACT
V350256906L1C006R04400389505	chr1	1098945	50M	170	1099115	1098946	1099116	V350256906L1C006R04400389505_chr1_1098945	137	30	GCCC	CTTC
V350256906L1C006R04400455059	chr1	640848	50M	218	641066	640849	641067	V350256906L1C006R04400455059_chr1_640848	0	57	ctgg	TCAT
V350256906L1C006R04400481449	chr1	725523	31M19S	142	725665	725524	725666	V350256906L1C006R04400481449_chr1_725523	7	149	aatg	ttcc
V350256906L1C006R04400597406	chr1	1171764	50M	156	1171920	1171765	1171921	V350256906L1C006R04400597406_chr1_1171764	51	60	CCTC	CCCC
V350256906L1C006R04400751232	chr1	32515	50M	149	32664	32516	32665	V350256906L1C006R04400751232_chr1_32515	6	155	CTTG	CTCT
V350256906L1C006R04400824482	chr1	814606	50M	172	814778	814607	814779	V350256906L1C006R04400824482_chr1_814606	23	35	ccaa	TGTG
V350256906L1C006R04400834855	chr1	838902	50M	171	839073	838903	839074	V350256906L1C006R04400834855_chr1_838902	30	27	ctgc	ggta
V350256906L1C006R04400899676	chr1	941816	50M	218	942034	941817	942035	V350256906L1C006R04400899676_chr1_941816	163	161	CCCA	CCAC
V350256906L1C006R04401041567	chr1	1370184	50M	181	1370365	1370185	1370366	V350256906L1C006R04401041567_chr1_1370184	32	29	CCCA	ACCC
V350256906L1C006R04401068839	chr1	950895	50M	154	951049	950896	951050	V350256906L1C006R04401068839_chr1_950895	0	18	CCAT	CCCG
V350256906L1C006R04401166008	chr1	914426	50M	165	914591	914427	914592	V350256906L1C006R04401166008_chr1_914426	45	20	GTTC	CGGC
V350256906L1C006R04401199077	chr1	1103963	50M	177	1104140	1103964	1104141	V350256906L1C006R04401199077_chr1_1103963	34	40	CCAA	GCCC
V350256906L1C006R04500554690	chr1	1287745	50M	162	1287907	1287746	1287908	V350256906L1C006R04500554690_chr1_1287745	0	154	CCCG	GGAC
V350256906L1C006R04501037718	chr1	43647	50M	170	43817	43648	43818	V350256906L1C006R04501037718_chr1_43647	38	23	tgct	gtag
V350256906L1C006R04501112564	chr1	1133895	50M	174	1134069	1133896	1134070	V350256906L1C006R04501112564_chr1_1133895	6	0	GCAC	GGTG
V350256906L1C006R04501181043	chr1	1238888	50M	172	1239060	1238889	1239061	V350256906L1C006R04501181043_chr1_1238888	2	113	CCAG	GAGG
V350256906L1C006R04501296255	chr1	10045	50M	176	10221	10046	10222	V350256906L1C006R04501296255_chr1_10045	478	302	accc	ggtt
V350256906L1C006R04600125344	chr1	725153	27S23M	193	725346	725154	725347	V350256906L1C006R04600125344_chr1_725153	116	9	aata	attc
V350256906L1C006R04601279796	chr1	1231805	50M	175	1231980	1231806	1231981	V350256906L1C006R04601279796_chr1_1231805	95	44	CTGT	GCAT
V350256906L1C006R04700172353	chr1	587081	50M	155	587236	587082	587237	V350256906L1C006R04700172353_chr1_587081	45	22	caaa	ttgc
V350256906L1C006R04701046767	chr1	1348176	50M	178	1348354	1348177	1348355	V350256906L1C006R04701046767_chr1_1348176	185	129	aata	ccca
V350256906L1C006R04800003477	chr1	263214	50M	163	263377	263215	263378	V350256906L1C006R04800003477_chr1_263214	148	0	tcac	tgaa
V350256906L1C006R04800896771	chr1	1329749	50M	174	1329923	1329750	1329924	V350256906L1C006R04800896771_chr1_1329749	0	13	CGCC	cctg
V350256906L1C006R04800906822	chr1	27361	50M	173	27534	27362	27535	V350256906L1C006R04800906822_chr1_27361	0	0	gcca	ACAT
V350256906L1C006R04801397390	chr1	102765	50M	165	102930	102766	102931	V350256906L1C006R04801397390_chr1_102765	51	55	tact	ggag
V350256906L1C006R04900150552	chr1	921441	50M	158	921599	921442	921600	V350256906L1C006R04900150552_chr1_921441	61	64	ccct	actc
V350256906L1C006R04900539511	chr1	1195943	50M	134	1196077	1195944	1196078	V350256906L1C006R04900539511_chr1_1195943	92	17	CCAA	CTTT
V350256906L1C006R04900581455	chr1	583072	50M	174	583246	583073	583247	V350256906L1C006R04900581455_chr1_583072	342	170	ccag	TCCC
V350256906L1C006R04900730775	chr1	1368818	50M	227	1369045	1368819	1369046	V350256906L1C006R04900730775_chr1_1368818	58	77	CCCA	CAAA
V350256906L1C006R04900853709	chr1	690109	50M	165	690274	690110	690275	V350256906L1C006R04900853709_chr1_690109	72	69	cctt	tccc
V350256906L1C006R04901290224	chr1	33130	50M	172	33302	33131	33303	V350256906L1C006R04901290224_chr1_33130	95	0	gatc	gcca
V350256906L1C006R05000337632	chr1	1115333	50M	155	1115488	1115334	1115489	V350256906L1C006R05000337632_chr1_1115333	45	68	GGGA	GTGG
V350256906L1C006R05000418089	chr1	1332029	50M	172	1332201	1332030	1332202	V350256906L1C006R05000418089_chr1_1332029	32	13	cagc	gctg
V350256906L1C006R05000730227	chr1	1043932	50M	128	1044060	1043933	1044061	V350256906L1C006R05000730227_chr1_1043932	322	252	CCAC	CTGT
V350256906L1C006R05000849659	chr1	970636	50M	172	970808	970637	970809	V350256906L1C006R05000849659_chr1_970636	44	54	TGGG	ACTC
V350256906L1C006R05001020033	chr1	1043903	50M	183	1044086	1043904	1044087	V350256906L1C006R05001020033_chr1_1043903	293	226	CCAC	TGGT
V350256906L1C006R05001047525	chr1	113974	50M	158	114132	113975	114133	V350256906L1C006R05001047525_chr1_113974	51	13	acct	TCAG
V350256906L1C006R05100286790	chr1	172324	50M	203	172527	172325	172528	V350256906L1C006R05100286790_chr1_172324	52	0	CCCG	GAAC
V350256906L1C006R05100412250	chr1	458700	50M	166	458866	458701	458867	V350256906L1C006R05100412250_chr1_458700	0	0	tagt	tctc
V350256906L1C006R05100662515	chr1	329303	50M	172	329475	329304	329476	V350256906L1C006R05100662515_chr1_329303	58	80	CCAA	AGCC
V350256906L1C006R05100795499	chr1	375141	50M	179	375320	375142	375321	V350256906L1C006R05100795499_chr1_375141	55	63	attg	caaa
V350256906L1C006R05100851286	chr1	1048493	50M	144	1048637	1048494	1048638	V350256906L1C006R05100851286_chr1_1048493	32	85	atga	gaat
V350256906L1C006R05100874794	chr1	947631	50M	178	947809	947632	947810	V350256906L1C006R05100874794_chr1_947631	7	0	agta	cagt
V350256906L1C006R05100937011	chr1	1275540	50M	153	1275693	1275541	1275694	V350256906L1C006R05100937011_chr1_1275540	9	60	CCAG	CCTC
V350256906L1C006R05101144263	chr1	354227	50M	163	354390	354228	354391	V350256906L1C006R05101144263_chr1_354227	237	290	agag	tgct
V350256906L1C006R05200245131	chr1	582808	50M	178	582986	582809	582987	V350256906L1C006R05200245131_chr1_582808	78	256	ggtt	cctg
V350256906L1C006R05200649502	chr1	626959	50M	163	627122	626960	627123	V350256906L1C006R05200649502_chr1_626959	30	0	CAGA	GTAT
V350256906L1C006R05200690339	chr1	739932	50M	183	740115	739933	740116	V350256906L1C006R05200690339_chr1_739932	43	24	AAGA	ATTT
V350256906L1C006R05200691061	chr1	1116992	50M	123	1117115	1116993	1117116	V350256906L1C006R05200691061_chr1_1116992	173	196	CAGC	CCCA
V350256906L1C006R05200791567	chr1	657133	50M	192	657325	657134	657326	V350256906L1C006R05200791567_chr1_657133	70	89	tgta	tttt
V350256906L1C006R05200999425	chr1	521567	50M	157	521724	521568	521725	V350256906L1C006R05200999425_chr1_521567	236	79	AACC	tcag
V350256906L1C006R05201009678	chr1	1421063	50M	196	1421259	1421064	1421260	V350256906L1C006R05201009678_chr1_1421063	0	2	AGCT	CCCT
V350256906L1C006R05201071549	chr1	1289988	50M	196	1290184	1289989	1290185	V350256906L1C006R05201071549_chr1_1289988	27	0	GGGA	CCAT
V350256906L1C006R05300433948	chr1	615809	50M	169	615978	615810	615979	V350256906L1C006R05300433948_chr1_615809	23	122	atgg	attt
V350256906L1C006R05300648511	chr1	849144	50M	175	849319	849145	849320	V350256906L1C006R05300648511_chr1_849144	58	69	CCTG	GAGA
V350256906L1C006R05300880673	chr1	1142158	50M	177	1142335	1142159	1142336	V350256906L1C006R05300880673_chr1_1142158	0	164	GAAA	CCAG
V350256906L1C006R05300881139	chr1	1160148	50M	171	1160319	1160149	1160320	V350256906L1C006R05300881139_chr1_1160148	42	34	gcca	TGAA
V350256906L1C006R05300893888	chr1	1195818	50M	160	1195978	1195819	1195979	V350256906L1C006R05300893888_chr1_1195818	1	57	CGTG	GGTG
V350256906L1C006R05300914827	chr1	700870	50M	180	701050	700871	701051	V350256906L1C006R05300914827_chr1_700870	64	97	caag	ctgg
V350256906L1C006R05301249003	chr1	335745	50M	199	335944	335746	335945	V350256906L1C006R05301249003_chr1_335745	241	74	ccat	AGAA
V350256906L1C006R05301402523	chr1	754362	50M	181	754543	754363	754544	V350256906L1C006R05301402523_chr1_754362	84	203	GGGG	ccag
V350256906L1C006R05400457170	chr1	1396021	50M	183	1396204	1396022	1396205	V350256906L1C006R05400457170_chr1_1396021	69	103	CTTT	CCAT
V350256906L1C006R05400628553	chr1	1345739	50M	194	1345933	1345740	1345934	V350256906L1C006R05400628553_chr1_1345739	0	0	catc	caag
V350256906L1C006R05400652341	chr1	995002	50M	148	995150	995003	995151	V350256906L1C006R05400652341_chr1_995002	39	63	AGGC	TCAC
V350256906L1C006R05401083175	chr1	97584	50M	150	97734	97585	97735	V350256906L1C006R05401083175_chr1_97584	14	0	CAAG	TCTT
V350256906L1C006R05500482858	chr1	256931	50M	162	257093	256932	257094	V350256906L1C006R05500482858_chr1_256931	49	54	taaa	cccc
V350256906L1C006R05500710126	chr1	702089	50M	174	702263	702090	702264	V350256906L1C006R05500710126_chr1_702089	48	101	ggtg	cctg
V350256906L1C006R05501019574	chr1	658801	50M	172	658973	658802	658974	V350256906L1C006R05501019574_chr1_658801	57	89	CAAG	GCCA
V350256906L1C006R05501143835	chr1	31945	50M	193	32138	31946	32139	V350256906L1C006R05501143835_chr1_31945	63	10	ACCT	GGAC
V350256906L1C006R05501392187	chr1	1386422	50M	151	1386573	1386423	1386574	V350256906L1C006R05501392187_chr1_1386422	42	0	GGAt	ggca
V350256906L1C006R05600133578	chr1	13812	50M	158	13970	13813	13971	V350256906L1C006R05600133578_chr1_13812	47	48	CTTC	AGAA
V350256906L1C006R05600439294	chr1	1069703	50M	164	1069867	1069704	1069868	V350256906L1C006R05600439294_chr1_1069703	70	51	CTCC	CTCA
V350256906L1C006R05600581736	chr1	173374	50M	165	173539	173375	173540	V350256906L1C006R05600581736_chr1_173374	59	53	CACT	ATCT
V350256906L1C006R05600770414	chr1	922452	50M	184	922636	922453	922637	V350256906L1C006R05600770414_chr1_922452	88	41	gtta	ccta
V350256906L1C006R05601274999	chr1	587257	50M	162	587419	587258	587420	V350256906L1C006R05601274999_chr1_587257	43	20	tgtt	gtta
V350256906L1C006R05700162914	chr1	1002073	50M	200	1002273	1002074	1002274	V350256906L1C006R05700162914_chr1_1002073	30	16	CCCG	GGAT
V350256906L1C006R05701199203	chr1	634904	50M	167	635071	634905	635072	V350256906L1C006R05701199203_chr1_634904	307	154	cgat	tgcc
V350256906L1C006R05800394791	chr1	765344	50M	151	765495	765345	765496	V350256906L1C006R05800394791_chr1_765344	208	57	cttc	ccat
V350256906L1C006R05800527874	chr1	1383075	50M	176	1383251	1383076	1383252	V350256906L1C006R05800527874_chr1_1383075	39	0	ctgc	tggg
V350256906L1C006R05800545862	chr1	59671	50M	144	59815	59672	59816	V350256906L1C006R05800545862_chr1_59671	189	95	TCCC	CTGA
V350256906L1C006R05800613889	chr1	1002815	50M	168	1002983	1002816	1002984	V350256906L1C006R05800613889_chr1_1002815	57	61	CGCC	TCTC
V350256906L1C006R05800735691	chr1	124946	50M	196	125142	124947	125143	V350256906L1C006R05800735691_chr1_124946	108	37	CCCA	CACA
V350256906L1C006R05801264682	chr1	1274337	50M	190	1274527	1274338	1274528	V350256906L1C006R05801264682_chr1_1274337	0	0	CCCC	TGTG
V350256906L1C006R05900147269	chr1	1128052	50M	227	1128279	1128053	1128280	V350256906L1C006R05900147269_chr1_1128052	0	0	CGTA	aaaa
V350256906L1C006R05900239482	chr1	1037637	50M	106	1037743	1037638	1037744	V350256906L1C006R05900239482_chr1_1037637	50	29	tgta	ggaa
V350256906L1C006R05900670504	chr1	621816	50M	160	621976	621817	621977	V350256906L1C006R05900670504_chr1_621816	71	68	GGCT	ATGG
V350256906L1C006R06000134934	chr1	336290	50M	191	336481	336291	336482	V350256906L1C006R06000134934_chr1_336290	44	109	AAAT	attc
V350256906L1C006R06000343891	chr1	1141230	50M	144	1141374	1141231	1141375	V350256906L1C006R06000343891_chr1_1141230	39	50	GCTG	CCTG
V350256906L1C006R06000500325	chr1	940909	50M	165	941074	940910	941075	V350256906L1C006R06000500325_chr1_940909	8	0	ccac	TCCC
V350256906L1C006R06000558298	chr1	1189316	50M	138	1189454	1189317	1189455	V350256906L1C006R06000558298_chr1_1189316	17	3	GACC	CCCT
V350256906L1C006R06000698798	chr1	88875	50M	174	89049	88876	89050	V350256906L1C006R06000698798_chr1_88875	224	50	CACC	tgtg
V350256906L1C006R06000948459	chr1	1364649	50M	165	1364814	1364650	1364815	V350256906L1C006R06000948459_chr1_1364649	18	27	acac	tgta
V350256906L1C006R06100123977	chr1	981550	50M	171	981721	981551	981722	V350256906L1C006R06100123977_chr1_981550	69	78	CAGA	GGGC
V350256906L1C006R06100641063	chr1	1377021	50M	157	1377178	1377022	1377179	V350256906L1C006R06100641063_chr1_1377021	52	57	CGTG	GCCA
V350256906L1C006R06100838731	chr1	341016	50M	171	341187	341017	341188	V350256906L1C006R06100838731_chr1_341016	28	7	TCTT	GAAG
V350256906L1C006R06100841701	chr1	828163	50M	142	828305	828164	828306	V350256906L1C006R06100841701_chr1_828163	65	33	tata	ttat
V350256906L1C006R06101228432	chr1	922276	30M1I19M	211	922487	922277	922488	V350256906L1C006R06101228432_chr1_922276	104	53	cagc	CAAA
V350256906L1C006R06101243215	chr1	266571	50M	140	266711	266572	266712	V350256906L1C006R06101243215_chr1_266571	69	27	ACTC	CCCT
V350256906L1C006R06101247431	chr1	1103549	50M	167	1103716	1103550	1103717	V350256906L1C006R06101247431_chr1_1103549	72	70	CCCA	CCCA
V350256906L1C006R06101274432	chr1	1355396	50M	156	1355552	1355397	1355553	V350256906L1C006R06101274432_chr1_1355396	44	73	CCCT	GCCG
V350256906L1C006R06200090329	chr1	943046	50M	191	943237	943047	943238	V350256906L1C006R06200090329_chr1_943046	7	36	TCCA	cggg
V350256906L1C006R06200335869	chr1	663097	50M	169	663266	663098	663267	V350256906L1C006R06200335869_chr1_663097	32	20	GGGA	GGTC
V350256906L1C006R06200425730	chr1	1200807	50M	240	1201047	1200808	1201048	V350256906L1C006R06200425730_chr1_1200807	57	65	ccta	acag
V350256906L1C006R06201343349	chr1	48388	50M	198	48586	48389	48587	V350256906L1C006R06201343349_chr1_48388	49	64	TGAA	ccat
V350256906L1C006R06300182779	chr1	1204587	50M	241	1204828	1204588	1204829	V350256906L1C006R06300182779_chr1_1204587	102	66	CCCC	GGAG
V350256906L1C006R06300234191	chr1	1247592	50M	164	1247756	1247593	1247757	V350256906L1C006R06300234191_chr1_1247592	0	7	ggcc	CCCA
V350256906L1C006R06300347124	chr1	1397579	50M	160	1397739	1397580	1397740	V350256906L1C006R06300347124_chr1_1397579	59	60	CCCT	CTCA
V350256906L1C006R06300605449	chr1	1019573	50M	157	1019730	1019574	1019731	V350256906L1C006R06300605449_chr1_1019573	0	20	CGGC	ACAG
V350256906L1C006R06300684170	chr1	677560	50M	171	677731	677561	677732	V350256906L1C006R06300684170_chr1_677560	64	67	ctag	taat
V350256906L1C006R06300918437	chr1	779647	50M	181	779828	779648	779829	V350256906L1C006R06300918437_chr1_779647	51	44	ccag	GCAA
V350256906L1C006R06300975457	chr1	1304010	50M	181	1304191	1304011	1304192	V350256906L1C006R06300975457_chr1_1304010	171	21	ccag	cccg
V350256906L1C006R06300995242	chr1	698278	50M	198	698476	698279	698477	V350256906L1C006R06300995242_chr1_698278	0	36	ccaa	ccta
V350256906L1C006R06301009108	chr1	439620	50M	206	439826	439621	439827	V350256906L1C006R06301009108_chr1_439620	20	44	tgat	attt
V350256906L1C006R06301149317	chr1	410447	50M	159	410606	410448	410607	V350256906L1C006R06301149317_chr1_410447	335	187	CCCA	CAGA
V350256906L1C006R06400199865	chr1	1021941	50M	158	1022099	1021942	1022100	V350256906L1C006R06400199865_chr1_1021941	114	1	CCTG	ACAC
V350256906L1C006R06400233394	chr1	854678	50M	150	854828	854679	854829	V350256906L1C006R06400233394_chr1_854678	62	43	CCCC	CACG
V350256906L1C006R06400948094	chr1	400774	50M	214	400988	400775	400989	V350256906L1C006R06400948094_chr1_400774	100	25	caat	aaat
V350256906L1C006R06400966064	chr1	871980	50M	192	872172	871981	872173	V350256906L1C006R06400966064_chr1_871980	156	9	CGTG	ATCA
V350256906L1C006R06401188948	chr1	129491	50M	224	129715	129492	129716	V350256906L1C006R06401188948_chr1_129491	134	162	caag	actg
V350256906L1C006R06500481839	chr1	897744	50M	148	897892	897745	897893	V350256906L1C006R06500481839_chr1_897744	82	9	CTGG	CTCC
V350256906L1C006R06500505297	chr1	459055	50M	190	459245	459056	459246	V350256906L1C006R06500505297_chr1_459055	59	63	gaag	CTGA
V350256906L1C006R06500564383	chr1	351719	50M	168	351887	351720	351888	V350256906L1C006R06500564383_chr1_351719	0	0	AGCA	CCTA
V350256906L1C006R06500703616	chr1	870701	50M	175	870876	870702	870877	V350256906L1C006R06500703616_chr1_870701	60	88	ctcg	CACG
V350256906L1C006R06500744194	chr1	846027	50M	167	846194	846028	846195	V350256906L1C006R06500744194_chr1_846027	127	15	CCAC	TGCC
V350256906L1C006R06501019869	chr1	745610	50M	122	745732	745611	745733	V350256906L1C006R06501019869_chr1_745610	44	30	CTTT	ATTC
V350256906L1C006R06600007696	chr1	144098	50M	175	144273	144099	144274	V350256906L1C006R06600007696_chr1_144098	112	149	CTGC	ccag
V350256906L1C006R06600437214	chr1	651700	50M	152	651852	651701	651853	V350256906L1C006R06600437214_chr1_651700	59	26	GCTT	GCAC
V350256906L1C006R06600459823	chr1	158023	50M	166	158189	158024	158190	V350256906L1C006R06600459823_chr1_158023	32	47	ACTC	ttga
V350256906L1C006R06600484452	chr1	1424630	50M	186	1424816	1424631	1424817	V350256906L1C006R06600484452_chr1_1424630	11	51	ACCA	CGTG
V350256906L1C006R06600694541	chr1	1099352	50M	200	1099552	1099353	1099553	V350256906L1C006R06600694541_chr1_1099352	4	0	CTTA	CCTA
V350256906L1C006R06700277827	chr1	435196	50M	195	435391	435197	435392	V350256906L1C006R06700277827_chr1_435196	39	38	ACCA	GGAC
V350256906L1C006R06701110258	chr1	780878	50M	171	781049	780879	781050	V350256906L1C006R06701110258_chr1_780878	51	19	CGTG	AGAT
V350256906L1C006R06701143061	chr1	154260	50M	146	154406	154261	154407	V350256906L1C006R06701143061_chr1_154260	129	73	taat	tccc
V350256906L1C006R06800454781	chr1	574380	50M	169	574549	574381	574550	V350256906L1C006R06800454781_chr1_574380	65	56	ACAC	CCAA
V350256906L1C006R06800634253	chr1	94388	50M	163	94551	94389	94552	V350256906L1C006R06800634253_chr1_94388	47	64	TGTA	gctc
V350256906L1C006R06800709342	chr1	1177328	50M	180	1177508	1177329	1177509	V350256906L1C006R06800709342_chr1_1177328	38	55	CACG	CCAG
V350256906L1C006R06800814510	chr1	1111650	50M	168	1111818	1111651	1111819	V350256906L1C006R06800814510_chr1_1111650	46	1	CGCT	AGCT
V350256906L1C006R06800902211	chr1	246465	50M	216	246681	246466	246682	V350256906L1C006R06800902211_chr1_246465	0	35	taat	ATAA
V350256906L1C006R06900493065	chr1	682838	50M	148	682986	682839	682987	V350256906L1C006R06900493065_chr1_682838	49	197	cctg	gcta
V350256906L1C006R06900664424	chr1	676783	50M	188	676971	676784	676972	V350256906L1C006R06900664424_chr1_676783	67	70	cctc	ccca
V350256906L1C006R06900813091	chr1	1068910	50M	194	1069104	1068911	1069105	V350256906L1C006R06900813091_chr1_1068910	60	58	GGAC	AGCA
V350256906L1C006R06900821744	chr1	27251	50M	147	27398	27252	27399	V350256906L1C006R06900821744_chr1_27251	72	19	TGGA	agcc
V350256906L1C006R06901010567	chr1	610716	50M	211	610927	610717	610928	V350256906L1C006R06901010567_chr1_610716	0	80	CTGG	CCGG
V350256906L1C006R06901099311	chr1	696557	50M	142	696699	696558	696700	V350256906L1C006R06901099311_chr1_696557	89	219	ACTA	CTTT
V350256906L1C006R06901273500	chr1	1038052	50M	174	1038226	1038053	1038227	V350256906L1C006R06901273500_chr1_1038052	0	0	cctg	tgtc
V350256906L1C006R06901287706	chr1	1095451	50M	206	1095657	1095452	1095658	V350256906L1C006R06901287706_chr1_1095451	42	67	ccca	CCTT
V350256906L1C006R07000366193	chr1	1211932	50M	195	1212127	1211933	1212128	V350256906L1C006R07000366193_chr1_1211932	0	43	cact	caac
V350256906L1C006R07000446056	chr1	456204	50M	160	456364	456205	456365	V350256906L1C006R07000446056_chr1_456204	531	600	catt	AAAT
V350256906L1C006R07000972461	chr1	81841	50M	185	82026	81842	82027	V350256906L1C006R07000972461_chr1_81841	39	20	gaaa	ctga
V350256906L1C006R07100381112	chr1	467317	50M	201	467518	467318	467519	V350256906L1C006R07100381112_chr1_467317	0	4	catg	agat
V350256906L1C006R07100545435	chr1	98203	50M	168	98371	98204	98372	V350256906L1C006R07100545435_chr1_98203	266	98	ACTT	GAAT
V350256906L1C006R07100644140	chr1	136452	50M	174	136626	136453	136627	V350256906L1C006R07100644140_chr1_136452	0	144	GCTC	CCCA
V350256906L1C006R07100678731	chr1	51202	50M	168	51370	51203	51371	V350256906L1C006R07100678731_chr1_51202	154	4	TCAT	CCCA
V350256906L1C006R07100721663	chr1	1099016	50M	173	1099189	1099017	1099190	V350256906L1C006R07100721663_chr1_1099016	129	19	AGGC	CTGA
V350256906L1C006R07100912036	chr1	17549	50M	127	17676	17550	17677	V350256906L1C006R07100912036_chr1_17549	78	13	CACT	GACT
V350256906L1C006R07100980797	chr1	736692	50M	207	736899	736693	736900	V350256906L1C006R07100980797_chr1_736692	256	49	gctt	CATA
V350256906L1C006R07200270615	chr1	236009	50M	159	236168	236010	236169	V350256906L1C006R07200270615_chr1_236009	11	54	TGTC	CTTG
V350256906L1C006R07200378394	chr1	253924	50M	166	254090	253925	254091	V350256906L1C006R07200378394_chr1_253924	63	49	agag	Atga
V350256906L1C006R07200545102	chr1	809957	50M	179	810136	809958	810137	V350256906L1C006R07200545102_chr1_809957	58	58	CCTG	AGCC
V350256906L1C006R07200965108	chr1	598872	50M	179	599051	598873	599052	V350256906L1C006R07200965108_chr1_598872	0	45	ccca	agaa
V350256906L2C001R00100121147	chr1	773525	50M	157	773682	773526	773683	V350256906L2C001R00100121147_chr1_773525	56	0	ccta	ccct
V350256906L2C001R00100528008	chr1	848943	50M	169	849112	848944	849113	V350256906L2C001R00100528008_chr1_848943	43	41	CTCT	CTGA
V350256906L2C001R00100766213	chr1	110488	50M	220	110708	110489	110709	V350256906L2C001R00100766213_chr1_110488	0	18	tgca	tgct
V350256906L2C001R00100848424	chr1	657297	50M	203	657500	657298	657501	V350256906L2C001R00100848424_chr1_657297	61	81	agag	GCCT
V350256906L2C001R00101046739	chr1	806732	50M	150	806882	806733	806883	V350256906L2C001R00101046739_chr1_806732	29	8	cctg	tccc
V350256906L2C001R00101171488	chr1	674346	50M	163	674509	674347	674510	V350256906L2C001R00101171488_chr1_674346	47	35	ggct	TTTG
V350256906L2C001R00200085222	chr1	574724	50M	168	574892	574725	574893	V350256906L2C001R00200085222_chr1_574724	52	9	taat	ccag
V350256906L2C001R00200264750	chr1	1267254	50M	172	1267426	1267255	1267427	V350256906L2C001R00200264750_chr1_1267254	10	12	GGCC	CCAT
V350256906L2C001R00200451610	chr1	837599	50M	155	837754	837600	837755	V350256906L2C001R00200451610_chr1_837599	74	37	CCTC	CGTC
V350256906L2C001R00200594182	chr1	325620	50M	149	325769	325621	325770	V350256906L2C001R00200594182_chr1_325620	23	50	CCAG	CACA
V350256906L2C001R00201150388	chr1	255835	50M	155	255990	255836	255991	V350256906L2C001R00201150388_chr1_255835	65	61	TGAA	CCTT
V350256906L2C001R00201235330	chr1	805351	50M	152	805503	805352	805504	V350256906L2C001R00201235330_chr1_805351	39	29	GCGG	CCGC
V350256906L2C001R00300043069	chr1	789754	50M	150	789904	789755	789905	V350256906L2C001R00300043069_chr1_789754	87	12	AAAT	TGTG
V350256906L2C001R00300180638	chr1	1273933	50M	161	1274094	1273934	1274095	V350256906L2C001R00300180638_chr1_1273933	60	52	CCAC	GGCC
V350256906L2C001R00300345818	chr1	775859	50M	175	776034	775860	776035	V350256906L2C001R00300345818_chr1_775859	47	51	TAGT	TGTG
V350256906L2C001R00300450209	chr1	1158725	50M	160	1158885	1158726	1158886	V350256906L2C001R00300450209_chr1_1158725	90	219	CAAG	GTGT
V350256906L2C001R00300557453	chr1	610701	50M	170	610871	610702	610872	V350256906L2C001R00300557453_chr1_610701	0	24	CATG	TGAA
V350256906L2C001R00300769184	chr1	358984	50M	165	359149	358985	359150	V350256906L2C001R00300769184_chr1_358984	85	97	CCTA	GCCC
V350256906L2C001R00300777130	chr1	1157185	50M	194	1157379	1157186	1157380	V350256906L2C001R00300777130_chr1_1157185	8	1	caaa	CATT
V350256906L2C001R00300964432	chr1	94339	50M	112	94451	94340	94452	V350256906L2C001R00300964432_chr1_94339	66	0	tacc	GATT
V350256906L2C001R00301328962	chr1	1122108	50M	161	1122269	1122109	1122270	V350256906L2C001R00301328962_chr1_1122108	0	8	taat	ggac
V350256906L2C001R00400567010	chr1	85205	50M	159	85364	85206	85365	V350256906L2C001R00400567010_chr1_85205	19	92	ggcc	ttca
V350256906L2C001R00400595423	chr1	997473	50M	151	997624	997474	997625	V350256906L2C001R00400595423_chr1_997473	1	34	cctt	CAGA
V350256906L2C001R00400602030	chr1	19607	50M	152	19759	19608	19760	V350256906L2C001R00400602030_chr1_19607	45	0	GCCC	AGGA
V350256906L2C001R00400606800	chr1	738389	50M	184	738573	738390	738574	V350256906L2C001R00400606800_chr1_738389	22	121	GGAA	ccca
V350256906L2C001R00400618784	chr1	1036757	50M	198	1036955	1036758	1036956	V350256906L2C001R00400618784_chr1_1036757	0	14	ggag	CCCT
V350256906L2C001R00401353924	chr1	105039	50M	178	105217	105040	105218	V350256906L2C001R00401353924_chr1_105039	62	65	ggag	GTAA
V350256906L2C001R00500060998	chr1	168653	50M	181	168834	168654	168835	V350256906L2C001R00500060998_chr1_168653	106	0	ccca	CTCT
V350256906L2C001R00500145922	chr1	29107	50M	209	29316	29108	29317	V350256906L2C001R00500145922_chr1_29107	59	84	CAAG	GAGG
V350256906L2C001R00500510883	chr1	451427	50M	141	451568	451428	451569	V350256906L2C001R00500510883_chr1_451427	79	197	tgtg	cacc
V350256906L2C001R00500688322	chr1	402413	50M	161	402574	402414	402575	V350256906L2C001R00500688322_chr1_402413	160	0	ccaa	tgct
V350256906L2C001R00500917680	chr1	849837	50M	253	850090	849838	850091	V350256906L2C001R00500917680_chr1_849837	57	0	gggg	cctc
V350256906L2C001R00501198901	chr1	111675	50M	165	111840	111676	111841	V350256906L2C001R00501198901_chr1_111675	28	7	TGTG	TGTT
V350256906L2C001R00600199079	chr1	107445	50M	188	107633	107446	107634	V350256906L2C001R00600199079_chr1_107445	34	72	TATA	agga
V350256906L2C001R00600199309	chr1	94694	50M	166	94860	94695	94861	V350256906L2C001R00600199309_chr1_94694	47	32	ccaa	agat
V350256906L2C001R00600207442	chr1	791877	50M	167	792044	791878	792045	V350256906L2C001R00600207442_chr1_791877	17	46	CCTC	CACC
V350256906L2C001R00600252789	chr1	1347870	50M	179	1348049	1347871	1348050	V350256906L2C001R00600252789_chr1_1347870	44	58	acac	gaaa
V350256906L2C001R00600382178	chr1	343848	50M	166	344014	343849	344015	V350256906L2C001R00600382178_chr1_343848	0	62	attt	GATA
V350256906L2C001R00600925765	chr1	872951	50M	176	873127	872952	873128	V350256906L2C001R00600925765_chr1_872951	0	69	CCAG	CCCC
V350256906L2C001R00600992613	chr1	845987	50M	175	846162	845988	846163	V350256906L2C001R00600992613_chr1_845987	167	0	AACT	GGCC
V350256906L2C001R00601359465	chr1	726825	27S22M1S	145	726970	726826	726971	V350256906L2C001R00601359465_chr1_726825	0	25	gaat	catt
V350256906L2C001R00601365831	chr1	1086564	50M	201	1086765	1086565	1086766	V350256906L2C001R00601365831_chr1_1086564	23	62	CCCC	CGGA
V350256906L2C001R00700066473	chr1	988865	50M	170	989035	988866	989036	V350256906L2C001R00700066473_chr1_988865	172	2	CCTT	GGCT
V350256906L2C001R00700233577	chr1	446159	50M	164	446323	446160	446324	V350256906L2C001R00700233577_chr1_446159	0	158	gcgc	aagt
V350256906L2C001R00700376737	chr1	1067890	50M	164	1068054	1067891	1068055	V350256906L2C001R00700376737_chr1_1067890	40	3	CACA	ccca
V350256906L2C001R00700438528	chr1	831634	50M	139	831773	831635	831774	V350256906L2C001R00700438528_chr1_831634	38	71	gcaa	caca
V350256906L2C001R00700561867	chr1	537476	50M	179	537655	537477	537656	V350256906L2C001R00700561867_chr1_537476	114	14	CCCC	ggag
V350256906L2C001R00700664873	chr1	1248435	50M	159	1248594	1248436	1248595	V350256906L2C001R00700664873_chr1_1248435	33	6	CGAG	TCCA
V350256906L2C001R00700750817	chr1	730293	50M	148	730441	730294	730442	V350256906L2C001R00700750817_chr1_730293	47	40	CCAT	acct
V350256906L2C001R00701180056	chr1	1196265	50M	187	1196452	1196266	1196453	V350256906L2C001R00701180056_chr1_1196265	37	31	tgaa	ttcc
V350256906L2C001R00701276475	chr1	255523	50M	169	255692	255524	255693	V350256906L2C001R00701276475_chr1_255523	0	10	TCCC	ACTA
V350256906L2C001R00801257880	chr1	579594	50M	192	579786	579595	579787	V350256906L2C001R00801257880_chr1_579594	0	189	agcc	CTAG
V350256906L2C001R00900330066	chr1	831112	50M	180	831292	831113	831293	V350256906L2C001R00900330066_chr1_831112	21	201	ctgg	aaaa
V350256906L2C001R00900594566	chr1	670373	50M	162	670535	670374	670536	V350256906L2C001R00900594566_chr1_670373	70	138	caga	cctt
V350256906L2C001R00900690167	chr1	1332433	50M	175	1332608	1332434	1332609	V350256906L2C001R00900690167_chr1_1332433	47	24	tgtg	AGCC
V350256906L2C001R00900720234	chr1	753873	50M	168	754041	753874	754042	V350256906L2C001R00900720234_chr1_753873	57	53	CTGG	caga
V350256906L2C001R00901237473	chr1	751056	50M	221	751277	751057	751278	V350256906L2C001R00901237473_chr1_751056	65	31	AAAT	tata
V350256906L2C001R00901360011	chr1	726865	10S27M13S	128	726993	726866	726994	V350256906L2C001R00901360011_chr1_726865	21	2	gaat	ttcc
V350256906L2C001R00901382867	chr1	1213450	50M	182	1213632	1213451	1213633	V350256906L2C001R00901382867_chr1_1213450	177	0	agaa	aatt
V350256906L2C001R01000069837	chr1	1399208	50M	170	1399378	1399209	1399379	V350256906L2C001R01000069837_chr1_1399208	56	69	cttg	cctg
V350256906L2C001R01000212915	chr1	1296160	50M	173	1296333	1296161	1296334	V350256906L2C001R01000212915_chr1_1296160	87	40	GGGA	catg
V350256906L2C001R01000822464	chr1	879919	50M	151	880070	879920	880071	V350256906L2C001R01000822464_chr1_879919	56	32	TGGT	GCCC
V350256906L2C001R01100065711	chr1	135314	50M	222	135536	135315	135537	V350256906L2C001R01100065711_chr1_135314	9	64	TGGG	CGAA
V350256906L2C001R01100237206	chr1	1205444	50M	164	1205608	1205445	1205609	V350256906L2C001R01100237206_chr1_1205444	20	18	ccct	ctat
V350256906L2C001R01100243109	chr1	390551	50M	167	390718	390552	390719	V350256906L2C001R01100243109_chr1_390551	43	46	ccaa	tgca
V350256906L2C001R01100251201	chr1	1094133	50M	154	1094287	1094134	1094288	V350256906L2C001R01100251201_chr1_1094133	32	101	ACCT	CCGT
V350256906L2C001R01100338505	chr1	1416129	50M	186	1416315	1416130	1416316	V350256906L2C001R01100338505_chr1_1416129	59	60	CCCA	CGCC
V350256906L2C001R01100631898	chr1	794552	50M	143	794695	794553	794696	V350256906L2C001R01100631898_chr1_794552	0	15	ATTA	GATA
V350256906L2C001R01100951952	chr1	678863	50M	172	679035	678864	679036	V350256906L2C001R01100951952_chr1_678863	0	122	GGGA	accc
V350256906L2C001R01200121453	chr1	992577	50M	155	992732	992578	992733	V350256906L2C001R01200121453_chr1_992577	73	21	ctcc	CCCC
V350256906L2C001R01200290936	chr1	338023	50M	171	338194	338024	338195	V350256906L2C001R01200290936_chr1_338023	38	60	CCCC	GGAA
V350256906L2C001R01200438500	chr1	16081	50M	175	16256	16082	16257	V350256906L2C001R01200438500_chr1_16081	141	11	CCGG	CTCT
V350256906L2C001R01200496504	chr1	874635	50M	174	874809	874636	874810	V350256906L2C001R01200496504_chr1_874635	54	60	CCCC	CAGG
V350256906L2C001R01200657078	chr1	97929	50M	174	98103	97930	98104	V350256906L2C001R01200657078_chr1_97929	0	173	taac	ATAC
V350256906L2C001R01200677393	chr1	732292	50M	168	732460	732293	732461	V350256906L2C001R01200677393_chr1_732292	0	1	CCTT	ttta
V350256906L2C001R01200860237	chr1	1296776	50M	164	1296940	1296777	1296941	V350256906L2C001R01200860237_chr1_1296776	65	60	CCTG	GGCA
V350256906L2C001R01200922792	chr1	747565	50M	159	747724	747566	747725	V350256906L2C001R01200922792_chr1_747565	167	199	caaa	caat
V350256906L2C001R01201139970	chr1	14349	50M	161	14510	14350	14511	V350256906L2C001R01201139970_chr1_14349	0	0	CGAG	CTGC
V350256906L2C001R01300068705	chr1	1307800	50M	181	1307981	1307801	1307982	V350256906L2C001R01300068705_chr1_1307800	21	45	CCTC	CCTT
V350256906L2C001R01300402981	chr1	138594	50M	169	138763	138595	138764	V350256906L2C001R01300402981_chr1_138594	51	67	GCAG	CTTC
V350256906L2C001R01300511878	chr1	1331718	50M	170	1331888	1331719	1331889	V350256906L2C001R01300511878_chr1_1331718	40	65	ctca	gatc
V350256906L2C001R01300596960	chr1	347950	50M	137	348087	347951	348088	V350256906L2C001R01300596960_chr1_347950	142	212	ccta	CATT
V350256906L2C001R01300609688	chr1	645663	50M	174	645837	645664	645838	V350256906L2C001R01300609688_chr1_645663	0	53	AAAC	aaaa
V350256906L2C001R01300717005	chr1	1428504	50M	171	1428675	1428505	1428676	V350256906L2C001R01300717005_chr1_1428504	69	63	ACAG	cttc
V350256906L2C001R01300909828	chr1	698585	50M	165	698750	698586	698751	V350256906L2C001R01300909828_chr1_698585	83	62	GGAA	GGCT
V350256906L2C001R01301009975	chr1	888122	50M	172	888294	888123	888295	V350256906L2C001R01301009975_chr1_888122	52	26	CCCC	AGGA
V350256906L2C001R01301389318	chr1	690097	50M	184	690281	690098	690282	V350256906L2C001R01301389318_chr1_690097	79	75	caag	acag
V350256906L2C001R01400295981	chr1	340615	50M	169	340784	340616	340785	V350256906L2C001R01400295981_chr1_340615	28	153	CACT	CTCT
V350256906L2C001R01400373853	chr1	256504	50M	198	256702	256505	256703	V350256906L2C001R01400373853_chr1_256504	0	191	caaa	actt
V350256906L2C001R01400751063	chr1	1063787	50M	186	1063973	1063788	1063974	V350256906L2C001R01400751063_chr1_1063787	36	54	GGAT	CAGG
V350256906L2C001R01400799960	chr1	12298	50M	155	12453	12299	12454	V350256906L2C001R01400799960_chr1_12298	0	6	TACC	GCCA
V350256906L2C001R01500092669	chr1	58744	50M	164	58908	58745	58909	V350256906L2C001R01500092669_chr1_58744	176	12	TAGA	ATAA
V350256906L2C001R01500160092	chr1	974450	50M	179	974629	974451	974630	V350256906L2C001R01500160092_chr1_974450	43	50	ccta	CCAC
V350256906L2C001R01500237864	chr1	85840	50M	153	85993	85841	85994	V350256906L2C001R01500237864_chr1_85840	0	26	atac	GGCT
V350256906L2C001R01500322197	chr1	550625	50M	152	550777	550626	550778	V350256906L2C001R01500322197_chr1_550625	73	19	CTCT	GGAC
V350256906L2C001R01500359003	chr1	1131755	50M	163	1131918	1131756	1131919	V350256906L2C001R01500359003_chr1_1131755	0	33	cgta	GAAC
V350256906L2C001R01500402884	chr1	344294	50M	179	344473	344295	344474	V350256906L2C001R01500402884_chr1_344294	0	174	gcaa	gtaa
V350256906L2C001R01500626027	chr1	58933	50M	173	59106	58934	59107	V350256906L2C001R01500626027_chr1_58933	0	13	TGAG	aaac
V350256906L2C001R01500861060	chr1	1293408	50M	168	1293576	1293409	1293577	V350256906L2C001R01500861060_chr1_1293408	58	35	GGCC	TCCC
V350256906L2C001R01501038995	chr1	629787	50M	167	629954	629788	629955	V350256906L2C001R01501038995_chr1_629787	43	58	TTAA	TGGA
V350256906L2C001R01600067264	chr1	855618	50M	190	855808	855619	855809	V350256906L2C001R01600067264_chr1_855618	52	112	GACT	GGGG
V350256906L2C001R01600316335	chr1	1216369	50M	180	1216549	1216370	1216550	V350256906L2C001R01600316335_chr1_1216369	123	39	GGGA	AGCC
V350256906L2C001R01600638345	chr1	756864	50M	159	757023	756865	757024	V350256906L2C001R01600638345_chr1_756864	0	3	CCTG	GACC
V350256906L2C001R01600908650	chr1	430710	50M	195	430905	430711	430906	V350256906L2C001R01600908650_chr1_430710	124	51	aacc	cttt
V350256906L2C001R01600965601	chr1	25566	50M	162	25728	25567	25729	V350256906L2C001R01600965601_chr1_25566	173	11	CAAA	GCTG
V350256906L2C001R01700252154	chr1	27281	50M	157	27438	27282	27439	V350256906L2C001R01700252154_chr1_27281	42	59	cctg	tcaa
V350256906L2C001R01700347493	chr1	150064	50M	188	150252	150065	150253	V350256906L2C001R01700347493_chr1_150064	3	56	CTCA	tgag
V350256906L2C001R01700604624	chr1	30864	50M	147	31011	30865	31012	V350256906L2C001R01700604624_chr1_30864	14	38	ctcc	ggtt
V350256906L2C001R01700798701	chr1	71657	50M	167	71824	71658	71825	V350256906L2C001R01700798701_chr1_71657	35	62	ACTA	ctgt
V350256906L2C001R01701034771	chr1	1191916	50M	130	1192046	1191917	1192047	V350256906L2C001R01701034771_chr1_1191916	56	49	CGAC	cgtg
V350256906L2C001R01701120769	chr1	822626	50M	165	822791	822627	822792	V350256906L2C001R01701120769_chr1_822626	31	47	TTTA	CATG
V350256906L2C001R01701138233	chr1	1128004	50M	136	1128140	1128005	1128141	V350256906L2C001R01701138233_chr1_1128004	21	62	GGTA	TGTC
V350256906L2C001R01701211614	chr1	869088	34M1I15M	228	869316	869089	869317	V350256906L2C001R01701211614_chr1_869088	99	220	ACTT	ACCC
V350256906L2C001R01701333555	chr1	892999	50M	155	893154	893000	893155	V350256906L2C001R01701333555_chr1_892999	10	0	gcaa	cctt
V350256906L2C001R01800208125	chr1	149255	50M	159	149414	149256	149415	V350256906L2C001R01800208125_chr1_149255	32	93	AGTC	gaac
V350256906L2C001R01800453935	chr1	628782	50M	199	628981	628783	628982	V350256906L2C001R01800453935_chr1_628782	39	55	caaa	AGCC
V350256906L2C001R01800528042	chr1	577842	50M	181	578023	577843	578024	V350256906L2C001R01800528042_chr1_577842	111	292	CAAT	CCCA
V350256906L2C001R01800728256	chr1	419644	50M	156	419800	419645	419801	V350256906L2C001R01800728256_chr1_419644	183	176	aatg	TCTA
V350256906L2C001R01800790582	chr1	389824	50M	178	390002	389825	390003	V350256906L2C001R01800790582_chr1_389824	58	76	attc	ttat
V350256906L2C001R01900108565	chr1	40336	50M	164	40500	40337	40501	V350256906L2C001R01900108565_chr1_40336	46	87	cctg	aaca
V350256906L2C001R01900161830	chr1	817031	50M	153	817184	817032	817185	V350256906L2C001R01900161830_chr1_817031	0	79	TGAG	CTGA
V350256906L2C001R01900205160	chr1	921682	50M	176	921858	921683	921859	V350256906L2C001R01900205160_chr1_921682	100	37	ggat	accc
V350256906L2C001R01900553467	chr1	798238	50M	169	798407	798239	798408	V350256906L2C001R01900553467_chr1_798238	72	51	gtct	gcaa
V350256906L2C001R01900568357	chr1	1350049	50M	178	1350227	1350050	1350228	V350256906L2C001R01900568357_chr1_1350049	68	59	gact	ctga
V350256906L2C001R01900582777	chr1	1190249	50M	216	1190465	1190250	1190466	V350256906L2C001R01900582777_chr1_1190249	61	38	GCAA	TAAA
V350256906L2C001R01901100252	chr1	756189	28M22S	189	756378	756190	756379	V350256906L2C001R01901100252_chr1_756189	0	0	GTCT	CAGG
V350256906L2C001R01901136605	chr1	709126	50M	157	709283	709127	709284	V350256906L2C001R01901136605_chr1_709126	11	17	CAAC	CAGT
V350256906L2C001R01901152552	chr1	853348	50M	156	853504	853349	853505	V350256906L2C001R01901152552_chr1_853348	64	48	CACG	ATGT
V350256906L2C001R02000078641	chr1	229679	50M	266	229945	229680	229946	V350256906L2C001R02000078641_chr1_229679	62	34	cctg	cctc
V350256906L2C001R02000388942	chr1	21106	50M	173	21279	21107	21280	V350256906L2C001R02000388942_chr1_21106	0	134	GGTC	ACAG
V350256906L2C001R02000662918	chr1	804867	50M	137	805004	804868	805005	V350256906L2C001R02000662918_chr1_804867	39	18	gcct	CCCC
V350256906L2C001R02000846439	chr1	576767	50M	167	576934	576768	576935	V350256906L2C001R02000846439_chr1_576767	64	55	TGAC	GCCT
V350256906L2C001R02000903112	chr1	1319155	24M1D26M	164	1319319	1319156	1319320	V350256906L2C001R02000903112_chr1_1319155	43	20	acaa	CCCC
V350256906L2C001R02001059423	chr1	107119	50M	167	107286	107120	107287	V350256906L2C001R02001059423_chr1_107119	0	0	CAAT	TAAG
V350256906L2C001R02001183714	chr1	1007681	50M	185	1007866	1007682	1007867	V350256906L2C001R02001183714_chr1_1007681	35	32	CCCA	CCCA
V350256906L2C001R02100051953	chr1	1398316	50M	158	1398474	1398317	1398475	V350256906L2C001R02100051953_chr1_1398316	58	53	GGTC	ACAC
V350256906L2C001R02100233827	chr1	1341607	50M	142	1341749	1341608	1341750	V350256906L2C001R02100233827_chr1_1341607	36	33	tgca	GGtt
V350256906L2C001R02100407712	chr1	72067	50M	177	72244	72068	72245	V350256906L2C001R02100407712_chr1_72067	0	99	TGTA	cctg
V350256906L2C001R02100481040	chr1	125357	50M	198	125555	125358	125556	V350256906L2C001R02100481040_chr1_125357	92	290	ATTA	GACA
V350256906L2C001R02100493965	chr1	1377162	50M	172	1377334	1377163	1377335	V350256906L2C001R02100493965_chr1_1377162	54	60	GCTC	GCAG
V350256906L2C001R02100569229	chr1	1163450	50M	166	1163616	1163451	1163617	V350256906L2C001R02100569229_chr1_1163450	27	0	GTGG	CCAG
V350256906L2C001R02100861711	chr1	1314953	50M	166	1315119	1314954	1315120	V350256906L2C001R02100861711_chr1_1314953	4	0	caac	gtgt
V350256906L2C001R02100975075	chr1	1110151	50M	165	1110316	1110152	1110317	V350256906L2C001R02100975075_chr1_1110151	5	42	CCTG	ccat
V350256906L2C001R02101015636	chr1	904754	50M	129	904883	904755	904884	V350256906L2C001R02101015636_chr1_904754	11	0	tata	caca
V350256906L2C001R02101147523	chr1	996856	50M	173	997029	996857	997030	V350256906L2C001R02101147523_chr1_996856	68	66	GGAC	ccaa
V350256906L2C001R02200067088	chr1	1065815	50M	147	1065962	1065816	1065963	V350256906L2C001R02200067088_chr1_1065815	29	75	CGTC	agaa
V350256906L2C001R02200315255	chr1	692983	50M	186	693169	692984	693170	V350256906L2C001R02200315255_chr1_692983	0	0	ctaa	CACC
V350256906L2C001R02200387842	chr1	810564	50M	143	810707	810565	810708	V350256906L2C001R02200387842_chr1_810564	73	24	GCTG	TGAA
V350256906L2C001R02200491404	chr1	1188324	50M	163	1188487	1188325	1188488	V350256906L2C001R02200491404_chr1_1188324	17	55	cctg	gggc
V350256906L2C001R02200491455	chr1	991459	50M	161	991620	991460	991621	V350256906L2C001R02200491455_chr1_991459	106	133	TGTC	CCCT
V350256906L2C001R02201003694	chr1	686224	50M	134	686358	686225	686359	V350256906L2C001R02201003694_chr1_686224	0	16	catg	CTAC
V350256906L2C001R02201219478	chr1	1403237	50M	102	1403339	1403238	1403340	V350256906L2C001R02201219478_chr1_1403237	0	56	CCAG	TGAG
V350256906L2C001R02201286466	chr1	377191	50M	165	377356	377192	377357	V350256906L2C001R02201286466_chr1_377191	61	46	cctc	cagg
V350256906L2C001R02300264264	chr1	744995	50M	199	745194	744996	745195	V350256906L2C001R02300264264_chr1_744995	0	107	CTCA	CATG
V350256906L2C001R02300327984	chr1	1290034	50M	270	1290304	1290035	1290305	V350256906L2C001R02300327984_chr1_1290034	2	48	TCCC	CCTT
V350256906L2C001R02300514485	chr1	70019	50M	161	70180	70020	70181	V350256906L2C001R02300514485_chr1_70019	150	0	ACTG	ACAC
V350256906L2C001R02301231508	chr1	266261	50M	176	266437	266262	266438	V350256906L2C001R02301231508_chr1_266261	69	56	tatc	TATG
V350256906L2C001R02400000310	chr1	1120154	50M	165	1120319	1120155	1120320	V350256906L2C001R02400000310_chr1_1120154	315	150	TTAG	CCCA
V350256906L2C001R02400018439	chr1	597047	50M	193	597240	597048	597241	V350256906L2C001R02400018439_chr1_597047	73	75	tgtc	TGCA
V350256906L2C001R02400197780	chr1	1401175	50M	154	1401329	1401176	1401330	V350256906L2C001R02400197780_chr1_1401175	9	0	tctt	tgaa
V350256906L2C001R02400719798	chr1	798210	50M	139	798349	798211	798350	V350256906L2C001R02400719798_chr1_798210	48	0	gaaa	cttg
V350256906L2C001R02400758564	chr1	828148	50M	201	828349	828149	828350	V350256906L2C001R02400758564_chr1_828148	60	67	ctgt	tggg
V350256906L2C001R02500141426	chr1	50603	50M	158	50761	50604	50762	V350256906L2C001R02500141426_chr1_50603	0	50	ctat	TAAA
V350256906L2C001R02500143512	chr1	584121	50M	204	584325	584122	584326	V350256906L2C001R02500143512_chr1_584121	56	74	GGAC	aatt
V350256906L2C001R02500156185	chr1	1027563	50M	158	1027721	1027564	1027722	V350256906L2C001R02500156185_chr1_1027563	3	36	GGTC	GCCC
V350256906L2C001R02500528870	chr1	1019804	50M	215	1020019	1019805	1020020	V350256906L2C001R02500528870_chr1_1019804	24	34	CCTG	CTGC
V350256906L2C001R02500746107	chr1	970976	50M	158	971134	970977	971135	V350256906L2C001R02500746107_chr1_970976	58	0	ccca	CCCC
V350256906L2C001R02500971138	chr1	96671	50M	177	96848	96672	96849	V350256906L2C001R02500971138_chr1_96671	11	16	CTGG	GCAG
V350256906L2C001R02600865508	chr1	791169	50M	191	791360	791170	791361	V350256906L2C001R02600865508_chr1_791169	29	11	AGAT	CATT
V350256906L2C001R02601149450	chr1	1408244	50M	170	1408414	1408245	1408415	V350256906L2C001R02601149450_chr1_1408244	58	71	cgcc	ggcc
V350256906L2C001R02601152999	chr1	1329340	50M	142	1329482	1329341	1329483	V350256906L2C001R02601152999_chr1_1329340	39	61	ctac	ccag
V350256906L2C001R02700160632	chr1	558909	50M	136	559045	558910	559046	V350256906L2C001R02700160632_chr1_558909	33	54	CCTT	GAAG
V350256906L2C001R02700543686	chr1	1322961	50M	179	1323140	1322962	1323141	V350256906L2C001R02700543686_chr1_1322961	53	22	TCCT	CACC
V350256906L2C001R02700804913	chr1	934319	50M	110	934429	934320	934430	V350256906L2C001R02700804913_chr1_934319	66	0	GAAA	CTGA
V350256906L2C001R02701182455	chr1	12707	50M	186	12893	12708	12894	V350256906L2C001R02701182455_chr1_12707	3	116	CCCA	AGAC
V350256906L2C001R02800029759	chr1	457602	50M	161	457763	457603	457764	V350256906L2C001R02800029759_chr1_457602	10	0	gtag	acca
V350256906L2C001R02800104291	chr1	530933	50M	171	531104	530934	531105	V350256906L2C001R02800104291_chr1_530933	27	38	GTGC	ctta
V350256906L2C001R02800236585	chr1	1134785	50M	263	1135048	1134786	1135049	V350256906L2C001R02800236585_chr1_1134785	51	7	CCTG	CCCT
V350256906L2C001R02800529304	chr1	1101160	50M	130	1101290	1101161	1101291	V350256906L2C001R02800529304_chr1_1101160	31	0	TGAA	CAGG
V350256906L2C001R02801005236	chr1	684166	50M	183	684349	684167	684350	V350256906L2C001R02801005236_chr1_684166	36	63	agag	taga
V350256906L2C001R02801168905	chr1	927139	50M	175	927314	927140	927315	V350256906L2C001R02801168905_chr1_927139	53	55	cagg	CGTC
V350256906L2C001R02900002189	chr1	979073	50M	154	979227	979074	979228	V350256906L2C001R02900002189_chr1_979073	18	72	CACC	CACA
V350256906L2C001R02900088852	chr1	921441	50M	158	921599	921442	921600	V350256906L2C001R02900088852_chr1_921441	61	64	ccct	actc
V350256906L2C001R02900223784	chr1	1021363	50M	189	1021552	1021364	1021553	V350256906L2C001R02900223784_chr1_1021363	19	21	GGAA	CCAG
V350256906L2C001R02900866409	chr1	118795	50M	158	118953	118796	118954	V350256906L2C001R02900866409_chr1_118795	131	66	acat	gttt
V350256906L2C001R03000120979	chr1	585351	50M	192	585543	585352	585544	V350256906L2C001R03000120979_chr1_585351	26	15	ggat	tgtg
V350256906L2C001R03000130644	chr1	718280	50M	189	718469	718281	718470	V350256906L2C001R03000130644_chr1_718280	29	73	caaa	cggt
V350256906L2C001R03000527704	chr1	588681	50M	185	588866	588682	588867	V350256906L2C001R03000527704_chr1_588681	117	30	caaa	tata
V350256906L2C001R03000647091	chr1	557091	50M	185	557276	557092	557277	V350256906L2C001R03000647091_chr1_557091	164	349	ACTT	GCCG
V350256906L2C001R03000678347	chr1	911622	50M	117	911739	911623	911740	V350256906L2C001R03000678347_chr1_911622	3	37	GAGA	CCTT
V350256906L2C001R03000898529	chr1	605354	50M	145	605499	605355	605500	V350256906L2C001R03000898529_chr1_605354	116	0	tacc	agag
V350256906L2C001R03001242382	chr1	80017	50M	199	80216	80018	80217	V350256906L2C001R03001242382_chr1_80017	24	49	aagc	tccc
V350256906L2C001R03100290055	chr1	742644	50M	190	742834	742645	742835	V350256906L2C001R03100290055_chr1_742644	24	48	CTCG	GGAT
V350256906L2C001R03100479312	chr1	1288405	50M	186	1288591	1288406	1288592	V350256906L2C001R03100479312_chr1_1288405	53	14	AGCA	GCTC
V350256906L2C001R03100566765	chr1	364778	50M	165	364943	364779	364944	V350256906L2C001R03100566765_chr1_364778	7	0	CCAT	GGAG
V350256906L2C001R03100853580	chr1	254552	50M	190	254742	254553	254743	V350256906L2C001R03100853580_chr1_254552	13	141	attt	gcta
V350256906L2C001R03100941013	chr1	156718	50M	154	156872	156719	156873	V350256906L2C001R03100941013_chr1_156718	16	81	Ctta	cctc
V350256906L2C001R03101070066	chr1	32637	50M	189	32826	32638	32827	V350256906L2C001R03101070066_chr1_32637	128	19	AACA	CCCA
V350256906L2C001R03101153450	chr1	429157	50M	172	429329	429158	429330	V350256906L2C001R03101153450_chr1_429157	68	61	gtta	ccct
V350256906L2C001R03200097201	chr1	1172353	50M	177	1172530	1172354	1172531	V350256906L2C001R03200097201_chr1_1172353	134	103	CATC	ACCT
V350256906L2C001R03200318250	chr1	739634	50M	194	739828	739635	739829	V350256906L2C001R03200318250_chr1_739634	0	34	catt	cata
V350256906L2C001R03200339453	chr1	1071690	50M	159	1071849	1071691	1071850	V350256906L2C001R03200339453_chr1_1071690	34	155	CCTG	ccac
V350256906L2C001R03200960738	chr1	813276	50M	141	813417	813277	813418	V350256906L2C001R03200960738_chr1_813276	279	420	GCCT	GGGA
V350256906L2C001R03300164615	chr1	1060287	50M	188	1060475	1060288	1060476	V350256906L2C001R03300164615_chr1_1060287	32	20	CAAA	GCCG
V350256906L2C001R03301142069	chr1	1111866	50M	154	1112020	1111867	1112021	V350256906L2C001R03301142069_chr1_1111866	32	186	TCCC	GCCC
V350256906L2C001R03400408027	chr1	1154320	50M	161	1154481	1154321	1154482	V350256906L2C001R03400408027_chr1_1154320	49	0	CAGC	GGCT
V350256906L2C001R03400630284	chr1	1253453	50M	184	1253637	1253454	1253638	V350256906L2C001R03400630284_chr1_1253453	51	53	tgtt	cttt
V350256906L2C001R03400900650	chr1	661686	50M	199	661885	661687	661886	V350256906L2C001R03400900650_chr1_661686	24	223	GGGC	GGCT
V350256906L2C001R03401033330	chr1	1267122	50M	170	1267292	1267123	1267293	V350256906L2C001R03401033330_chr1_1267122	142	0	TCTT	CTTG
V350256906L2C001R03401183224	chr1	1063837	50M	137	1063974	1063838	1063975	V350256906L2C001R03401183224_chr1_1063837	47	55	CTTT	CCAG
V350256906L2C001R03500620571	chr1	881718	50M	177	881895	881719	881896	V350256906L2C001R03500620571_chr1_881718	3	7	CATG	CCAA
V350256906L2C001R03500663240	chr1	105010	50M	195	105205	105011	105206	V350256906L2C001R03500663240_chr1_105010	77	71	ctgc	TGTC
V350256906L2C001R03500930244	chr1	550009	50M	162	550171	550010	550172	V350256906L2C001R03500930244_chr1_550009	70	40	ACTG	ggtg
V350256906L2C001R03501010833	chr1	768020	50M	145	768165	768021	768166	V350256906L2C001R03501010833_chr1_768020	49	160	CCCT	tcta
V350256906L2C001R03501085070	chr1	433578	50M	189	433767	433579	433768	V350256906L2C001R03501085070_chr1_433578	129	108	AATT	ACAA
V350256906L2C001R03600549920	chr1	1372749	50M	165	1372914	1372750	1372915	V350256906L2C001R03600549920_chr1_1372749	67	46	AGGC	TCTG
V350256906L2C001R03601023410	chr1	250456	50M	262	250718	250457	250719	V350256906L2C001R03601023410_chr1_250456	0	48	cctc	tgct
V350256906L2C001R03700538038	chr1	424061	50M	213	424274	424062	424275	V350256906L2C001R03700538038_chr1_424061	101	18	gaca	CCAT
V350256906L2C001R03700953302	chr1	102771	50M	184	102955	102772	102956	V350256906L2C001R03700953302_chr1_102771	47	80	actg	atag
V350256906L2C001R03800137730	chr1	922253	50M	180	922433	922254	922434	V350256906L2C001R03800137730_chr1_922253	81	107	gggt	aatc
V350256906L2C001R03800171624	chr1	1047331	50M	141	1047472	1047332	1047473	V350256906L2C001R03800171624_chr1_1047331	33	0	GGGG	gggg
V350256906L2C001R03800427046	chr1	50333	50M	166	50499	50334	50500	V350256906L2C001R03800427046_chr1_50333	58	46	TGTA	caca
V350256906L2C001R03800503437	chr1	466660	50M	180	466840	466661	466841	V350256906L2C001R03800503437_chr1_466660	86	78	GTGG	CAAA
V350256906L2C001R03800525028	chr1	468930	50M	144	469074	468931	469075	V350256906L2C001R03800525028_chr1_468930	0	118	cagt	tatt
V350256906L2C001R03800645328	chr1	701427	50M	185	701612	701428	701613	V350256906L2C001R03800645328_chr1_701427	98	61	TAAC	AGTA
V350256906L2C001R03801012148	chr1	804919	50M	170	805089	804920	805090	V350256906L2C001R03801012148_chr1_804919	29	38	AAGA	cacc
V350256906L2C001R03900240535	chr1	1032169	50M	169	1032338	1032170	1032339	V350256906L2C001R03900240535_chr1_1032169	0	24	acct	agac
V350256906L2C001R03901044958	chr1	32281	50M	171	32452	32282	32453	V350256906L2C001R03901044958_chr1_32281	9	12	GGAA	CCTC
V350256906L2C001R03901156553	chr1	87289	50M	162	87451	87290	87452	V350256906L2C001R03901156553_chr1_87289	4	28	tttt	ACAT
V350256906L2C001R04000080267	chr1	1398990	50M	210	1399200	1398991	1399201	V350256906L2C001R04000080267_chr1_1398990	31	64	CAAC	ccac
V350256906L2C001R04000141418	chr1	1365339	50M	180	1365519	1365340	1365520	V350256906L2C001R04000141418_chr1_1365339	10	25	caag	tgcc
V350256906L2C001R04000737222	chr1	1021314	50M	168	1021482	1021315	1021483	V350256906L2C001R04000737222_chr1_1021314	68	48	AACC	CGCA
V350256906L2C001R04001338299	chr1	1257197	50M	165	1257362	1257198	1257363	V350256906L2C001R04001338299_chr1_1257197	33	28	CCCG	GCCC
V350256906L2C001R04100048161	chr1	800968	50M	152	801120	800969	801121	V350256906L2C001R04100048161_chr1_800968	4	156	tggc	GTTC
V350256906L2C001R04100499770	chr1	776007	50M	139	776146	776008	776147	V350256906L2C001R04100499770_chr1_776007	24	0	CAAA	TTAC
V350256906L2C001R04100524721	chr1	390190	50M	183	390373	390191	390374	V350256906L2C001R04100524721_chr1_390190	62	66	tgat	ctgg
V350256906L2C001R04100647558	chr1	873334	50M	163	873497	873335	873498	V350256906L2C001R04100647558_chr1_873334	108	271	GGGG	CCTG
V350256906L2C001R04100884114	chr1	1190249	50M	216	1190465	1190250	1190466	V350256906L2C001R04100884114_chr1_1190249	61	38	GCAA	TAAA
V350256906L2C001R04101018745	chr1	407960	50M	147	408107	407961	408108	V350256906L2C001R04101018745_chr1_407960	24	40	ATCA	AGCA
V350256906L2C001R04101220939	chr1	943452	50M	255	943707	943453	943708	V350256906L2C001R04101220939_chr1_943452	126	70	TCTT	gaca
V350256906L2C001R04101277217	chr1	251832	50M	161	251993	251833	251994	V350256906L2C001R04101277217_chr1_251832	8	0	TGAT	caac
V350256906L2C001R04200183082	chr1	1031994	50M	213	1032207	1031995	1032208	V350256906L2C001R04200183082_chr1_1031994	0	16	gaac	cctg
V350256906L2C001R04200263469	chr1	800719	50M	169	800888	800720	800889	V350256906L2C001R04200263469_chr1_800719	31	47	GCAC	CCAC
V350256906L2C001R04200908117	chr1	699052	50M	143	699195	699053	699196	V350256906L2C001R04200908117_chr1_699052	21	59	TCAG	GTAA
V350256906L2C001R04201266355	chr1	1104675	50M	180	1104855	1104676	1104856	V350256906L2C001R04201266355_chr1_1104675	62	72	CGGG	CCCT
V350256906L2C001R04201389007	chr1	1393701	50M	175	1393876	1393702	1393877	V350256906L2C001R04201389007_chr1_1393701	94	11	ctgg	ctag
V350256906L2C001R04300041074	chr1	17971	50M	181	18152	17972	18153	V350256906L2C001R04300041074_chr1_17971	0	16	GTCT	CCCA
V350256906L2C001R04300363053	chr1	430972	50M	184	431156	430973	431157	V350256906L2C001R04300363053_chr1_430972	8	32	taga	tgga
V350256906L2C001R04300785892	chr1	1037741	50M	172	1037913	1037742	1037914	V350256906L2C001R04300785892_chr1_1037741	27	19	cctc	gctg
V350256906L2C001R04301163657	chr1	759207	50M	176	759383	759208	759384	V350256906L2C001R04301163657_chr1_759207	16	24	TAGA	TTTT
V350256906L2C001R04301384747	chr1	1325764	50M	173	1325937	1325765	1325938	V350256906L2C001R04301384747_chr1_1325764	53	31	GAAG	TGCC
V350256906L2C001R04400002202	chr1	1072697	50M	170	1072867	1072698	1072868	V350256906L2C001R04400002202_chr1_1072697	52	62	CCGA	CCAG
V350256906L2C001R04400272211	chr1	1222190	50M	184	1222374	1222191	1222375	V350256906L2C001R04400272211_chr1_1222190	52	10	TGCC	CCCG
V350256906L2C001R04400304707	chr1	78562	50M	238	78800	78563	78801	V350256906L2C001R04400304707_chr1_78562	81	153	aact	gatc
V350256906L2C001R04400575786	chr1	885898	50M	176	886074	885899	886075	V350256906L2C001R04400575786_chr1_885898	0	0	caca	tggg
V350256906L2C001R04400668821	chr1	431066	50M	144	431210	431067	431211	V350256906L2C001R04400668821_chr1_431066	26	2	aaat	ccta
V350256906L2C001R04400706197	chr1	530300	50M	200	530500	530301	530501	V350256906L2C001R04400706197_chr1_530300	7	149	actt	aaat
V350256906L2C001R04401139823	chr1	724691	50M	171	724862	724692	724863	V350256906L2C001R04401139823_chr1_724691	25	63	ggac	catt
V350256906L2C001R04401142446	chr1	1102329	50M	166	1102495	1102330	1102496	V350256906L2C001R04401142446_chr1_1102329	230	204	GGTG	GCCC
V350256906L2C001R04401205667	chr1	1100906	50M	167	1101073	1100907	1101074	V350256906L2C001R04401205667_chr1_1100906	0	9	GCCC	GGAG
V350256906L2C001R04500488720	chr1	400281	50M	171	400452	400282	400453	V350256906L2C001R04500488720_chr1_400281	20	119	ttaa	caaa
V350256906L2C001R04500941012	chr1	831555	50M	151	831706	831556	831707	V350256906L2C001R04500941012_chr1_831555	8	110	gcta	ggag
V350256906L2C001R04501241189	chr1	1323027	50M	170	1323197	1323028	1323198	V350256906L2C001R04501241189_chr1_1323027	119	12	CAGG	ACTC
V350256906L2C001R04501259127	chr1	1197255	50M	166	1197421	1197256	1197422	V350256906L2C001R04501259127_chr1_1197255	75	0	cctg	tact
V350256906L2C001R04501401411	chr1	1375282	50M	170	1375452	1375283	1375453	V350256906L2C001R04501401411_chr1_1375282	103	169	CGCG	GACG
V350256906L2C001R04600025929	chr1	54105	50M	170	54275	54106	54276	V350256906L2C001R04600025929_chr1_54105	66	63	CCCA	GTTT
V350256906L2C001R04600306607	chr1	18640	50M	157	18797	18641	18798	V350256906L2C001R04600306607_chr1_18640	233	76	GAAG	GCCT
V350256906L2C001R04601152862	chr1	88854	50M	172	89026	88855	89027	V350256906L2C001R04601152862_chr1_88854	245	73	CCCC	acag
V350256906L2C001R04601185182	chr1	151711	50M	164	151875	151712	151876	V350256906L2C001R04601185182_chr1_151711	7	28	ccct	ccca
V350256906L2C001R04601388820	chr1	680777	50M	164	680941	680778	680942	V350256906L2C001R04601388820_chr1_680777	31	1	gtga	ccca
V350256906L2C001R04601403934	chr1	1332251	50M	157	1332408	1332252	1332409	V350256906L2C001R04601403934_chr1_1332251	61	59	ccca	cgcc
V350256906L2C001R04700097869	chr1	127949	50M	206	128155	127950	128156	V350256906L2C001R04700097869_chr1_127949	46	27	acca	AGAG
V350256906L2C001R04700228646	chr1	332226	50M	169	332395	332227	332396	V350256906L2C001R04700228646_chr1_332226	33	63	CCTG	caaa
V350256906L2C001R04700469282	chr1	1116766	50M	151	1116917	1116767	1116918	V350256906L2C001R04700469282_chr1_1116766	27	98	CCTC	GGTG
V350256906L2C001R04700937298	chr1	248688	50M	168	248856	248689	248857	V350256906L2C001R04700937298_chr1_248688	50	28	CATT	GGGA
V350256906L2C001R04700969842	chr1	244007	50M	178	244185	244008	244186	V350256906L2C001R04700969842_chr1_244007	30	23	AAGG	ggat
V350256906L2C001R04701124234	chr1	1021717	50M	171	1021888	1021718	1021889	V350256906L2C001R04701124234_chr1_1021717	80	61	CTGA	CTGT
V350256906L2C001R04800039723	chr1	370273	50M	155	370428	370274	370429	V350256906L2C001R04800039723_chr1_370273	44	24	tgtg	ctat
V350256906L2C001R04800422913	chr1	725060	6S44M	173	725233	725061	725234	V350256906L2C001R04800422913_chr1_725060	90	36	agga	ccat
V350256906L2C001R04800520589	chr1	831712	50M	147	831859	831713	831860	V350256906L2C001R04800520589_chr1_831712	116	0	ctga	agcc
V350256906L2C001R04800683077	chr1	259156	50M	164	259320	259157	259321	V350256906L2C001R04800683077_chr1_259156	64	60	CATT	CGTG
V350256906L2C001R04800938968	chr1	571144	50M	173	571317	571145	571318	V350256906L2C001R04800938968_chr1_571144	209	117	cata	aaac
V350256906L2C001R04800991343	chr1	1025483	50M	218	1025701	1025484	1025702	V350256906L2C001R04800991343_chr1_1025483	62	32	TCAG	CGGC
V350256906L2C001R04801001713	chr1	1136870	50M	99	1136969	1136871	1136970	V350256906L2C001R04801001713_chr1_1136870	16	115	CCCC	ACTC
V350256906L2C001R04801245148	chr1	1173642	50M	156	1173798	1173643	1173799	V350256906L2C001R04801245148_chr1_1173642	45	18	CAGG	CGTG
V350256906L2C001R04801281792	chr1	1240239	50M	149	1240388	1240240	1240389	V350256906L2C001R04801281792_chr1_1240239	59	200	GGCA	GGAG
V350256906L2C001R04801345331	chr1	392283	50M	176	392459	392284	392460	V350256906L2C001R04801345331_chr1_392283	0	0	aact	TTTA
V350256906L2C001R04801380371	chr1	1076208	50M	144	1076352	1076209	1076353	V350256906L2C001R04801380371_chr1_1076208	87	33	CCCT	AACC
V350256906L2C001R04900154721	chr1	1069888	50M	184	1070072	1069889	1070073	V350256906L2C001R04900154721_chr1_1069888	72	59	CTCC	CACC
V350256906L2C001R04900559418	chr1	591306	50M	190	591496	591307	591497	V350256906L2C001R04900559418_chr1_591306	44	132	acaa	caga
V350256906L2C001R04900570416	chr1	1324602	50M	211	1324813	1324603	1324814	V350256906L2C001R04900570416_chr1_1324602	0	0	agcc	GATA
V350256906L2C001R04900615046	chr1	967106	50M	171	967277	967107	967278	V350256906L2C001R04900615046_chr1_967106	49	44	GCCC	CCAG
V350256906L2C001R04900826292	chr1	1087384	50M	164	1087548	1087385	1087549	V350256906L2C001R04900826292_chr1_1087384	0	15	cagg	cacg
V350256906L2C001R05000241945	chr1	142858	50M	158	143016	142859	143017	V350256906L2C001R05000241945_chr1_142858	11	119	ctca	CCAG
V350256906L2C001R05000390609	chr1	1212288	50M	235	1212523	1212289	1212524	V350256906L2C001R05000390609_chr1_1212288	32	3	ggac	tcta
V350256906L2C001R05000391617	chr1	110222	50M	177	110399	110223	110400	V350256906L2C001R05000391617_chr1_110222	53	52	gaaa	cttt
V350256906L2C001R05000493952	chr1	364318	50M	184	364502	364319	364503	V350256906L2C001R05000493952_chr1_364318	13	21	CAAA	AGAT
V350256906L2C001R05000687226	chr1	429899	50M	218	430117	429900	430118	V350256906L2C001R05000687226_chr1_429899	42	34	CCCC	GCTG
V350256906L2C001R05001297684	chr1	17000	50M	162	17162	17001	17163	V350256906L2C001R05001297684_chr1_17000	99	91	ACAT	AGGC
V350256906L2C001R05100217524	chr1	1351321	50M	175	1351496	1351322	1351497	V350256906L2C001R05100217524_chr1_1351321	90	54	ctgc	taaa
V350256906L2C001R05100403770	chr1	329019	50M	169	329188	329020	329189	V350256906L2C001R05100403770_chr1_329019	46	102	tggg	gccg
V350256906L2C001R05101111824	chr1	68644	50M	186	68830	68645	68831	V350256906L2C001R05101111824_chr1_68644	113	29	cttt	AATG
V350256906L2C001R05101166828	chr1	670088	50M	165	670253	670089	670254	V350256906L2C001R05101166828_chr1_670088	0	0	AAAA	TTCT
V350256906L2C001R05200305621	chr1	929405	50M	198	929603	929406	929604	V350256906L2C001R05200305621_chr1_929405	139	11	cccc	cctc
V350256906L2C001R05200386841	chr1	113411	50M	184	113595	113412	113596	V350256906L2C001R05200386841_chr1_113411	76	77	AGAG	CCTA
V350256906L2C001R05200400769	chr1	726012	4S46M	159	726171	726013	726172	V350256906L2C001R05200400769_chr1_726012	87	78	gaat	ttcc
V350256906L2C001R05200429313	chr1	1269133	50M	187	1269320	1269134	1269321	V350256906L2C001R05200429313_chr1_1269133	0	17	ggtc	CCCC
V350256906L2C001R05200554500	chr1	921333	50M	112	921445	921334	921446	V350256906L2C001R05200554500_chr1_921333	62	57	cata	aggg
V350256906L2C001R05200889437	chr1	1003887	50M	164	1004051	1003888	1004052	V350256906L2C001R05200889437_chr1_1003887	173	9	CCGG	CCCG
V350256906L2C001R05200973040	chr1	28272	50M	185	28457	28273	28458	V350256906L2C001R05200973040_chr1_28272	8	25	agaa	CATA
V350256906L2C001R05200998468	chr1	1040852	50M	171	1041023	1040853	1041024	V350256906L2C001R05200998468_chr1_1040852	80	60	ccct	ccca
V350256906L2C001R05201191171	chr1	1332863	50M	163	1333026	1332864	1333027	V350256906L2C001R05201191171_chr1_1332863	26	134	ctaa	caag
V350256906L2C001R05201198699	chr1	410401	50M	169	410570	410402	410571	V350256906L2C001R05201198699_chr1_410401	289	223	TCTC	CCCT
V350256906L2C001R05301045858	chr1	342955	50M	152	343107	342956	343108	V350256906L2C001R05301045858_chr1_342955	26	73	CTCT	CACT
V350256906L2C001R05301277138	chr1	1426127	50M	207	1426334	1426128	1426335	V350256906L2C001R05301277138_chr1_1426127	24	15	CCCA	CCAG
V350256906L2C001R05301404944	chr1	1328603	50M	197	1328800	1328604	1328801	V350256906L2C001R05301404944_chr1_1328603	50	0	AGTG	CCAA
V350256906L2C001R05400127899	chr1	1140040	50M	156	1140196	1140041	1140197	V350256906L2C001R05400127899_chr1_1140040	35	65	TGCC	CCAC
V350256906L2C001R05400257891	chr1	580278	50M	167	580445	580279	580446	V350256906L2C001R05400257891_chr1_580278	42	55	CGTA	CCTC
V350256906L2C001R05400642791	chr1	991037	50M	176	991213	991038	991214	V350256906L2C001R05400642791_chr1_991037	69	45	GCTC	CTGA
V350256906L2C001R05400768072	chr1	1215998	50M	230	1216228	1215999	1216229	V350256906L2C001R05400768072_chr1_1215998	0	103	gagg	GCCG
V350256906L2C001R05400879948	chr1	721845	50M	222	722067	721846	722068	V350256906L2C001R05400879948_chr1_721845	41	64	ccca	aaat
V350256906L2C001R05500178020	chr1	725063	4S13M5I28M	116	725179	725064	725180	V350256906L2C001R05500178020_chr1_725063	93	90	aatg	tcct
V350256906L2C001R05500532013	chr1	789550	50M	121	789671	789551	789672	V350256906L2C001R05500532013_chr1_789550	89	9	TGAA	ATAT
V350256906L2C001R05500574225	chr1	157343	50M	196	157539	157344	157540	V350256906L2C001R05500574225_chr1_157343	0	166	ccca	ggag
V350256906L2C001R05501245351	chr1	817677	50M	181	817858	817678	817859	V350256906L2C001R05501245351_chr1_817677	0	150	TGGC	AGGA
V350256906L2C001R05600466187	chr1	1124102	50M	160	1124262	1124103	1124263	V350256906L2C001R05600466187_chr1_1124102	45	52	ggca	accg
V350256906L2C001R05600538248	chr1	37310	50M	152	37462	37311	37463	V350256906L2C001R05600538248_chr1_37310	69	43	ggat	GGTC
V350256906L2C001R05600978134	chr1	1411777	50M	184	1411961	1411778	1411962	V350256906L2C001R05600978134_chr1_1411777	71	63	ACTC	gcag
V350256906L2C001R05601020750	chr1	1031289	50M	173	1031462	1031290	1031463	V350256906L2C001R05601020750_chr1_1031289	77	41	cttt	cgaa
V350256906L2C001R05601113151	chr1	530690	50M	164	530854	530691	530855	V350256906L2C001R05601113151_chr1_530690	116	28	GGAG	CCAC
V350256906L2C001R05700060147	chr1	868134	50M	175	868309	868135	868310	V350256906L2C001R05700060147_chr1_868134	41	70	GCCC	CCTT
V350256906L2C001R05700176826	chr1	79066	50M	182	79248	79067	79249	V350256906L2C001R05700176826_chr1_79066	0	154	cccc	tctc
V350256906L2C001R05700321718	chr1	464434	50M	172	464606	464435	464607	V350256906L2C001R05700321718_chr1_464434	145	0	ctca	ccaa
V350256906L2C001R05700511496	chr1	903783	50M	161	903944	903784	903945	V350256906L2C001R05700511496_chr1_903783	2	0	ACCT	attc
V350256906L2C001R05700788192	chr1	234974	50M	166	235140	234975	235141	V350256906L2C001R05700788192_chr1_234974	103	213	gttc	aaga
V350256906L2C001R05700904351	chr1	1069158	50M	179	1069337	1069159	1069338	V350256906L2C001R05700904351_chr1_1069158	28	41	CCTA	gccc
V350256906L2C001R05700914065	chr1	998083	50M	172	998255	998084	998256	V350256906L2C001R05700914065_chr1_998083	26	71	CGTC	GGGG
V350256906L2C001R05700939286	chr1	815861	50M	171	816032	815862	816033	V350256906L2C001R05700939286_chr1_815861	0	0	cttt	gtat
V350256906L2C001R05701167322	chr1	679441	50M	181	679622	679442	679623	V350256906L2C001R05701167322_chr1_679441	113	0	caac	AATG
V350256906L2C001R05800321856	chr1	130841	50M	160	131001	130842	131002	V350256906L2C001R05800321856_chr1_130841	0	57	gcca	GGCC
V350256906L2C001R05800436811	chr1	897408	50M	127	897535	897409	897536	V350256906L2C001R05800436811_chr1_897408	20	52	TGCT	AGGA
V350256906L2C001R05800505427	chr1	558329	50M	153	558482	558330	558483	V350256906L2C001R05800505427_chr1_558329	61	55	gaat	TAGT
V350256906L2C001R05800575774	chr1	1120119	50M	165	1120284	1120120	1120285	V350256906L2C001R05800575774_chr1_1120119	350	185	CCGT	CCCC
V350256906L2C001R05800875257	chr1	1132744	50M	149	1132893	1132745	1132894	V350256906L2C001R05800875257_chr1_1132744	1	11	ccct	CGAA
V350256906L2C001R05900572609	chr1	1072294	50M	198	1072492	1072295	1072493	V350256906L2C001R05900572609_chr1_1072294	45	48	CGCT	CCTG
V350256906L2C001R05900690272	chr1	1006719	50M	162	1006881	1006720	1006882	V350256906L2C001R05900690272_chr1_1006719	80	56	tggc	tgag
V350256906L2C001R05900718574	chr1	1237840	50M	132	1237972	1237841	1237973	V350256906L2C001R05900718574_chr1_1237840	188	56	GGAC	ACAC
V350256906L2C001R05900870004	chr1	884639	50M	139	884778	884640	884779	V350256906L2C001R05900870004_chr1_884639	91	53	CATG	TCAT
V350256906L2C001R05900980787	chr1	443452	50M	187	443639	443453	443640	V350256906L2C001R05900980787_chr1_443452	34	50	GGGA	ATCC
V350256906L2C001R05901036075	chr1	1420868	50M	153	1421021	1420869	1421022	V350256906L2C001R05901036075_chr1_1420868	0	26	CTGG	CCCC
V350256906L2C001R05901086891	chr1	802247	50M	156	802403	802248	802404	V350256906L2C001R05901086891_chr1_802247	187	31	TCCC	GCAG
V350256906L2C001R05901121186	chr1	644485	50M	158	644643	644486	644644	V350256906L2C001R05901121186_chr1_644485	5	7	ggca	gttc
V350256906L2C001R06000078041	chr1	333991	50M	150	334141	333992	334142	V350256906L2C001R06000078041_chr1_333991	0	40	CCTG	CTTG
V350256906L2C001R06000265749	chr1	1093075	50M	131	1093206	1093076	1093207	V350256906L2C001R06000265749_chr1_1093075	83	113	CCCT	CCTT
V350256906L2C001R06000301446	chr1	993552	50M	156	993708	993553	993709	V350256906L2C001R06000301446_chr1_993552	66	41	TCAC	CCTG
V350256906L2C001R06000414681	chr1	121754	50M	190	121944	121755	121945	V350256906L2C001R06000414681_chr1_121754	25	30	ACCA	CAAG
V350256906L2C001R06000454779	chr1	1262696	50M	180	1262876	1262697	1262877	V350256906L2C001R06000454779_chr1_1262696	6	10	CCTC	CGCA
V350256906L2C001R06000660609	chr1	985967	50M	143	986110	985968	986111	V350256906L2C001R06000660609_chr1_985967	0	31	ATCA	GCTC
V350256906L2C001R06000707058	chr1	88353	50M	139	88492	88354	88493	V350256906L2C001R06000707058_chr1_88353	59	36	tccc	gatc
V350256906L2C001R06000794858	chr1	243920	50M	138	244058	243921	244059	V350256906L2C001R06000794858_chr1_243920	26	0	AAGA	CAAC
V350256906L2C001R06000921957	chr1	427311	50M	157	427468	427312	427469	V350256906L2C001R06000921957_chr1_427311	0	0	CAGG	CCCA
V350256906L2C001R06001185953	chr1	228734	50M	150	228884	228735	228885	V350256906L2C001R06001185953_chr1_228734	48	11	CGGC	gctt
V350256906L2C001R06100072201	chr1	1006286	50M	209	1006495	1006287	1006496	V350256906L2C001R06100072201_chr1_1006286	41	56	GGGT	CCAT
V350256906L2C001R06100566443	chr1	1358788	50M	207	1358995	1358789	1358996	V350256906L2C001R06100566443_chr1_1358788	56	92	tgtt	ccca
V350256906L2C001R06100608000	chr1	323333	50M	190	323523	323334	323524	V350256906L2C001R06100608000_chr1_323333	0	31	cacc	ctta
V350256906L2C001R06100919447	chr1	17599	50M	155	17754	17600	17755	V350256906L2C001R06100919447_chr1_17599	37	40	GCCA	GGCC
V350256906L2C001R06101070889	chr1	147564	50M	179	147743	147565	147744	V350256906L2C001R06101070889_chr1_147564	230	112	CTTA	tgta
V350256906L2C001R06101074312	chr1	109461	50M	179	109640	109462	109641	V350256906L2C001R06101074312_chr1_109461	267	88	AGAG	AGGT
V350256906L2C001R06101092833	chr1	922690	50M	167	922857	922691	922858	V350256906L2C001R06101092833_chr1_922690	85	69	tgac	ccgt
V350256906L2C001R06200138755	chr1	19817	50M	188	20005	19818	20006	V350256906L2C001R06200138755_chr1_19817	19	207	AGGC	cagg
V350256906L2C001R06200294674	chr1	176479	50M	164	176643	176480	176644	V350256906L2C001R06200294674_chr1_176479	250	86	GACT	GAAG
V350256906L2C001R06200468571	chr1	387749	50M	160	387909	387750	387910	V350256906L2C001R06200468571_chr1_387749	24	0	ctaa	ccaa
V350256906L2C001R06200740420	chr1	1197544	50M	253	1197797	1197545	1197798	V350256906L2C001R06200740420_chr1_1197544	26	41	ACTC	CACC
V350256906L2C001R06201244333	chr1	403467	50M	168	403635	403468	403636	V350256906L2C001R06201244333_chr1_403467	151	0	catt	taac
V350256906L2C001R06300019850	chr1	351566	50M	189	351755	351567	351756	V350256906L2C001R06300019850_chr1_351566	19	1	ACTG	CATT
V350256906L2C001R06300204528	chr1	720175	50M	170	720345	720176	720346	V350256906L2C001R06300204528_chr1_720175	55	65	ctca	gtca
V350256906L2C001R06300435325	chr1	684122	50M	176	684298	684123	684299	V350256906L2C001R06300435325_chr1_684122	53	64	tgat	ccta
V350256906L2C001R06300916348	chr1	1345933	50M	152	1346085	1345934	1346086	V350256906L2C001R06300916348_chr1_1345933	0	5	tgac	aaaa
V350256906L2C001R06300924962	chr1	841564	50M	184	841748	841565	841749	V350256906L2C001R06300924962_chr1_841564	41	51	CGGG	GGCA
V350256906L2C001R06301183306	chr1	687394	50M	140	687534	687395	687535	V350256906L2C001R06301183306_chr1_687394	0	4	gatc	gatc
V350256906L2C001R06301244815	chr1	803579	50M	200	803779	803580	803780	V350256906L2C001R06301244815_chr1_803579	28	83	CCTG	CAAG
V350256906L2C001R06400016549	chr1	1419997	50M	204	1420201	1419998	1420202	V350256906L2C001R06400016549_chr1_1419997	76	75	TAAA	TAAC
V350256906L2C001R06400830493	chr1	20849	50M	171	21020	20850	21021	V350256906L2C001R06400830493_chr1_20849	28	52	CCAC	AGGC
V350256906L2C001R06400879902	chr1	1295035	50M	190	1295225	1295036	1295226	V350256906L2C001R06400879902_chr1_1295035	53	77	ACCT	GAAT
V350256906L2C001R06401380346	chr1	1393230	50M	148	1393378	1393231	1393379	V350256906L2C001R06401380346_chr1_1393230	0	37	gtat	caaa
V350256906L2C001R06500515058	chr1	821171	50M	177	821348	821172	821349	V350256906L2C001R06500515058_chr1_821171	23	21	tctg	ctag
V350256906L2C001R06500621989	chr1	785901	50M	159	786060	785902	786061	V350256906L2C001R06500621989_chr1_785901	55	55	AGTG	ccct
V350256906L2C001R06500685052	chr1	1349102	50M	144	1349246	1349103	1349247	V350256906L2C001R06500685052_chr1_1349102	66	38	ccct	cgag
V350256906L2C001R06500871068	chr1	719699	50M	202	719901	719700	719902	V350256906L2C001R06500871068_chr1_719699	0	13	cata	cttt
V350256906L2C001R06501048440	chr1	414282	50M	115	414397	414283	414398	V350256906L2C001R06501048440_chr1_414282	33	14	ggct	tgat
V350256906L2C001R06501241678	chr1	1162749	50M	172	1162921	1162750	1162922	V350256906L2C001R06501241678_chr1_1162749	20	31	ggcc	CCTG
V350256906L2C001R06600036122	chr1	1012517	50M	183	1012700	1012518	1012701	V350256906L2C001R06600036122_chr1_1012517	247	64	CGGG	CCAT
V350256906L2C001R06600280080	chr1	1388185	21M3D29M	181	1388366	1388186	1388367	V350256906L2C001R06600280080_chr1_1388185	46	31	aaaa	TGTG
V350256906L2C001R06600495651	chr1	926195	50M	179	926374	926196	926375	V350256906L2C001R06600495651_chr1_926195	35	16	acat	tgtt
V350256906L2C001R06601032327	chr1	318538	50M	155	318693	318539	318694	V350256906L2C001R06601032327_chr1_318538	29	92	ctgg	cccc
V350256906L2C001R06601035202	chr1	735599	50M	133	735732	735600	735733	V350256906L2C001R06601035202_chr1_735599	54	31	taaa	tact
V350256906L2C001R06601149271	chr1	690783	50M	176	690959	690784	690960	V350256906L2C001R06601149271_chr1_690783	12	41	cccg	tgat
V350256906L2C001R06601258552	chr1	1156507	50M	191	1156698	1156508	1156699	V350256906L2C001R06601258552_chr1_1156507	83	62	CGGA	cctc
V350256906L2C001R06601304041	chr1	1118101	50M	164	1118265	1118102	1118266	V350256906L2C001R06601304041_chr1_1118101	52	58	cagg	TCTG
V350256906L2C001R06700234133	chr1	608090	50M	199	608289	608091	608290	V350256906L2C001R06700234133_chr1_608090	26	225	taaa	gcca
V350256906L2C001R06700691503	chr1	236386	50M	155	236541	236387	236542	V350256906L2C001R06700691503_chr1_236386	0	16	ATTG	cagc
V350256906L2C001R06800117443	chr1	267080	50M	149	267229	267081	267230	V350256906L2C001R06800117443_chr1_267080	82	10	AGGG	AAGA
V350256906L2C001R06800248489	chr1	1163337	50M	170	1163507	1163338	1163508	V350256906L2C001R06800248489_chr1_1163337	51	84	CCCC	TCCG
V350256906L2C001R06800310723	chr1	547481	50M	179	547660	547482	547661	V350256906L2C001R06800310723_chr1_547481	0	153	cccc	TACA
V350256906L2C001R06800347585	chr1	17668	50M	162	17830	17669	17831	V350256906L2C001R06800347585_chr1_17668	5	0	CCCA	CCAG
V350256906L2C001R06800445245	chr1	61222	50M	180	61402	61223	61403	V350256906L2C001R06800445245_chr1_61222	95	0	ATTA	CTTT
V350256906L2C001R06800548731	chr1	625423	50M	166	625589	625424	625590	V350256906L2C001R06800548731_chr1_625423	55	46	CATT	ACAA
V350256906L2C001R06800603831	chr1	704270	50M	186	704456	704271	704457	V350256906L2C001R06800603831_chr1_704270	46	46	TCCT	tgct
V350256906L2C001R06800864141	chr1	920831	50M	164	920995	920832	920996	V350256906L2C001R06800864141_chr1_920831	52	65	caat	cact
V350256906L2C001R06800986242	chr1	1272834	50M	143	1272977	1272835	1272978	V350256906L2C001R06800986242_chr1_1272834	150	255	CCCT	TCCT
V350256906L2C001R06900065420	chr1	952977	50M	142	953119	952978	953120	V350256906L2C001R06900065420_chr1_952977	34	49	ggca	tctg
V350256906L2C001R06900179445	chr1	409779	50M	154	409933	409780	409934	V350256906L2C001R06900179445_chr1_409779	44	4	cgcc	CTGT
V350256906L2C001R06900344774	chr1	1023832	50M	176	1024008	1023833	1024009	V350256906L2C001R06900344774_chr1_1023832	74	38	CCCC	GTCA
V350256906L2C001R06900428736	chr1	432170	50M	188	432358	432171	432359	V350256906L2C001R06900428736_chr1_432170	162	14	TCTT	tgcc
V350256906L2C001R06900561155	chr1	466127	50M	180	466307	466128	466308	V350256906L2C001R06900561155_chr1_466127	28	9	aggt	tggg
V350256906L2C001R06900612665	chr1	655113	50M	112	655225	655114	655226	V350256906L2C001R06900612665_chr1_655113	209	97	agct	atct
V350256906L2C001R06900877323	chr1	41783	50M	161	41944	41784	41945	V350256906L2C001R06900877323_chr1_41783	572	604	cctt	taat
V350256906L2C001R06901064766	chr1	668884	50M	202	669086	668885	669087	V350256906L2C001R06901064766_chr1_668884	252	101	ggtg	GTTG
V350256906L2C001R06901076264	chr1	996124	50M	168	996292	996125	996293	V350256906L2C001R06901076264_chr1_996124	64	38	CGCA	GCCG
V350256906L2C001R07000286071	chr1	666212	50M	138	666350	666213	666351	V350256906L2C001R07000286071_chr1_666212	48	17	actc	CTTT
V350256906L2C001R07000352559	chr1	580064	50M	170	580234	580065	580235	V350256906L2C001R07000352559_chr1_580064	25	0	GAGA	CCTT
V350256906L2C001R07000672773	chr1	97473	50M	140	97613	97474	97614	V350256906L2C001R07000672773_chr1_97473	37	43	TTAT	CTCC
V350256906L2C001R07000847830	chr1	1071058	50M	168	1071226	1071059	1071227	V350256906L2C001R07000847830_chr1_1071058	24	24	ggct	cctg
V350256906L2C001R07001187203	chr1	12642	50M	156	12798	12643	12799	V350256906L2C001R07001187203_chr1_12642	43	94	CCAG	CAGG
V350256906L2C001R07001317666	chr1	93775	50M	171	93946	93776	93947	V350256906L2C001R07001317666_chr1_93775	85	59	ccag	ctgg
V350256906L2C001R07100718341	chr1	907174	50M	157	907331	907175	907332	V350256906L2C001R07100718341_chr1_907174	6	44	CCCT	CCAC
V350256906L2C001R07100725839	chr1	732405	50M	176	732581	732406	732582	V350256906L2C001R07100725839_chr1_732405	56	99	aaag	TCTG
V350256906L2C001R07100974113	chr1	661690	50M	138	661828	661691	661829	V350256906L2C001R07100974113_chr1_661690	28	166	CGAA	TGGA
V350256906L2C001R07100997456	chr1	30927	41M3D9M	171	31098	30928	31099	V350256906L2C001R07100997456_chr1_30927	0	25	tctc	atac
V350256906L2C001R07100998803	chr1	945866	6S44M	165	946031	945867	946032	V350256906L2C001R07100998803_chr1_945866	109	0	ttat	ACAG
V350256906L2C001R07200359198	chr1	1407648	50M	143	1407791	1407649	1407792	V350256906L2C001R07200359198_chr1_1407648	21	1	CACC	GCGC
V350256906L2C001R07200666724	chr1	46593	50M	166	46759	46594	46760	V350256906L2C001R07200666724_chr1_46593	31	197	ccac	CCTG
V350256906L2C001R07201123919	chr1	537980	50M	170	538150	537981	538151	V350256906L2C001R07201123919_chr1_537980	177	83	CCTG	CCTT
V350256906L2C002R00101344939	chr1	572085	50M	188	572273	572086	572274	V350256906L2C002R00101344939_chr1_572085	62	61	cctt	CCAA
V350256906L2C002R00200498008	chr1	566968	50M	166	567134	566969	567135	V350256906L2C002R00200498008_chr1_566968	173	7	AACC	TCTC
V350256906L2C002R00200560652	chr1	701268	50M	176	701444	701269	701445	V350256906L2C002R00200560652_chr1_701268	0	81	AAAT	ATGC
V350256906L2C002R00200879037	chr1	1315660	50M	219	1315879	1315661	1315880	V350256906L2C002R00200879037_chr1_1315660	33	4	ccaa	GATG
V350256906L2C002R00201143555	chr1	468996	50M	175	469171	468997	469172	V350256906L2C002R00201143555_chr1_468996	40	23	tagc	tgag
V350256906L2C002R00201325535	chr1	958304	50M	140	958444	958305	958445	V350256906L2C002R00201325535_chr1_958304	0	27	TGGC	CAGT
V350256906L2C002R00201329275	chr1	1199972	50M	169	1200141	1199973	1200142	V350256906L2C002R00201329275_chr1_1199972	0	0	cgaa	aatt
V350256906L2C002R00300294694	chr1	655195	50M	180	655375	655196	655376	V350256906L2C002R00300294694_chr1_655195	127	15	accc	ttat
V350256906L2C002R00300317732	chr1	1367014	50M	172	1367186	1367015	1367187	V350256906L2C002R00300317732_chr1_1367014	0	5	CCTC	GGTG
V350256906L2C002R00300418185	chr1	38925	50M	212	39137	38926	39138	V350256906L2C002R00300418185_chr1_38925	64	67	ggca	tgtc
V350256906L2C002R00300459501	chr1	1103826	50M	184	1104010	1103827	1104011	V350256906L2C002R00300459501_chr1_1103826	0	0	CTGG	GATG
V350256906L2C002R00300575903	chr1	803775	50M	197	803972	803776	803973	V350256906L2C002R00300575903_chr1_803775	84	70	CTTG	TTCA
V350256906L2C002R00300620968	chr1	156090	50M	186	156276	156091	156277	V350256906L2C002R00300620968_chr1_156090	139	5	cagg	ctac
V350256906L2C002R00301169824	chr1	1396530	50M	172	1396702	1396531	1396703	V350256906L2C002R00301169824_chr1_1396530	115	13	CTGG	cagc
V350256906L2C002R00400569337	chr1	728368	50M	181	728549	728369	728550	V350256906L2C002R00400569337_chr1_728368	75	256	tgac	atcc
V350256906L2C002R00400602612	chr1	621280	50M	162	621442	621281	621443	V350256906L2C002R00400602612_chr1_621280	63	66	CCAA	GGTC
V350256906L2C002R00400987147	chr1	726405	25S19M6S	192	726597	726406	726598	V350256906L2C002R00400987147_chr1_726405	6	3	aatg	ccat
V350256906L2C002R00500144295	chr1	676783	50M	142	676925	676784	676926	V350256906L2C002R00500144295_chr1_676783	67	34	cctc	ccag
V350256906L2C002R00500240433	chr1	1339830	50M	151	1339981	1339831	1339982	V350256906L2C002R00500240433_chr1_1339830	70	40	ggcc	tgaa
V350256906L2C002R00500245469	chr1	1156169	50M	169	1156338	1156170	1156339	V350256906L2C002R00500245469_chr1_1156169	40	64	GGGG	ACTT
V350256906L2C002R00500381811	chr1	1306010	50M	131	1306141	1306011	1306142	V350256906L2C002R00500381811_chr1_1306010	69	21	GCCT	GGTT
V350256906L2C002R00500923203	chr1	257482	50M	140	257622	257483	257623	V350256906L2C002R00500923203_chr1_257482	58	50	aggc	ctgt
V350256906L2C002R00501079476	chr1	252254	50M	169	252423	252255	252424	V350256906L2C002R00501079476_chr1_252254	0	57	CTGA	CCTA
V350256906L2C002R00600032142	chr1	1289253	50M	130	1289383	1289254	1289384	V350256906L2C002R00600032142_chr1_1289253	48	38	AGGC	CAGG
V350256906L2C002R00600253461	chr1	451918	50M	169	452087	451919	452088	V350256906L2C002R00600253461_chr1_451918	30	58	cgta	caca
V350256906L2C002R00600490952	chr1	1420774	50M	139	1420913	1420775	1420914	V350256906L2C002R00600490952_chr1_1420774	71	11	CTTG	CCTC
V350256906L2C002R00600584073	chr1	748633	50M	144	748777	748634	748778	V350256906L2C002R00600584073_chr1_748633	48	57	CACC	TTCT
V350256906L2C002R00600816151	chr1	400247	50M	149	400396	400248	400397	V350256906L2C002R00600816151_chr1_400247	54	63	ccct	tata
V350256906L2C002R00600829970	chr1	92098	50M	171	92269	92099	92270	V350256906L2C002R00600829970_chr1_92098	184	193	gtgt	ccat
V350256906L2C002R00601298095	chr1	1146929	50M	178	1147107	1146930	1147108	V350256906L2C002R00601298095_chr1_1146929	41	74	CCCA	CCCC
V350256906L2C002R00700164863	chr1	1338628	50M	209	1338837	1338629	1338838	V350256906L2C002R00700164863_chr1_1338628	26	46	tctt	tcct
V350256906L2C002R00700377585	chr1	344683	50M	171	344854	344684	344855	V350256906L2C002R00700377585_chr1_344683	184	13	ttaa	tgac
V350256906L2C002R00700520221	chr1	89728	50M	153	89881	89729	89882	V350256906L2C002R00700520221_chr1_89728	0	139	TATG	cctc
V350256906L2C002R00701085006	chr1	673818	50M	183	674001	673819	674002	V350256906L2C002R00701085006_chr1_673818	83	67	ccct	caac
V350256906L2C002R00701260747	chr1	1063536	50M	195	1063731	1063537	1063732	V350256906L2C002R00701260747_chr1_1063536	0	0	GCAT	TGGG
V350256906L2C002R00800009780	chr1	176766	50M	155	176921	176767	176922	V350256906L2C002R00800009780_chr1_176766	6	0	CCAA	CTTT
V350256906L2C002R00800370549	chr1	524722	50M	177	524899	524723	524900	V350256906L2C002R00800370549_chr1_524722	15	27	caca	aggt
V350256906L2C002R00800453994	chr1	319541	50M	216	319757	319542	319758	V350256906L2C002R00800453994_chr1_319541	15	0	ctgc	tgag
V350256906L2C002R00800503632	chr1	795127	50M	175	795302	795128	795303	V350256906L2C002R00800503632_chr1_795127	0	2	CAAT	TCTT
V350256906L2C002R00800631671	chr1	1431675	50M	172	1431847	1431676	1431848	V350256906L2C002R00800631671_chr1_1431675	63	66	TGGA	CCCA
V350256906L2C002R00800649177	chr1	362994	50M	169	363163	362995	363164	V350256906L2C002R00800649177_chr1_362994	0	9	TGAG	ccat
V350256906L2C002R00801322759	chr1	881507	50M	191	881698	881508	881699	V350256906L2C002R00801322759_chr1_881507	0	23	CCCA	GGCA
V350256906L2C002R00900572301	chr1	1184906	50M	227	1185133	1184907	1185134	V350256906L2C002R00900572301_chr1_1184906	122	40	CCCT	ctac
V350256906L2C002R00901062461	chr1	813064	45M5S	181	813245	813065	813246	V350256906L2C002R00901062461_chr1_813064	67	248	TGCT	CTGC
V350256906L2C002R00901066036	chr1	101940	50M	147	102087	101941	102088	V350256906L2C002R00901066036_chr1_101940	7	0	ctac	tgtt
V350256906L2C002R00901191325	chr1	715781	50M	185	715966	715782	715967	V350256906L2C002R00901191325_chr1_715781	65	57	acca	GAGC
V350256906L2C002R01000066116	chr1	418066	50M	151	418217	418067	418218	V350256906L2C002R01000066116_chr1_418066	32	48	CATC	AACA
V350256906L2C002R01000125830	chr1	724307	50M	165	724472	724308	724473	V350256906L2C002R01000125830_chr1_724307	0	165	gaac	catc
V350256906L2C002R01000427603	chr1	113415	50M	164	113579	113416	113580	V350256906L2C002R01000427603_chr1_113415	72	61	CCAA	GCTC
V350256906L2C002R01000454376	chr1	165598	50M	168	165766	165599	165767	V350256906L2C002R01000454376_chr1_165598	238	111	ATAA	CAGG
V350256906L2C002R01001021036	chr1	803328	50M	153	803481	803329	803482	V350256906L2C002R01001021036_chr1_803328	88	4	GCTC	GTCA
V350256906L2C002R01001230590	chr1	747224	50M	149	747373	747225	747374	V350256906L2C002R01001230590_chr1_747224	19	0	CTAT	CCTT
V350256906L2C002R01001361208	chr1	1349012	50M	158	1349170	1349013	1349171	V350256906L2C002R01001361208_chr1_1349012	0	0	gaat	taaa
V350256906L2C002R01100340256	chr1	726905	10S29M11S	139	727044	726906	727045	V350256906L2C002R01100340256_chr1_726905	61	9	gaat	ATTC
V350256906L2C002R01100629252	chr1	447960	50M	170	448130	447961	448131	V350256906L2C002R01100629252_chr1_447960	12	21	caaa	caat
V350256906L2C002R01100840616	chr1	784521	50M	151	784672	784522	784673	V350256906L2C002R01100840616_chr1_784521	71	26	CAAA	TCAA
V350256906L2C002R01101188670	chr1	1187939	50M	178	1188117	1187940	1188118	V350256906L2C002R01101188670_chr1_1187939	29	41	cccg	ggat
V350256906L2C002R01200017409	chr1	777273	50M	178	777451	777274	777452	V350256906L2C002R01200017409_chr1_777273	0	11	GCCC	ACGG
V350256906L2C002R01200518620	chr1	763552	50M	202	763754	763553	763755	V350256906L2C002R01200518620_chr1_763552	49	46	TTAT	CCAG
V350256906L2C002R01200999138	chr1	345694	50M	170	345864	345695	345865	V350256906L2C002R01200999138_chr1_345694	57	31	tgag	taat
V350256906L2C002R01201336755	chr1	777010	50M	185	777195	777011	777196	V350256906L2C002R01201336755_chr1_777010	48	27	cctc	gcac
V350256906L2C002R01201363811	chr1	391168	50M	179	391347	391169	391348	V350256906L2C002R01201363811_chr1_391168	58	210	tatt	ctca
V350256906L2C002R01300084949	chr1	1039481	50M	156	1039637	1039482	1039638	V350256906L2C002R01300084949_chr1_1039481	0	23	cctc	ccag
V350256906L2C002R01300533840	chr1	64188	50M	176	64364	64189	64365	V350256906L2C002R01300533840_chr1_64188	49	62	GGTT	CCTT
V350256906L2C002R01300614199	chr1	876318	50M	237	876555	876319	876556	V350256906L2C002R01300614199_chr1_876318	72	17	CCCG	GCCG
V350256906L2C002R01301014113	chr1	1340460	50M	140	1340600	1340461	1340601	V350256906L2C002R01301014113_chr1_1340460	7	75	ccca	gcag
V350256906L2C002R01301063610	chr1	1150435	50M	165	1150600	1150436	1150601	V350256906L2C002R01301063610_chr1_1150435	111	0	TCTA	CTTG
V350256906L2C002R01301115369	chr1	1294393	50M	164	1294557	1294394	1294558	V350256906L2C002R01301115369_chr1_1294393	57	43	CCTT	GGGT
V350256906L2C002R01400226322	chr1	166832	50M	148	166980	166833	166981	V350256906L2C002R01400226322_chr1_166832	40	13	AATT	ATCC
V350256906L2C002R01400559578	chr1	725881	9S41M	198	726079	725882	726080	V350256906L2C002R01400559578_chr1_725881	2	154	ggaa	tcca
V350256906L2C002R01400852045	chr1	1021462	50M	142	1021604	1021463	1021605	V350256906L2C002R01400852045_chr1_1021462	28	11	CCCT	TCCC
V350256906L2C002R01401006472	chr1	411203	50M	172	411375	411204	411376	V350256906L2C002R01401006472_chr1_411203	0	0	GAAA	TAAA
V350256906L2C002R01401259436	chr1	599967	50M	144	600111	599968	600112	V350256906L2C002R01401259436_chr1_599967	0	37	actt	aatt
V350256906L2C002R01500205981	chr1	597981	50M	161	598142	597982	598143	V350256906L2C002R01500205981_chr1_597981	0	8	taaa	caaa
V350256906L2C002R01500260883	chr1	95778	50M	164	95942	95779	95943	V350256906L2C002R01500260883_chr1_95778	0	33	GGAA	CCTT
V350256906L2C002R01500635444	chr1	118195	50M	162	118357	118196	118358	V350256906L2C002R01500635444_chr1_118195	38	65	agat	tgta
V350256906L2C002R01500870945	chr1	1067187	50M	153	1067340	1067188	1067341	V350256906L2C002R01500870945_chr1_1067187	47	86	CCTC	TGTC
V350256906L2C002R01500909089	chr1	259874	50M	180	260054	259875	260055	V350256906L2C002R01500909089_chr1_259874	39	29	CGTT	aata
V350256906L2C002R01500915686	chr1	917013	50M	169	917182	917014	917183	V350256906L2C002R01500915686_chr1_917013	34	57	CTCT	AAAG
V350256906L2C002R01501300767	chr1	1269935	50M	183	1270118	1269936	1270119	V350256906L2C002R01501300767_chr1_1269935	0	0	TCCC	GGGC
V350256906L2C002R01600103183	chr1	359906	50M	175	360081	359907	360082	V350256906L2C002R01600103183_chr1_359906	53	24	TCAT	GTGG
V350256906L2C002R01600127523	chr1	442967	50M	203	443170	442968	443171	V350256906L2C002R01600127523_chr1_442967	4	17	CACC	cact
V350256906L2C002R01600271926	chr1	67305	50M	178	67483	67306	67484	V350256906L2C002R01600271926_chr1_67305	32	18	GATC	CTTG
V350256906L2C002R01600598450	chr1	1103107	50M	166	1103273	1103108	1103274	V350256906L2C002R01600598450_chr1_1103107	76	60	TGCA	CTGT
V350256906L2C002R01601311237	chr1	577074	50M	166	577240	577075	577241	V350256906L2C002R01601311237_chr1_577074	12	0	GCTT	tgga
V350256906L2C002R01700086579	chr1	131049	50M	169	131218	131050	131219	V350256906L2C002R01700086579_chr1_131049	9	7	TTGG	GATG
V350256906L2C002R01700131321	chr1	888901	50M	118	889019	888902	889020	V350256906L2C002R01700131321_chr1_888901	65	18	TGTG	CTGG
V350256906L2C002R01700222698	chr1	1133705	50M	112	1133817	1133706	1133818	V350256906L2C002R01700222698_chr1_1133705	0	34	CTGA	TAAA
V350256906L2C002R01700507800	chr1	429733	50M	153	429886	429734	429887	V350256906L2C002R01700507800_chr1_429733	69	29	TCTG	CCCA
V350256906L2C002R01700623264	chr1	125534	50M	153	125687	125535	125688	V350256906L2C002R01700623264_chr1_125534	269	268	GGCT	CTCT
V350256906L2C002R01700781925	chr1	1025605	50M	185	1025790	1025606	1025791	V350256906L2C002R01700781925_chr1_1025605	31	14	CCCA	GTGT
V350256906L2C002R01700846764	chr1	813170	50M	195	813365	813171	813366	V350256906L2C002R01700846764_chr1_813170	173	368	CTGA	GGAA
V350256906L2C002R01800105709	chr1	1008690	50M	167	1008857	1008691	1008858	V350256906L2C002R01800105709_chr1_1008690	67	58	GCAC	CTCA
V350256906L2C002R01800456585	chr1	1328440	50M	169	1328609	1328441	1328610	V350256906L2C002R01800456585_chr1_1328440	81	56	GACC	GGCA
V350256906L2C002R01801145482	chr1	1010680	50M	157	1010837	1010681	1010838	V350256906L2C002R01801145482_chr1_1010680	18	28	CCTG	GGTC
V350256906L2C002R01801253622	chr1	155981	50M	173	156154	155982	156155	V350256906L2C002R01801253622_chr1_155981	248	75	TGAT	ctaa
V350256906L2C002R01900079158	chr1	923881	50M	159	924040	923882	924041	V350256906L2C002R01900079158_chr1_923881	0	119	cctt	ctgc
V350256906L2C002R01900255504	chr1	953471	50M	166	953637	953472	953638	V350256906L2C002R01900255504_chr1_953471	58	160	ccaa	cact
V350256906L2C002R01900414084	chr1	1321637	50M	159	1321796	1321638	1321797	V350256906L2C002R01900414084_chr1_1321637	125	10	CAAA	CCCA
V350256906L2C002R01900720143	chr1	143460	50M	208	143668	143461	143669	V350256906L2C002R01900720143_chr1_143460	278	70	ccac	ctga
V350256906L2C002R01900761267	chr1	116210	50M	142	116352	116211	116353	V350256906L2C002R01900761267_chr1_116210	84	89	ACCA	AACA
V350256906L2C002R01901188539	chr1	645666	50M	176	645842	645667	645843	V350256906L2C002R01901188539_chr1_645666	0	58	CAAA	tatt
V350256906L2C002R02000062670	chr1	1267174	50M	180	1267354	1267175	1267355	V350256906L2C002R02000062670_chr1_1267174	90	38	CCTG	CTGG
V350256906L2C002R02000146104	chr1	820895	50M	171	821066	820896	821067	V350256906L2C002R02000146104_chr1_820895	33	26	ctta	taat
V350256906L2C002R02000157422	chr1	1247026	50M	176	1247202	1247027	1247203	V350256906L2C002R02000157422_chr1_1247026	5	12	CCTA	CCAG
V350256906L2C002R02000584598	chr1	770729	50M	165	770894	770730	770895	V350256906L2C002R02000584598_chr1_770729	50	61	GGCC	GGCT
V350256906L2C002R02001244095	chr1	697754	50M	171	697925	697755	697926	V350256906L2C002R02001244095_chr1_697754	32	23	GCCC	AGTG
V350256906L2C002R02001384495	chr1	907971	50M	165	908136	907972	908137	V350256906L2C002R02001384495_chr1_907971	0	34	ccct	ctta
V350256906L2C002R02100476315	chr1	754941	50M	222	755163	754942	755164	V350256906L2C002R02100476315_chr1_754941	0	26	CTAG	atga
V350256906L2C002R02100879596	chr1	1322032	50M	166	1322198	1322033	1322199	V350256906L2C002R02100879596_chr1_1322032	39	39	CCTA	ATTA
V350256906L2C002R02200117120	chr1	901114	50M	183	901297	901115	901298	V350256906L2C002R02200117120_chr1_901114	38	56	CTCT	CAGG
V350256906L2C002R02200220602	chr1	120226	50M	164	120390	120227	120391	V350256906L2C002R02200220602_chr1_120226	83	49	TCAG	CCCT
V350256906L2C002R02200302225	chr1	1231314	50M	191	1231505	1231315	1231506	V350256906L2C002R02200302225_chr1_1231314	26	3	CCTG	CCTG
V350256906L2C002R02201166136	chr1	1096972	50M	175	1097147	1096973	1097148	V350256906L2C002R02201166136_chr1_1096972	31	26	CTGG	CTGA
V350256906L2C002R02300271424	chr1	580361	50M	165	580526	580362	580527	V350256906L2C002R02300271424_chr1_580361	0	20	ACAG	CTCT
V350256906L2C002R02301044076	chr1	12761	50M	195	12956	12762	12957	V350256906L2C002R02301044076_chr1_12761	57	53	CCTA	CCCA
V350256906L2C002R02301168876	chr1	1204172	50M	185	1204357	1204173	1204358	V350256906L2C002R02301168876_chr1_1204172	42	54	ctca	CCCG
V350256906L2C002R02400226182	chr1	437016	50M	175	437191	437017	437192	V350256906L2C002R02400226182_chr1_437016	17	133	caca	CCTG
V350256906L2C002R02400412603	chr1	693121	50M	172	693293	693122	693294	V350256906L2C002R02400412603_chr1_693121	24	65	tggt	attt
V350256906L2C002R02401031678	chr1	1082897	50M	149	1083046	1082898	1083047	V350256906L2C002R02401031678_chr1_1082897	61	45	TGGG	CCCT
V350256906L2C002R02401141445	chr1	13571	50M	197	13768	13572	13769	V350256906L2C002R02401141445_chr1_13571	273	91	TGCT	GCCT
V350256906L2C002R02401298762	chr1	445658	50M	181	445839	445659	445840	V350256906L2C002R02401298762_chr1_445658	24	134	CCAG	ACAC
V350256906L2C002R02500651887	chr1	404861	50M	195	405056	404862	405057	V350256906L2C002R02500651887_chr1_404861	3	0	tggc	ccat
V350256906L2C002R02500663452	chr1	88247	50M	174	88421	88248	88422	V350256906L2C002R02500663452_chr1_88247	0	0	tagt	cctg
V350256906L2C002R02501215723	chr1	732088	50M	161	732249	732089	732250	V350256906L2C002R02501215723_chr1_732088	4	21	caac	TGTT
V350256906L2C002R02501250377	chr1	463408	50M	220	463628	463409	463629	V350256906L2C002R02501250377_chr1_463408	51	127	aaaa	tgtt
V350256906L2C002R02600605689	chr1	176936	50M	164	177100	176937	177101	V350256906L2C002R02600605689_chr1_176936	0	157	CACA	CCGT
V350256906L2C002R02600832195	chr1	14319	50M	187	14506	14320	14507	V350256906L2C002R02600832195_chr1_14319	0	0	CCAA	CTGT
V350256906L2C002R02600936011	chr1	918375	50M	173	918548	918376	918549	V350256906L2C002R02600936011_chr1_918375	54	63	CGGG	ccag
V350256906L2C002R02600955404	chr1	579760	50M	199	579959	579761	579960	V350256906L2C002R02600955404_chr1_579760	163	37	GAAA	GAAT
V350256906L2C002R02600990911	chr1	323887	50M	161	324048	323888	324049	V350256906L2C002R02600990911_chr1_323887	93	29	ACCA	gctc
V350256906L2C002R02601182694	chr1	1053414	50M	185	1053599	1053415	1053600	V350256906L2C002R02601182694_chr1_1053414	44	32	CCAC	CCAT
V350256906L2C002R02601295201	chr1	375474	50M	164	375638	375475	375639	V350256906L2C002R02601295201_chr1_375474	64	48	ggat	ccta
V350256906L2C002R02601364806	chr1	685719	50M	169	685888	685720	685889	V350256906L2C002R02601364806_chr1_685719	27	92	CTGA	tcct
V350256906L2C002R02700055337	chr1	709347	50M	161	709508	709348	709509	V350256906L2C002R02700055337_chr1_709347	74	56	CCTA	GACT
V350256906L2C002R02700305629	chr1	1336643	50M	233	1336876	1336644	1336877	V350256906L2C002R02700305629_chr1_1336643	40	6	GGTT	TCCC
V350256906L2C002R02700381803	chr1	1154807	50M	154	1154961	1154808	1154962	V350256906L2C002R02700381803_chr1_1154807	6	60	CCCC	GCTC
V350256906L2C002R02700390774	chr1	797165	50M	191	797356	797166	797357	V350256906L2C002R02700390774_chr1_797165	157	0	gatt	tcta
V350256906L2C002R02700623263	chr1	136597	5S45M	150	136747	136598	136748	V350256906L2C002R02700623263_chr1_136597	115	265	GGGC	GCCC
V350256906L2C002R02701072636	chr1	1218013	50M	190	1218203	1218014	1218204	V350256906L2C002R02701072636_chr1_1218013	87	57	TAGC	cgag
V350256906L2C002R02701191341	chr1	907461	50M	166	907627	907462	907628	V350256906L2C002R02701191341_chr1_907461	49	23	CTCC	CCCT
V350256906L2C002R02701202380	chr1	891462	50M	171	891633	891463	891634	V350256906L2C002R02701202380_chr1_891462	19	60	CCCC	AGCT
V350256906L2C002R02800064348	chr1	344882	50M	263	345145	344883	345146	V350256906L2C002R02800064348_chr1_344882	0	56	tgca	aaaa
V350256906L2C002R02800163543	chr1	1048184	50M	167	1048351	1048185	1048352	V350256906L2C002R02800163543_chr1_1048184	154	0	cctg	accc
V350256906L2C002R02800375311	chr1	602372	50M	146	602518	602373	602519	V350256906L2C002R02800375311_chr1_602372	0	111	cccc	ctgc
V350256906L2C002R02800526638	chr1	1413021	50M	162	1413183	1413022	1413184	V350256906L2C002R02800526638_chr1_1413021	2	81	CACA	accc
V350256906L2C002R02800701546	chr1	340567	50M	229	340796	340568	340797	V350256906L2C002R02800701546_chr1_340567	0	141	TTTA	TATA
V350256906L2C002R02800822865	chr1	458495	50M	187	458682	458496	458683	V350256906L2C002R02800822865_chr1_458495	133	10	ccac	ccaa
V350256906L2C002R02801378874	chr1	321129	50M	165	321294	321130	321295	V350256906L2C002R02801378874_chr1_321129	93	43	CCTA	tacc
V350256906L2C002R02900807512	chr1	407519	50M	171	407690	407520	407691	V350256906L2C002R02900807512_chr1_407519	208	52	acaC	ggag
V350256906L2C002R02900887853	chr1	624275	50M	188	624463	624276	624464	V350256906L2C002R02900887853_chr1_624275	54	71	TCAT	CAGG
V350256906L2C002R02901283177	chr1	1166274	50M	225	1166499	1166275	1166500	V350256906L2C002R02901283177_chr1_1166274	43	0	AACT	GGGT
V350256906L2C002R02901344510	chr1	875234	50M	173	875407	875235	875408	V350256906L2C002R02901344510_chr1_875234	59	60	GGTG	TGGG
V350256906L2C002R03000307757	chr1	620700	50M	172	620872	620701	620873	V350256906L2C002R03000307757_chr1_620700	58	47	acag	gcaa
V350256906L2C002R03000384481	chr1	1424400	50M	168	1424568	1424401	1424569	V350256906L2C002R03000384481_chr1_1424400	64	73	ccca	CCAG
V350256906L2C002R03000585358	chr1	1247608	50M	152	1247760	1247609	1247761	V350256906L2C002R03000585358_chr1_1247608	0	3	CTTG	CTGC
V350256906L2C002R03000840907	chr1	1191438	50M	177	1191615	1191439	1191616	V350256906L2C002R03000840907_chr1_1191438	0	0	GGAA	CTTT
V350256906L2C002R03001045523	chr1	1262464	50M	168	1262632	1262465	1262633	V350256906L2C002R03001045523_chr1_1262464	80	69	CCAT	TGTT
V350256906L2C002R03001157314	chr1	399505	50M	170	399675	399506	399676	V350256906L2C002R03001157314_chr1_399505	6	0	ccag	ttta
V350256906L2C002R03001402529	chr1	468210	50M	158	468368	468211	468369	V350256906L2C002R03001402529_chr1_468210	8	9	taaa	tggg
V350256906L2C002R03100082636	chr1	48772	50M	226	48998	48773	48999	V350256906L2C002R03100082636_chr1_48772	58	42	agag	tgga
V350256906L2C002R03100156159	chr1	402700	50M	172	402872	402701	402873	V350256906L2C002R03100156159_chr1_402700	1	153	tata	tggg
V350256906L2C002R03100467752	chr1	171418	50M	173	171591	171419	171592	V350256906L2C002R03100467752_chr1_171418	0	32	CATC	GGGC
V350256906L2C002R03101066275	chr1	1255062	50M	147	1255209	1255063	1255210	V350256906L2C002R03101066275_chr1_1255062	55	0	ccct	cctg
V350256906L2C002R03101391797	chr1	1096769	50M	168	1096937	1096770	1096938	V350256906L2C002R03101391797_chr1_1096769	37	66	CGGT	ACCC
V350256906L2C002R03200000885	chr1	527730	50M	171	527901	527731	527902	V350256906L2C002R03200000885_chr1_527730	18	189	CAAG	CCAT
V350256906L2C002R03200119476	chr1	814557	50M	160	814717	814558	814718	V350256906L2C002R03200119476_chr1_814557	72	58	atcg	cccc
V350256906L2C002R03200736635	chr1	770203	50M	172	770375	770204	770376	V350256906L2C002R03200736635_chr1_770203	62	93	tcat	AGAC
V350256906L2C002R03201096506	chr1	816710	50M	172	816882	816711	816883	V350256906L2C002R03201096506_chr1_816710	156	90	cttt	GAAA
V350256906L2C002R03300114057	chr1	148301	50M	193	148494	148302	148495	V350256906L2C002R03300114057_chr1_148301	225	72	tagc	tggc
V350256906L2C002R03300300811	chr1	724458	15S19M16S	248	724706	724459	724707	V350256906L2C002R03300300811_chr1_724458	151	10	actt	attc
V350256906L2C002R03300383601	chr1	837378	50M	177	837555	837379	837556	V350256906L2C002R03300383601_chr1_837378	62	30	TGTT	CCCA
V350256906L2C002R03300497602	chr1	162394	50M	180	162574	162395	162575	V350256906L2C002R03300497602_chr1_162394	0	33	aagg	caga
V350256906L2C002R03300535492	chr1	1036284	50M	175	1036459	1036285	1036460	V350256906L2C002R03300535492_chr1_1036284	64	72	cacg	gata
V350256906L2C002R03300589696	chr1	254375	50M	178	254553	254376	254554	V350256906L2C002R03300589696_chr1_254375	0	12	cctt	taaa
V350256906L2C002R03300702940	chr1	711245	50M	182	711427	711246	711428	V350256906L2C002R03300702940_chr1_711245	30	126	aaaa	ctcc
V350256906L2C002R03300728918	chr1	422973	50M	170	423143	422974	423144	V350256906L2C002R03300728918_chr1_422973	87	32	GGAA	TAGC
V350256906L2C002R03301230491	chr1	1238621	50M	246	1238867	1238622	1238868	V350256906L2C002R03301230491_chr1_1238621	31	0	GCCT	CGGC
V350256906L2C002R03400157561	chr1	18206	50M	183	18389	18207	18390	V350256906L2C002R03400157561_chr1_18206	3	0	AGAG	CCAT
V350256906L2C002R03400967980	chr1	1210495	50M	144	1210639	1210496	1210640	V350256906L2C002R03400967980_chr1_1210495	0	32	TGTG	GGCA
V350256906L2C002R03500000854	chr1	448509	50M	161	448670	448510	448671	V350256906L2C002R03500000854_chr1_448509	3	0	aacc	ttgc
V350256906L2C002R03500044095	chr1	1019734	50M	160	1019894	1019735	1019895	V350256906L2C002R03500044095_chr1_1019734	16	41	TGAG	CCCA
V350256906L2C002R03500182738	chr1	642634	50M	186	642820	642635	642821	V350256906L2C002R03500182738_chr1_642634	0	0	TACT	aaca
V350256906L2C002R03500255201	chr1	789702	50M	178	789880	789703	789881	V350256906L2C002R03500255201_chr1_789702	40	0	TAAA	CACG
V350256906L2C002R03500692064	chr1	978981	50M	177	979158	978982	979159	V350256906L2C002R03500692064_chr1_978981	23	3	CCTC	GGAG
V350256906L2C002R03501150914	chr1	31663	50M	205	31868	31664	31869	V350256906L2C002R03501150914_chr1_31663	113	140	agct	CCTA
V350256906L2C002R03501248686	chr1	658316	50M	173	658489	658317	658490	V350256906L2C002R03501248686_chr1_658316	13	0	CATA	CCCC
V350256906L2C002R03501397331	chr1	639811	50M	182	639993	639812	639994	V350256906L2C002R03501397331_chr1_639811	0	50	GGTT	GGAA
V350256906L2C002R03600049650	chr1	699425	50M	161	699586	699426	699587	V350256906L2C002R03600049650_chr1_699425	41	92	CCTA	GGTG
V350256906L2C002R03600353394	chr1	1366120	50M	175	1366295	1366121	1366296	V350256906L2C002R03600353394_chr1_1366120	9	0	CAGG	CCTA
V350256906L2C002R03600431784	chr1	230821	50M	171	230992	230822	230993	V350256906L2C002R03600431784_chr1_230821	65	30	gatt	cctc
V350256906L2C002R03600611092	chr1	266582	50M	151	266733	266583	266734	V350256906L2C002R03600611092_chr1_266582	58	49	GGTG	TAAT
V350256906L2C002R03600766684	chr1	982609	50M	160	982769	982610	982770	V350256906L2C002R03600766684_chr1_982609	235	75	TCCC	GTAG
V350256906L2C002R03600840773	chr1	884279	50M	158	884437	884280	884438	V350256906L2C002R03600840773_chr1_884279	69	59	CCCA	TCTT
V350256906L2C002R03600955388	chr1	672274	50M	144	672418	672275	672419	V350256906L2C002R03600955388_chr1_672274	165	21	gctg	cccc
V350256906L2C002R03600996761	chr1	1332860	50M	167	1333027	1332861	1333028	V350256906L2C002R03600996761_chr1_1332860	23	133	catc	ccaa
V350256906L2C002R03600997589	chr1	70313	50M	171	70484	70314	70485	V350256906L2C002R03600997589_chr1_70313	37	31	AGAA	GGAG
V350256906L2C002R03601042931	chr1	1170636	50M	202	1170838	1170637	1170839	V350256906L2C002R03601042931_chr1_1170636	145	61	CTTC	CCCT
V350256906L2C002R03601124877	chr1	245080	50M	182	245262	245081	245263	V350256906L2C002R03601124877_chr1_245080	254	72	CTGA	CCCC
V350256906L2C002R03700225816	chr1	100816	50M	121	100937	100817	100938	V350256906L2C002R03700225816_chr1_100816	17	138	CAAA	CTTT
V350256906L2C002R03700260761	chr1	132959	50M	149	133108	132960	133109	V350256906L2C002R03700260761_chr1_132959	0	2	AAAC	CATC
V350256906L2C002R03700299292	chr1	370754	50M	171	370925	370755	370926	V350256906L2C002R03700299292_chr1_370754	11	0	caac	ctag
V350256906L2C002R03700314816	chr1	50360	50M	186	50546	50361	50547	V350256906L2C002R03700314816_chr1_50360	31	56	AGAA	GGAG
V350256906L2C002R03701072676	chr1	694470	50M	147	694617	694471	694618	V350256906L2C002R03701072676_chr1_694470	142	289	CTTG	cctg
V350256906L2C002R03701072982	chr1	736798	50M	170	736968	736799	736969	V350256906L2C002R03701072982_chr1_736798	150	0	GGGA	TAAG
V350256906L2C002R03800012933	chr1	1191157	50M	148	1191305	1191158	1191306	V350256906L2C002R03800012933_chr1_1191157	81	38	CCCA	CCCC
V350256906L2C002R03800096350	chr1	556924	50M	170	557094	556925	557095	V350256906L2C002R03800096350_chr1_556924	0	167	GCCA	AGTC
V350256906L2C002R03800552668	chr1	649029	50M	171	649200	649030	649201	V350256906L2C002R03800552668_chr1_649029	176	5	GTTC	ACTG
V350256906L2C002R03800677260	chr1	632663	50M	223	632886	632664	632887	V350256906L2C002R03800677260_chr1_632663	106	18	tgag	tgat
V350256906L2C002R03801069106	chr1	803873	50M	136	804009	803874	804010	V350256906L2C002R03801069106_chr1_803873	0	36	AAAA	GAGT
V350256906L2C002R03801125478	chr1	884004	50M	139	884143	884005	884144	V350256906L2C002R03801125478_chr1_884004	3	28	GGCT	TTCG
V350256906L2C002R03801294245	chr1	620339	50M	165	620504	620340	620505	V350256906L2C002R03801294245_chr1_620339	71	58	ccct	taaa
V350256906L2C002R03900027649	chr1	20636	50M	184	20820	20637	20821	V350256906L2C002R03900027649_chr1_20636	79	57	ggtg	CCTC
V350256906L2C002R03900256061	chr1	1264483	50M	174	1264657	1264484	1264658	V350256906L2C002R03900256061_chr1_1264483	70	65	CATT	GGCC
V350256906L2C002R03900338814	chr1	121590	50M	179	121769	121591	121770	V350256906L2C002R03900338814_chr1_121590	6	10	CTAC	TGGA
V350256906L2C002R03900562893	chr1	1404011	50M	114	1404125	1404012	1404126	V350256906L2C002R03900562893_chr1_1404011	64	0	CCCA	CCAG
V350256906L2C002R03900644846	chr1	817856	50M	170	818026	817857	818027	V350256906L2C002R03900644846_chr1_817856	148	77	CTCA	TATA
V350256906L2C002R03901157829	chr1	1062840	50M	144	1062984	1062841	1062985	V350256906L2C002R03901157829_chr1_1062840	56	35	CAGC	CCGT
V350256906L2C002R03901164019	chr1	1277575	50M	156	1277731	1277576	1277732	V350256906L2C002R03901164019_chr1_1277575	0	71	CCCA	TGGG
V350256906L2C002R04000085330	chr1	832519	50M	149	832668	832520	832669	V350256906L2C002R04000085330_chr1_832519	71	54	taac	cctg
V350256906L2C002R04000119866	chr1	873695	50M	160	873855	873696	873856	V350256906L2C002R04000119866_chr1_873695	113	24	GCTG	TCCT
V350256906L2C002R04000431640	chr1	721481	50M	189	721670	721482	721671	V350256906L2C002R04000431640_chr1_721481	58	24	GTCC	gggc
V350256906L2C002R04000487930	chr1	847009	50M	164	847173	847010	847174	V350256906L2C002R04000487930_chr1_847009	141	0	GGTA	GCAT
V350256906L2C002R04000541274	chr1	105653	50M	180	105833	105654	105834	V350256906L2C002R04000541274_chr1_105653	144	37	tctc	CCAA
V350256906L2C002R04000748416	chr1	657950	50M	209	658159	657951	658160	V350256906L2C002R04000748416_chr1_657950	128	120	AGGC	CCGC
V350256906L2C002R04000939215	chr1	166621	50M	191	166812	166622	166813	V350256906L2C002R04000939215_chr1_166621	100	20	GCTA	CATG
V350256906L2C002R04001063856	chr1	422259	50M	198	422457	422260	422458	V350256906L2C002R04001063856_chr1_422259	131	0	ctta	cctg
V350256906L2C002R04001273268	chr1	1311127	50M	164	1311291	1311128	1311292	V350256906L2C002R04001273268_chr1_1311127	47	45	ccga	cctg
V350256906L2C002R04100183761	chr1	699526	50M	180	699706	699527	699707	V350256906L2C002R04100183761_chr1_699526	32	106	CAAG	gagc
V350256906L2C002R04100739580	chr1	921232	50M	178	921410	921233	921411	V350256906L2C002R04100739580_chr1_921232	4	92	caaa	gacg
V350256906L2C002R04100802032	chr1	773659	50M	184	773843	773660	773844	V350256906L2C002R04100802032_chr1_773659	3	10	ctag	ctaa
V350256906L2C002R04100832886	chr1	1019517	50M	165	1019682	1019518	1019683	V350256906L2C002R04100832886_chr1_1019517	31	68	CAGG	CCCA
V350256906L2C002R04100914173	chr1	537203	50M	152	537355	537204	537356	V350256906L2C002R04100914173_chr1_537203	387	235	CACA	GCCT
V350256906L2C002R04100971156	chr1	233485	50M	174	233659	233486	233660	V350256906L2C002R04100971156_chr1_233485	15	55	ccta	agac
V350256906L2C002R04200472463	chr1	1149870	50M	179	1150049	1149871	1150050	V350256906L2C002R04200472463_chr1_1149870	42	36	GAAG	ccat
V350256906L2C002R04200736553	chr1	1168339	50M	173	1168512	1168340	1168513	V350256906L2C002R04200736553_chr1_1168339	170	73	CCTG	CCTC
V350256906L2C002R04200856136	chr1	1325535	50M	185	1325720	1325536	1325721	V350256906L2C002R04200856136_chr1_1325535	0	9	CCAG	AAAA
V350256906L2C002R04201051095	chr1	939860	50M	159	940019	939861	940020	V350256906L2C002R04201051095_chr1_939860	39	71	ACAG	GGGG
V350256906L2C002R04201070002	chr1	408121	50M	181	408302	408122	408303	V350256906L2C002R04201070002_chr1_408121	26	122	TATT	CACT
V350256906L2C002R04201135677	chr1	75751	50M	174	75925	75752	75926	V350256906L2C002R04201135677_chr1_75751	180	6	aaag	tata
V350256906L2C002R04201281614	chr1	54669	50M	179	54848	54670	54849	V350256906L2C002R04201281614_chr1_54669	46	225	cttt	cagc
V350256906L2C002R04300182629	chr1	359022	50M	172	359194	359023	359195	V350256906L2C002R04300182629_chr1_359022	123	52	TTTA	CCAA
V350256906L2C002R04300186166	chr1	819267	50M	193	819460	819268	819461	V350256906L2C002R04300186166_chr1_819267	60	38	tgca	agaa
V350256906L2C002R04300263934	chr1	833921	50M	173	834094	833922	834095	V350256906L2C002R04300263934_chr1_833921	70	63	ggcg	TTAA
V350256906L2C002R04300395125	chr1	1048792	50M	194	1048986	1048793	1048987	V350256906L2C002R04300395125_chr1_1048792	13	20	GGCT	gagg
V350256906L2C002R04300417035	chr1	1403668	50M	171	1403839	1403669	1403840	V350256906L2C002R04300417035_chr1_1403668	52	70	CCCT	CTGG
V350256906L2C002R04300440818	chr1	170395	50M	170	170565	170396	170566	V350256906L2C002R04300440818_chr1_170395	367	537	CCCT	CCTG
V350256906L2C002R04300563383	chr1	1245583	50M	248	1245831	1245584	1245832	V350256906L2C002R04300563383_chr1_1245583	0	48	GCTT	CCAG
V350256906L2C002R04301023412	chr1	823119	3S14M1I32M	151	823270	823120	823271	V350256906L2C002R04301023412_chr1_823119	0	4	atac	TATG
V350256906L2C002R04400236280	chr1	148803	50M	186	148989	148804	148990	V350256906L2C002R04400236280_chr1_148803	27	42	ggtg	ggtt
V350256906L2C002R04400560576	chr1	1337112	50M	135	1337247	1337113	1337248	V350256906L2C002R04400560576_chr1_1337112	28	0	AAAT	AGCA
V350256906L2C002R04400678425	chr1	261025	50M	160	261185	261026	261186	V350256906L2C002R04400678425_chr1_261025	167	7	CCAA	AGAC
V350256906L2C002R04400764370	chr1	133939	50M	155	134094	133940	134095	V350256906L2C002R04400764370_chr1_133939	159	4	CCCA	aaaa
V350256906L2C002R04401049605	chr1	1022840	50M	184	1023024	1022841	1023025	V350256906L2C002R04401049605_chr1_1022840	48	68	GGAG	TGTG
V350256906L2C002R04401106995	chr1	828015	50M	144	828159	828016	828160	V350256906L2C002R04401106995_chr1_828015	23	69	tgag	tata
V350256906L2C002R04500017144	chr1	1107775	50M	180	1107955	1107776	1107956	V350256906L2C002R04500017144_chr1_1107775	83	58	ttgt	CTGG
V350256906L2C002R04500336115	chr1	40110	50M	216	40326	40111	40327	V350256906L2C002R04500336115_chr1_40110	0	56	tgtg	TGTT
V350256906L2C002R04500381589	chr1	697820	50M	151	697971	697821	697972	V350256906L2C002R04500381589_chr1_697820	40	43	CCAG	tgga
V350256906L2C002R04500550277	chr1	1208816	50M	177	1208993	1208817	1208994	V350256906L2C002R04500550277_chr1_1208816	44	58	GCCG	CCGG
V350256906L2C002R04500669425	chr1	1413980	50M	177	1414157	1413981	1414158	V350256906L2C002R04500669425_chr1_1413980	88	4	CCAG	CGGC
V350256906L2C002R04500715796	chr1	160878	50M	139	161017	160879	161018	V350256906L2C002R04500715796_chr1_160878	49	55	GGAG	AAGC
V350256906L2C002R04500879252	chr1	357546	50M	163	357709	357547	357710	V350256906L2C002R04500879252_chr1_357546	0	0	TGTT	aaga
V350256906L2C002R04500983004	chr1	1053805	50M	188	1053993	1053806	1053994	V350256906L2C002R04500983004_chr1_1053805	0	0	CTGA	CCAC
V350256906L2C002R04501140691	chr1	734607	50M	174	734781	734608	734782	V350256906L2C002R04501140691_chr1_734607	0	0	AGAA	TGGT
V350256906L2C002R04501183017	chr1	1067263	50M	162	1067425	1067264	1067426	V350256906L2C002R04501183017_chr1_1067263	9	21	CCAC	CCTC
V350256906L2C002R04600211095	chr1	127765	50M	166	127931	127766	127932	V350256906L2C002R04600211095_chr1_127765	50	28	GGTG	atag
V350256906L2C002R04601151147	chr1	1122469	47M3S	218	1122687	1122470	1122688	V350256906L2C002R04601151147_chr1_1122469	37	19	gccc	aagg
V350256906L2C002R04700097929	chr1	1254128	50M	177	1254305	1254129	1254306	V350256906L2C002R04700097929_chr1_1254128	12	33	CTAA	GGAG
V350256906L2C002R04700500327	chr1	341745	50M	156	341901	341746	341902	V350256906L2C002R04700500327_chr1_341745	2	19	TAAA	gccc
V350256906L2C002R04700592010	chr1	378562	50M	196	378758	378563	378759	V350256906L2C002R04700592010_chr1_378562	65	80	GGCA	CCCT
V350256906L2C002R04800189101	chr1	1020400	50M	188	1020588	1020401	1020589	V350256906L2C002R04800189101_chr1_1020400	42	57	CCCT	CCCA
V350256906L2C002R04800230502	chr1	914990	50M	143	915133	914991	915134	V350256906L2C002R04800230502_chr1_914990	43	13	CCTC	TTCA
V350256906L2C002R04800347369	chr1	1120590	50M	211	1120801	1120591	1120802	V350256906L2C002R04800347369_chr1_1120590	28	61	GGCG	AAGA
V350256906L2C002R04800588106	chr1	830140	50M	162	830302	830141	830303	V350256906L2C002R04800588106_chr1_830140	0	78	TATT	gcct
V350256906L2C002R04800766363	chr1	555650	50M	164	555814	555651	555815	V350256906L2C002R04800766363_chr1_555650	71	33	ccta	CCTA
V350256906L2C002R04801170204	chr1	863407	50M	137	863544	863408	863545	V350256906L2C002R04801170204_chr1_863407	0	91	CCTT	cctc
V350256906L2C002R04801320809	chr1	237087	50M	156	237243	237088	237244	V350256906L2C002R04801320809_chr1_237087	147	0	CCAA	CCCA
V350256906L2C002R04900201264	chr1	234412	50M	224	234636	234413	234637	V350256906L2C002R04900201264_chr1_234412	31	0	CTGG	gagg
V350256906L2C002R04900240136	chr1	724928	5S36M9S	176	725104	724929	725105	V350256906L2C002R04900240136_chr1_724928	0	134	aatt	tcca
V350256906L2C002R04900505676	chr1	1145166	50M	149	1145315	1145167	1145316	V350256906L2C002R04900505676_chr1_1145166	49	57	ggcc	gggt
V350256906L2C002R04900918552	chr1	1254121	50M	178	1254299	1254122	1254300	V350256906L2C002R04900918552_chr1_1254121	5	27	TAGG	GAGA
V350256906L2C002R04900990117	chr1	1158589	50M	192	1158781	1158590	1158782	V350256906L2C002R04900990117_chr1_1158589	0	146	TGAG	GCTC
V350256906L2C002R04901073873	chr1	1249469	50M	168	1249637	1249470	1249638	V350256906L2C002R04901073873_chr1_1249469	24	35	CGGA	CTGA
V350256906L2C002R05000434410	chr1	59464	50M	158	59622	59465	59623	V350256906L2C002R05000434410_chr1_59464	0	140	CAAG	GGGA
V350256906L2C002R05000634195	chr1	1420010	50M	186	1420196	1420011	1420197	V350256906L2C002R05000634195_chr1_1420010	82	70	AAAC	CCCT
V350256906L2C002R05000677110	chr1	945741	50M	200	945941	945742	945942	V350256906L2C002R05000677110_chr1_945741	234	34	CTTT	CAAG
V350256906L2C002R05001024150	chr1	723368	50M	236	723604	723369	723605	V350256906L2C002R05001024150_chr1_723368	0	42	GAAG	ggct
V350256906L2C002R05001186688	chr1	150837	50M	185	151022	150838	151023	V350256906L2C002R05001186688_chr1_150837	71	50	acta	ctgg
V350256906L2C002R05001209209	chr1	257508	50M	147	257655	257509	257656	V350256906L2C002R05001209209_chr1_257508	32	74	atct	cagg
V350256906L2C002R05100326159	chr1	666034	50M	141	666175	666035	666176	V350256906L2C002R05100326159_chr1_666034	7	11	cCCA	actt
V350256906L2C002R05100368487	chr1	739552	50M	166	739718	739553	739719	V350256906L2C002R05100368487_chr1_739552	72	62	CCTC	ctaa
V350256906L2C002R05100385006	chr1	817899	50M	127	818026	817900	818027	V350256906L2C002R05100385006_chr1_817899	191	77	AGGA	TATA
V350256906L2C002R05100493836	chr1	1098576	50M	144	1098720	1098577	1098721	V350256906L2C002R05100493836_chr1_1098576	68	34	GGCG	GCCA
V350256906L2C002R05100538556	chr1	442759	50M	188	442947	442760	442948	V350256906L2C002R05100538556_chr1_442759	0	0	TAAA	GCTG
V350256906L2C002R05101162334	chr1	673548	50M	168	673716	673549	673717	V350256906L2C002R05101162334_chr1_673548	135	6	CACA	ACTG
V350256906L2C002R05200510588	chr1	808493	50M	178	808671	808494	808672	V350256906L2C002R05200510588_chr1_808493	6	0	ATTT	TGTA
V350256906L2C002R05200876971	chr1	905921	50M	185	906106	905922	906107	V350256906L2C002R05200876971_chr1_905921	63	62	GGAG	CGAG
V350256906L2C002R05201037125	chr1	552866	50M	169	553035	552867	553036	V350256906L2C002R05201037125_chr1_552866	66	17	CTCA	catg
V350256906L2C002R05201040301	chr1	1046564	50M	164	1046728	1046565	1046729	V350256906L2C002R05201040301_chr1_1046564	95	0	AATT	ctct
V350256906L2C002R05201240748	chr1	32057	50M	147	32204	32058	32205	V350256906L2C002R05201240748_chr1_32057	0	21	GTGT	CATG
V350256906L2C002R05300652319	chr1	1223264	50M	199	1223463	1223265	1223464	V350256906L2C002R05300652319_chr1_1223264	25	12	CCTG	GCCC
V350256906L2C002R05300691059	chr1	402452	50M	181	402633	402453	402634	V350256906L2C002R05300691059_chr1_402452	121	30	ctgt	tcat
V350256906L2C002R05300723455	chr1	726108	4S33M13S	242	726350	726109	726351	V350256906L2C002R05300723455_chr1_726108	141	59	GAAT	ccat
V350256906L2C002R05300757367	chr1	334522	50M	196	334718	334523	334719	V350256906L2C002R05300757367_chr1_334522	34	148	ctga	ccca
V350256906L2C002R05301078527	chr1	258405	50M	186	258591	258406	258592	V350256906L2C002R05301078527_chr1_258405	69	72	acat	ggaa
V350256906L2C002R05400046665	chr1	746019	50M	150	746169	746020	746170	V350256906L2C002R05400046665_chr1_746019	18	62	TATT	CCCA
V350256906L2C002R05400409282	chr1	778750	50M	168	778918	778751	778919	V350256906L2C002R05400409282_chr1_778750	0	0	GGGT	AAAA
V350256906L2C002R05400520310	chr1	412116	50M	161	412277	412117	412278	V350256906L2C002R05400520310_chr1_412116	0	0	TTTA	CCTT
V350256906L2C002R05401072872	chr1	1316358	50M	175	1316533	1316359	1316534	V350256906L2C002R05401072872_chr1_1316358	92	267	CTGG	CCCC
V350256906L2C002R05401191032	chr1	143074	50M	171	143245	143075	143246	V350256906L2C002R05401191032_chr1_143074	61	75	AAAT	gcag
V350256906L2C002R05500259446	chr1	367909	50M	213	368122	367910	368123	V350256906L2C002R05500259446_chr1_367909	51	4	ACCT	GACT
V350256906L2C002R05500272903	chr1	27703	50M	181	27884	27704	27885	V350256906L2C002R05500272903_chr1_27703	147	15	TGGT	gtaa
V350256906L2C002R05500388985	chr1	724519	19S31M	167	724686	724520	724687	V350256906L2C002R05500388985_chr1_724519	197	30	atgg	ATTC
V350256906L2C002R05500520137	chr1	122850	50M	150	123000	122851	123001	V350256906L2C002R05500520137_chr1_122850	28	67	TCTT	AGCT
V350256906L2C002R05500619234	chr1	230626	50M	149	230775	230627	230776	V350256906L2C002R05500619234_chr1_230626	62	57	aatt	cccc
V350256906L2C002R05500701485	chr1	1162546	50M	165	1162711	1162547	1162712	V350256906L2C002R05500701485_chr1_1162546	148	0	ACAG	cctt
V350256906L2C002R05500764548	chr1	859805	50M	165	859970	859806	859971	V350256906L2C002R05500764548_chr1_859805	0	0	GGGC	ggca
V350256906L2C002R05501074569	chr1	415787	50M	154	415941	415788	415942	V350256906L2C002R05501074569_chr1_415787	6	40	cttt	CAGA
V350256906L2C002R05501255349	chr1	1156895	50M	153	1157048	1156896	1157049	V350256906L2C002R05501255349_chr1_1156895	62	20	tctt	CTTT
V350256906L2C002R05600007020	chr1	1031749	50M	144	1031893	1031750	1031894	V350256906L2C002R05600007020_chr1_1031749	2	86	tatt	acaa
V350256906L2C002R05600080223	chr1	854674	50M	169	854843	854675	854844	V350256906L2C002R05600080223_chr1_854674	66	58	CCCA	TGGC
V350256906L2C002R05600131466	chr1	1108890	50M	125	1109015	1108891	1109016	V350256906L2C002R05600131466_chr1_1108890	59	37	CGTG	CCGT
V350256906L2C002R05600192129	chr1	250903	50M	166	251069	250904	251070	V350256906L2C002R05600192129_chr1_250903	56	25	tcca	ccct
V350256906L2C002R05600229989	chr1	1140577	50M	166	1140743	1140578	1140744	V350256906L2C002R05600229989_chr1_1140577	55	55	CAGA	CTGG
V350256906L2C002R05601175333	chr1	1137965	50M	178	1138143	1137966	1138144	V350256906L2C002R05601175333_chr1_1137965	0	0	catc	gggg
V350256906L2C002R05700251937	chr1	1104102	50M	187	1104289	1104103	1104290	V350256906L2C002R05700251937_chr1_1104102	59	73	CATT	GATC
V350256906L2C002R05700515810	chr1	21034	50M	164	21198	21035	21199	V350256906L2C002R05700515810_chr1_21034	53	53	GGAG	CCAC
V350256906L2C002R05700594355	chr1	706292	50M	157	706449	706293	706450	V350256906L2C002R05700594355_chr1_706292	31	188	GCAG	AGTG
V350256906L2C002R05800134735	chr1	726299	9S41M	209	726508	726300	726509	V350256906L2C002R05800134735_chr1_726299	8	31	gaat	tcca
V350256906L2C002R05800499500	chr1	31064	50M	142	31206	31065	31207	V350256906L2C002R05800499500_chr1_31064	59	46	tcca	CCTG
V350256906L2C002R05800575935	chr1	1161339	50M	193	1161532	1161340	1161533	V350256906L2C002R05800575935_chr1_1161339	0	175	CGCA	ttcc
V350256906L2C002R05800669709	chr1	590291	50M	158	590449	590292	590450	V350256906L2C002R05800669709_chr1_590291	21	63	ctca	gtaa
V350256906L2C002R05801332506	chr1	123781	50M	162	123943	123782	123944	V350256906L2C002R05801332506_chr1_123781	78	86	ctga	gaac
V350256906L2C002R05900149398	chr1	1277126	50M	162	1277288	1277127	1277289	V350256906L2C002R05900149398_chr1_1277126	57	97	CTGG	GCCA
V350256906L2C002R05900548371	chr1	1326023	50M	175	1326198	1326024	1326199	V350256906L2C002R05900548371_chr1_1326023	25	29	TGTT	GCCA
V350256906L2C002R05900569167	chr1	954279	50M	152	954431	954280	954432	V350256906L2C002R05900569167_chr1_954279	86	75	cctc	gagg
V350256906L2C002R05900827322	chr1	249643	50M	139	249782	249644	249783	V350256906L2C002R05900827322_chr1_249643	80	22	agtt	ccct
V350256906L2C002R05901134069	chr1	129052	50M	201	129253	129053	129254	V350256906L2C002R05901134069_chr1_129052	57	70	TACG	GGTG
V350256906L2C002R05901362297	chr1	898065	50M	174	898239	898066	898240	V350256906L2C002R05901362297_chr1_898065	0	2	GGCG	CCTA
V350256906L2C002R06000082883	chr1	1375270	50M	165	1375435	1375271	1375436	V350256906L2C002R06000082883_chr1_1375270	91	186	GGCC	CCCA
V350256906L2C002R06000933643	chr1	682883	50M	103	682986	682884	682987	V350256906L2C002R06000933643_chr1_682883	94	197	actt	gcta
V350256906L2C002R06000944625	chr1	1353406	50M	187	1353593	1353407	1353594	V350256906L2C002R06000944625_chr1_1353406	64	63	caaa	cctc
V350256906L2C002R06100142017	chr1	1162103	50M	166	1162269	1162104	1162270	V350256906L2C002R06100142017_chr1_1162103	56	46	CCTC	CGCG
V350256906L2C002R06100328509	chr1	428269	50M	174	428443	428270	428444	V350256906L2C002R06100328509_chr1_428269	6	1	tgca	caga
V350256906L2C002R06100444860	chr1	18588	50M	229	18817	18589	18818	V350256906L2C002R06100444860_chr1_18588	181	56	CCTG	GGTG
V350256906L2C002R06100637557	chr1	1120197	50M	164	1120361	1120198	1120362	V350256906L2C002R06100637557_chr1_1120197	272	108	CCGG	CTTC
V350256906L2C002R06100954977	chr1	322069	50M	188	322257	322070	322258	V350256906L2C002R06100954977_chr1_322069	59	32	agta	gcat
V350256906L2C002R06101120885	chr1	446924	50M	170	447094	446925	447095	V350256906L2C002R06101120885_chr1_446924	0	168	CCAT	aaca
V350256906L2C002R06101353054	chr1	461201	50M	171	461372	461202	461373	V350256906L2C002R06101353054_chr1_461201	81	252	ccct	cagt
V350256906L2C002R06200238090	chr1	67885	50M	161	68046	67886	68047	V350256906L2C002R06200238090_chr1_67885	72	64	TAAT	taaa
V350256906L2C002R06200336170	chr1	165049	50M	148	165197	165050	165198	V350256906L2C002R06200336170_chr1_165049	42	89	gctg	tccc
V350256906L2C002R06200424862	chr1	259145	50M	185	259330	259146	259331	V350256906L2C002R06200424862_chr1_259145	61	70	ACAT	GAAT
V350256906L2C002R06200550844	chr1	39145	50M	161	39306	39146	39307	V350256906L2C002R06200550844_chr1_39145	75	236	tccc	taca
V350256906L2C002R06200932300	chr1	575507	50M	199	575706	575508	575707	V350256906L2C002R06200932300_chr1_575507	12	22	tgcc	ggtc
V350256906L2C002R06201062334	chr1	102921	50M	219	103140	102922	103141	V350256906L2C002R06201062334_chr1_102921	46	70	aata	ggga
V350256906L2C002R06201141708	chr1	726015	5S45M	141	726156	726016	726157	V350256906L2C002R06201141708_chr1_726015	90	93	tgga	ttcc
V350256906L2C002R06201256902	chr1	535105	50M	211	535316	535106	535317	V350256906L2C002R06201256902_chr1_535105	162	15	tgct	ccca
V350256906L2C002R06300152620	chr1	798599	50M	211	798810	798600	798811	V350256906L2C002R06300152620_chr1_798599	56	64	GTTT	CTTT
V350256906L2C002R06300245583	chr1	1395494	50M	169	1395663	1395495	1395664	V350256906L2C002R06300245583_chr1_1395494	0	7	ccag	tggt
V350256906L2C002R06300545371	chr1	844446	50M	177	844623	844447	844624	V350256906L2C002R06300545371_chr1_844446	420	243	CCCC	GACC
V350256906L2C002R06300698164	chr1	1320378	50M	177	1320555	1320379	1320556	V350256906L2C002R06300698164_chr1_1320378	92	18	ccac	catt
V350256906L2C002R06300857532	chr1	728536	50M	238	728774	728537	728775	V350256906L2C002R06300857532_chr1_728536	243	148	cata	ctgc
V350256906L2C002R06301355781	chr1	147001	50M	176	147177	147002	147178	V350256906L2C002R06301355781_chr1_147001	0	84	ctgg	ccac
V350256906L2C002R06400767105	chr1	1053952	50M	187	1054139	1053953	1054140	V350256906L2C002R06400767105_chr1_1053952	11	8	CGAG	CCCC
V350256906L2C002R06401332848	chr1	600395	50M	177	600572	600396	600573	V350256906L2C002R06401332848_chr1_600395	13	7	atag	ctat
V350256906L2C002R06500368640	chr1	58155	50M	167	58322	58156	58323	V350256906L2C002R06500368640_chr1_58155	0	36	TCTC	TTAG
V350256906L2C002R06501008583	chr1	924987	50M	149	925136	924988	925137	V350256906L2C002R06501008583_chr1_924987	72	17	tgca	gccc
V350256906L2C002R06501352574	chr1	775781	9M2I39M	160	775941	775782	775942	V350256906L2C002R06501352574_chr1_775781	5	4	tgTA	gatg
V350256906L2C002R06600058736	chr1	834695	50M	170	834865	834696	834866	V350256906L2C002R06600058736_chr1_834695	52	61	accg	CGTG
V350256906L2C002R06600109747	chr1	657964	50M	194	658158	657965	658159	V350256906L2C002R06600109747_chr1_657964	142	121	AGTG	CGCT
V350256906L2C002R06600354839	chr1	149392	50M	181	149573	149393	149574	V350256906L2C002R06600354839_chr1_149392	71	145	TGGA	ccga
V350256906L2C002R06600553048	chr1	611920	50M	161	612081	611921	612082	V350256906L2C002R06600553048_chr1_611920	9	170	tgcc	gctg
V350256906L2C002R06601315420	chr1	1406113	50M	183	1406296	1406114	1406297	V350256906L2C002R06601315420_chr1_1406113	40	39	cttt	cact
V350256906L2C002R06700001773	chr1	772372	50M	181	772553	772373	772554	V350256906L2C002R06700001773_chr1_772372	90	65	TCTA	CCAC
V350256906L2C002R06700208753	chr1	75570	50M	160	75730	75571	75731	V350256906L2C002R06700208753_chr1_75570	144	201	cgta	gccc
V350256906L2C002R06700226061	chr1	135018	50M	172	135190	135019	135191	V350256906L2C002R06700226061_chr1_135018	172	133	CTGG	GGCC
V350256906L2C002R06700588861	chr1	1424149	50M	192	1424341	1424150	1424342	V350256906L2C002R06700588861_chr1_1424149	26	62	gcga	tgag
V350256906L2C002R06700930757	chr1	138930	50M	166	139096	138931	139097	V350256906L2C002R06700930757_chr1_138930	59	35	GGGC	CTAC
V350256906L2C002R06800154269	chr1	1113850	50M	174	1114024	1113851	1114025	V350256906L2C002R06800154269_chr1_1113850	10	6	agaa	CGAC
V350256906L2C002R06800520734	chr1	1022848	50M	158	1023006	1022849	1023007	V350256906L2C002R06800520734_chr1_1022848	40	79	GAGA	TGAC
V350256906L2C002R06800617164	chr1	108509	50M	189	108698	108510	108699	V350256906L2C002R06800617164_chr1_108509	15	65	ctgc	CCCA
V350256906L2C002R06800948417	chr1	611968	50M	154	612122	611969	612123	V350256906L2C002R06800948417_chr1_611968	57	211	acca	aggg
V350256906L2C002R06801004173	chr1	687092	50M	159	687251	687093	687252	V350256906L2C002R06801004173_chr1_687092	74	33	acct	agac
V350256906L2C002R06801098758	chr1	916420	50M	182	916602	916421	916603	V350256906L2C002R06801098758_chr1_916420	34	53	CAGA	TGAA
V350256906L2C002R06801106602	chr1	1021537	50M	164	1021701	1021538	1021702	V350256906L2C002R06801106602_chr1_1021537	36	96	TGCA	AGAG
V350256906L2C002R06900342638	chr1	1343950	50M	166	1344116	1343951	1344117	V350256906L2C002R06900342638_chr1_1343950	217	224	ccta	CCTA
V350256906L2C002R06900447564	chr1	15678	50M	210	15888	15679	15889	V350256906L2C002R06900447564_chr1_15678	255	334	CAGG	CATC
V350256906L2C002R06900828845	chr1	1224568	47M3S	176	1224744	1224569	1224745	V350256906L2C002R06900828845_chr1_1224568	0	114	cccg	cacg
V350256906L2C002R06901162409	chr1	571759	50M	112	571871	571760	571872	V350256906L2C002R06901162409_chr1_571759	56	30	caaa	ccct
V350256906L2C002R07000066266	chr1	1141594	50M	159	1141753	1141595	1141754	V350256906L2C002R07000066266_chr1_1141594	29	37	CCCT	CGTT
V350256906L2C002R07000636159	chr1	724800	18S29M3S	195	724995	724801	724996	V350256906L2C002R07000636159_chr1_724800	35	25	tgga	ttcc
V350256906L2C002R07000905557	chr1	61700	50M	181	61881	61701	61882	V350256906L2C002R07000905557_chr1_61700	64	97	ccaa	aaaa
V350256906L2C002R07001019945	chr1	996584	50M	151	996735	996585	996736	V350256906L2C002R07001019945_chr1_996584	0	25	cctc	ctct
V350256906L2C002R07001362893	chr1	399426	50M	163	399589	399427	399590	V350256906L2C002R07001362893_chr1_399426	49	64	tcta	acat
V350256906L2C002R07100210589	chr1	123762	50M	169	123931	123763	123932	V350256906L2C002R07100210589_chr1_123762	59	98	ccag	tata
V350256906L2C002R07100212628	chr1	1365343	50M	175	1365518	1365344	1365519	V350256906L2C002R07100212628_chr1_1365343	14	24	tgat	gcct
V350256906L2C002R07100392910	chr1	55577	50M	201	55778	55578	55779	V350256906L2C002R07100392910_chr1_55577	0	0	gcta	GGAA
V350256906L2C002R07100694366	chr1	549817	50M	188	550005	549818	550006	V350256906L2C002R07100694366_chr1_549817	16	74	CCAG	GAAA
V350256906L2C002R07100758696	chr1	650219	50M	191	650410	650220	650411	V350256906L2C002R07100758696_chr1_650219	9	0	Caat	ataa
V350256906L2C002R07100830633	chr1	959751	50M	130	959881	959752	959882	V350256906L2C002R07100830633_chr1_959751	307	177	ACCC	CTGC
V350256906L2C002R07100930265	chr1	1349142	50M	171	1349313	1349143	1349314	V350256906L2C002R07100930265_chr1_1349142	26	35	caat	tcta
V350256906L2C002R07101058262	chr1	1357989	50M	166	1358155	1357990	1358156	V350256906L2C002R07101058262_chr1_1357989	24	0	cctc	tgCA
V350256906L2C002R07101150891	chr1	236703	50M	170	236873	236704	236874	V350256906L2C002R07101150891_chr1_236703	25	30	CAGT	tgct
V350256906L2C002R07101274680	chr1	860984	50M	172	861156	860985	861157	V350256906L2C002R07101274680_chr1_860984	62	70	CAGC	CCCG
V350256906L2C002R07101405712	chr1	112539	50M	134	112673	112540	112674	V350256906L2C002R07101405712_chr1_112539	151	213	cctg	TGTA
V350256906L2C002R07200262008	chr1	1387391	50M	178	1387569	1387392	1387570	V350256906L2C002R07200262008_chr1_1387391	0	0	AAAG	TGGG
V350256906L2C002R07200345971	chr1	122821	50M	175	122996	122822	122997	V350256906L2C002R07200345971_chr1_122821	57	71	CCAC	AACA
V350256906L2C002R07200498892	chr1	115518	50M	174	115692	115519	115693	V350256906L2C002R07200498892_chr1_115518	1	54	CTTT	cctt
V350256906L2C002R07200634235	chr1	1390692	50M	177	1390869	1390693	1390870	V350256906L2C002R07200634235_chr1_1390692	4	25	CCCG	GGTC
V350256906L2C002R07200991046	chr1	924538	50M	183	924721	924539	924722	V350256906L2C002R07200991046_chr1_924538	26	3	GGGT	CCCG
V350256906L2C002R07201036417	chr1	535331	50M	213	535544	535332	535545	V350256906L2C002R07201036417_chr1_535331	30	13	tgtg	gctg
V350256906L2C002R07201177234	chr1	1212790	50M	181	1212971	1212791	1212972	V350256906L2C002R07201177234_chr1_1212790	55	3	ccat	ccaa
V350256906L2C003R00300226536	chr1	706511	50M	158	706669	706512	706670	V350256906L2C003R00300226536_chr1_706511	211	53	GAGC	GGCG
V350256906L2C003R00300232967	chr1	393310	50M	153	393463	393311	393464	V350256906L2C003R00300232967_chr1_393310	0	23	acaa	tagg
V350256906L2C003R00300511235	chr1	71030	50M	172	71202	71031	71203	V350256906L2C003R00300511235_chr1_71030	37	33	CCCA	AATC
V350256906L2C003R00300538721	chr1	1361075	50M	187	1361262	1361076	1361263	V350256906L2C003R00300538721_chr1_1361075	44	7	AGCG	CCTG
V350256906L2C003R00300598092	chr1	966647	50M	165	966812	966648	966813	V350256906L2C003R00300598092_chr1_966647	6	36	tgag	CAGG
V350256906L2C003R00300903369	chr1	1322632	50M	168	1322800	1322633	1322801	V350256906L2C003R00300903369_chr1_1322632	20	94	CCCA	CACA
V350256906L2C003R00400164281	chr1	1184906	50M	235	1185141	1184907	1185142	V350256906L2C003R00400164281_chr1_1184906	122	48	CCCT	cttt
V350256906L2C003R00400175955	chr1	664885	50M	167	665052	664886	665053	V350256906L2C003R00400175955_chr1_664885	41	68	CCAA	CCTC
V350256906L2C003R00400285872	chr1	754260	50M	177	754437	754261	754438	V350256906L2C003R00400285872_chr1_754260	0	159	CTCA	CCAC
V350256906L2C003R00400342235	chr1	750726	50M	189	750915	750727	750916	V350256906L2C003R00400342235_chr1_750726	214	25	aaat	CCCC
V350256906L2C003R00400839246	chr1	885120	50M	103	885223	885121	885224	V350256906L2C003R00400839246_chr1_885120	56	34	CCAA	GTTC
V350256906L2C003R00400984431	chr1	716246	50M	202	716448	716247	716449	V350256906L2C003R00400984431_chr1_716246	20	59	GTCA	CATA
V350256906L2C003R00401020892	chr1	340372	50M	187	340559	340373	340560	V350256906L2C003R00401020892_chr1_340372	0	6	GAGG	CCCA
V350256906L2C003R00401030163	chr1	826785	50M	193	826978	826786	826979	V350256906L2C003R00401030163_chr1_826785	40	95	ttaa	caga
V350256906L2C003R00401149426	chr1	704000	50M	161	704161	704001	704162	V350256906L2C003R00401149426_chr1_704000	4	0	ACCA	CCAT
V350256906L2C003R00500127753	chr1	55056	50M	199	55255	55057	55256	V350256906L2C003R00500127753_chr1_55056	276	77	tact	agac
V350256906L2C003R00500706747	chr1	967780	50M	174	967954	967781	967955	V350256906L2C003R00500706747_chr1_967780	209	66	GGGC	GCCT
V350256906L2C003R00500772373	chr1	534050	50M	160	534210	534051	534211	V350256906L2C003R00500772373_chr1_534050	93	39	CCGT	gctg
V350256906L2C003R00500796174	chr1	258520	50M	173	258693	258521	258694	V350256906L2C003R00500796174_chr1_258520	1	18	taac	ggtt
V350256906L2C003R00501389537	chr1	631091	50M	185	631276	631092	631277	V350256906L2C003R00501389537_chr1_631091	58	73	GGTA	tact
V350256906L2C003R00600129150	chr1	708402	50M	172	708574	708403	708575	V350256906L2C003R00600129150_chr1_708402	16	2	CCCT	AGGC
V350256906L2C003R00600437512	chr1	1329759	50M	164	1329923	1329760	1329924	V350256906L2C003R00600437512_chr1_1329759	0	13	TTCA	cctg
V350256906L2C003R00600535380	chr1	1330282	50M	181	1330463	1330283	1330464	V350256906L2C003R00600535380_chr1_1330282	4	12	caaa	tttt
V350256906L2C003R00600866799	chr1	761491	50M	165	761656	761492	761657	V350256906L2C003R00600866799_chr1_761491	5	0	CTTC	ACCT
V350256906L2C003R00601161994	chr1	789372	50M	167	789539	789373	789540	V350256906L2C003R00601161994_chr1_789372	260	100	CCAT	CTCA
V350256906L2C003R00700136206	chr1	639162	50M	162	639324	639163	639325	V350256906L2C003R00700136206_chr1_639162	43	22	AATT	AGAA
V350256906L2C003R00700591542	chr1	345919	50M	171	346090	345920	346091	V350256906L2C003R00700591542_chr1_345919	64	71	ctca	atgt
V350256906L2C003R00700669474	chr1	851518	50M	174	851692	851519	851693	V350256906L2C003R00700669474_chr1_851518	49	53	CCCG	CAGG
V350256906L2C003R00800493306	chr1	254370	50M	194	254564	254371	254565	V350256906L2C003R00800493306_chr1_254370	0	1	ctcc	ccat
V350256906L2C003R00800495648	chr1	861989	50M	161	862150	861990	862151	V350256906L2C003R00800495648_chr1_861989	49	35	CCCA	CTTT
V350256906L2C003R00801054828	chr1	548062	50M	149	548211	548063	548212	V350256906L2C003R00801054828_chr1_548062	1	57	agtg	gcag
V350256906L2C003R00900195260	chr1	1072533	50M	103	1072636	1072534	1072637	V350256906L2C003R00900195260_chr1_1072533	7	0	GGTC	CCCC
V350256906L2C003R00900407955	chr1	1129625	50M	155	1129780	1129626	1129781	V350256906L2C003R00900407955_chr1_1129625	0	49	aagt	gtat
V350256906L2C003R00900455077	chr1	355006	7M1D43M	159	355165	355007	355166	V350256906L2C003R00900455077_chr1_355006	60	219	ggta	catc
V350256906L2C003R00900725925	chr1	1071235	50M	166	1071401	1071236	1071402	V350256906L2C003R00900725925_chr1_1071235	15	129	agat	GCAA
V350256906L2C003R00901053806	chr1	807920	50M	124	808044	807921	808045	V350256906L2C003R00901053806_chr1_807920	12	13	CCAC	AACC
V350256906L2C003R00901133474	chr1	813886	50M	206	814092	813887	814093	V350256906L2C003R00901133474_chr1_813886	119	76	CCAG	CACA
V350256906L2C003R00901231033	chr1	107253	35M1D15M	155	107408	107254	107409	V350256906L2C003R00901231033_chr1_107253	1	60	ATAT	AACA
V350256906L2C003R01000329231	chr1	548992	50M	143	549135	548993	549136	V350256906L2C003R01000329231_chr1_548992	48	48	GTTT	TGAG
V350256906L2C003R01000641952	chr1	143998	50M	192	144190	143999	144191	V350256906L2C003R01000641952_chr1_143998	12	204	CTGG	ccta
V350256906L2C003R01001186533	chr1	870382	50M	148	870530	870383	870531	V350256906L2C003R01001186533_chr1_870382	8	156	CCCT	CCCT
V350256906L2C003R01001229689	chr1	88049	50M	175	88224	88050	88225	V350256906L2C003R01001229689_chr1_88049	0	0	GAGA	gcat
V350256906L2C003R01100189469	chr1	331605	50M	176	331781	331606	331782	V350256906L2C003R01100189469_chr1_331605	56	55	CCCT	CCAC
V350256906L2C003R01100478585	chr1	168075	50M	171	168246	168076	168247	V350256906L2C003R01100478585_chr1_168075	102	12	CAAG	TATG
V350256906L2C003R01100591904	chr1	1201909	50M	182	1202091	1201910	1202092	V350256906L2C003R01100591904_chr1_1201909	5	0	aaaa	ggac
V350256906L2C003R01100990704	chr1	926892	50M	181	927073	926893	927074	V350256906L2C003R01100990704_chr1_926892	130	23	tcat	agcc
V350256906L2C003R01101195470	chr1	53810	50M	159	53969	53811	53970	V350256906L2C003R01101195470_chr1_53810	118	0	AGAA	TTTA
V350256906L2C003R01101195471	chr1	53810	50M	159	53969	53811	53970	V350256906L2C003R01101195471_chr1_53810	118	0	AGAA	TTTA
V350256906L2C003R01101352929	chr1	126866	50M	168	127034	126867	127035	V350256906L2C003R01101352929_chr1_126866	38	61	tatg	GAAA
V350256906L2C003R01200146988	chr1	1164003	50M	146	1164149	1164004	1164150	V350256906L2C003R01200146988_chr1_1164003	41	77	CAGG	CGTC
V350256906L2C003R01200401905	chr1	784560	50M	169	784729	784561	784730	V350256906L2C003R01200401905_chr1_784560	32	51	CTCC	TGTA
V350256906L2C003R01200536954	chr1	665129	50M	168	665297	665130	665298	V350256906L2C003R01200536954_chr1_665129	27	3	TGTA	ccac
V350256906L2C003R01200558654	chr1	1267663	50M	182	1267845	1267664	1267846	V350256906L2C003R01200558654_chr1_1267663	60	101	CGCG	CCCC
V350256906L2C003R01200737174	chr1	1132044	50M	155	1132199	1132045	1132200	V350256906L2C003R01200737174_chr1_1132044	49	18	TGGG	ACTG
V350256906L2C003R01201095117	chr1	1216621	50M	165	1216786	1216622	1216787	V350256906L2C003R01201095117_chr1_1216621	17	91	GAAG	TGAG
V350256906L2C003R01300186465	chr1	884390	47M3S	176	884566	884391	884567	V350256906L2C003R01300186465_chr1_884390	12	18	GGGG	GGCT
V350256906L2C003R01300554314	chr1	1161503	50M	167	1161670	1161504	1161671	V350256906L2C003R01300554314_chr1_1161503	146	164	ccag	TAGG
V350256906L2C003R01300736654	chr1	392529	50M	193	392722	392530	392723	V350256906L2C003R01300736654_chr1_392529	22	86	ccta	ctaa
V350256906L2C003R01300876345	chr1	63811	50M	169	63980	63812	63981	V350256906L2C003R01300876345_chr1_63811	55	53	CTTT	CTAA
V350256906L2C003R01300956794	chr1	635304	50M	165	635469	635305	635470	V350256906L2C003R01300956794_chr1_635304	20	13	tgct	cgag
V350256906L2C003R01301114869	chr1	1327762	50M	167	1327929	1327763	1327930	V350256906L2C003R01301114869_chr1_1327762	13	47	CATG	CCCT
V350256906L2C003R01301352322	chr1	644805	50M	161	644966	644806	644967	V350256906L2C003R01301352322_chr1_644805	0	144	caaa	ttat
V350256906L2C003R01400047559	chr1	550045	50M	133	550178	550046	550179	V350256906L2C003R01400047559_chr1_550045	34	47	AGCA	gacc
V350256906L2C003R01400292503	chr1	25463	50M	167	25630	25464	25631	V350256906L2C003R01400292503_chr1_25463	252	109	AGGA	CTTT
V350256906L2C003R01400393849	chr1	643575	50M	195	643770	643576	643771	V350256906L2C003R01400393849_chr1_643575	32	81	ctag	ttct
V350256906L2C003R01400596009	chr1	916813	50M	216	917029	916814	917030	V350256906L2C003R01400596009_chr1_916813	40	18	CCTT	CCTG
V350256906L2C003R01400959883	chr1	611117	50M	177	611294	611118	611295	V350256906L2C003R01400959883_chr1_611117	71	58	CTCC	gcAA
V350256906L2C003R01401374729	chr1	1315120	50M	169	1315289	1315121	1315290	V350256906L2C003R01401374729_chr1_1315120	0	12	aaaa	cttt
V350256906L2C003R01500165640	chr1	626985	50M	207	627192	626986	627193	V350256906L2C003R01500165640_chr1_626985	56	65	CATT	GGAG
V350256906L2C003R01501084094	chr1	15636	50M	107	15743	15637	15744	V350256906L2C003R01501084094_chr1_15636	213	320	CTGG	CCCC
V350256906L2C003R01600500896	chr1	30495	50M	123	30618	30496	30619	V350256906L2C003R01600500896_chr1_30495	48	52	agca	TGTT
V350256906L2C003R01600564949	chr1	1140804	50M	198	1141002	1140805	1141003	V350256906L2C003R01600564949_chr1_1140804	0	10	AGCA	CCCT
V350256906L2C003R01600938688	chr1	327321	50M	164	327485	327322	327486	V350256906L2C003R01600938688_chr1_327321	66	0	CAGT	GGAG
V350256906L2C003R01700101126	chr1	336118	50M	172	336290	336119	336291	V350256906L2C003R01700101126_chr1_336118	39	44	CAGA	CACA
V350256906L2C003R01700358882	chr1	1270780	50M	162	1270942	1270781	1270943	V350256906L2C003R01700358882_chr1_1270780	48	67	CCAG	CCAG
V350256906L2C003R01700627317	chr1	746914	50M	168	747082	746915	747083	V350256906L2C003R01700627317_chr1_746914	82	93	AGGT	CTCC
V350256906L2C003R01700788804	chr1	729680	50M	174	729854	729681	729855	V350256906L2C003R01700788804_chr1_729680	247	118	AGCT	CGCA
V350256906L2C003R01701092241	chr1	259003	50M	160	259163	259004	259164	V350256906L2C003R01701092241_chr1_259003	31	57	CAGC	TCCA
V350256906L2C003R01701218165	chr1	468360	50M	171	468531	468361	468532	V350256906L2C003R01701218165_chr1_468360	17	68	ggtt	cttt
V350256906L2C003R01800191461	chr1	750160	50M	177	750337	750161	750338	V350256906L2C003R01800191461_chr1_750160	16	68	TGCA	GAAG
V350256906L2C003R01800412443	chr1	849956	50M	169	850125	849957	850126	V350256906L2C003R01800412443_chr1_849956	13	0	gctg	cgaa
V350256906L2C003R01800416767	chr1	352897	50M	200	353097	352898	353098	V350256906L2C003R01800416767_chr1_352897	29	46	tctt	tgaa
V350256906L2C003R01800583947	chr1	745830	50M	172	746002	745831	746003	V350256906L2C003R01800583947_chr1_745830	20	35	GAGA	GTAA
V350256906L2C003R01800815750	chr1	1043125	50M	145	1043270	1043126	1043271	V350256906L2C003R01800815750_chr1_1043125	58	27	tccc	tggt
V350256906L2C003R01801027208	chr1	124700	50M	226	124926	124701	124927	V350256906L2C003R01801027208_chr1_124700	185	128	gcca	CCTA
V350256906L2C003R01801049544	chr1	389337	50M	168	389505	389338	389506	V350256906L2C003R01801049544_chr1_389337	0	0	ctga	tgtc
V350256906L2C003R01801283277	chr1	76206	50M	175	76381	76207	76382	V350256906L2C003R01801283277_chr1_76206	0	159	tcac	tctc
V350256906L2C003R01801398221	chr1	822832	50M	141	822973	822833	822974	V350256906L2C003R01801398221_chr1_822832	50	34	actc	atga
V350256906L2C003R01900135970	chr1	57738	50M	177	57915	57739	57916	V350256906L2C003R01900135970_chr1_57738	33	57	CTTC	TAAA
V350256906L2C003R01900144539	chr1	748884	50M	147	749031	748885	749032	V350256906L2C003R01900144539_chr1_748884	0	16	ACCT	GATT
V350256906L2C003R01900376953	chr1	555750	50M	177	555927	555751	555928	V350256906L2C003R01900376953_chr1_555750	10	20	cact	cgtt
V350256906L2C003R01900607196	chr1	1317647	26S24M	162	1317809	1317648	1317810	V350256906L2C003R01900607196_chr1_1317647	77	239	ccag	CCTC
V350256906L2C003R01900815447	chr1	973854	50M	177	974031	973855	974032	V350256906L2C003R01900815447_chr1_973854	0	0	CATC	CCCC
V350256906L2C003R01901159602	chr1	1389219	50M	158	1389377	1389220	1389378	V350256906L2C003R01901159602_chr1_1389219	1	34	ccat	CCTG
V350256906L2C003R01901405953	chr1	682042	50M	163	682205	682043	682206	V350256906L2C003R01901405953_chr1_682042	24	119	aaaa	cttc
V350256906L2C003R02000475831	chr1	726339	20S30M	160	726499	726340	726500	V350256906L2C003R02000475831_chr1_726339	48	22	gaat	ttgc
V350256906L2C003R02000967279	chr1	1159991	50M	165	1160156	1159992	1160157	V350256906L2C003R02000967279_chr1_1159991	65	50	ACAC	cgcc
V350256906L2C003R02001200334	chr1	1305252	50M	178	1305430	1305253	1305431	V350256906L2C003R02001200334_chr1_1305252	78	67	cact	ggag
V350256906L2C003R02001267151	chr1	790156	50M	130	790286	790157	790287	V350256906L2C003R02001267151_chr1_790156	70	0	TGAA	GTGC
V350256906L2C003R02100305557	chr1	576786	50M	157	576943	576787	576944	V350256906L2C003R02100305557_chr1_576786	53	64	GAAT	CTGG
V350256906L2C003R02101056870	chr1	410339	50M	148	410487	410340	410488	V350256906L2C003R02101056870_chr1_410339	227	306	TACA	CTAG
V350256906L2C003R02101305665	chr1	872951	50M	174	873125	872952	873126	V350256906L2C003R02101305665_chr1_872951	0	67	CCAG	CCAC
V350256906L2C003R02101327156	chr1	792254	50M	171	792425	792255	792426	V350256906L2C003R02101327156_chr1_792254	10	4	CAAG	GGAG
V350256906L2C003R02200283994	chr1	393113	50M	181	393294	393114	393295	V350256906L2C003R02200283994_chr1_393113	43	15	ctca	tgtg
V350256906L2C003R02200346143	chr1	767703	50M	168	767871	767704	767872	V350256906L2C003R02200346143_chr1_767703	51	59	GCCA	CGTG
V350256906L2C003R02200716680	chr1	23737	50M	137	23874	23738	23875	V350256906L2C003R02200716680_chr1_23737	62	0	TAGA	ccta
V350256906L2C003R02201049398	chr1	46175	50M	178	46353	46176	46354	V350256906L2C003R02201049398_chr1_46175	0	89	ccat	GAAG
V350256906L2C003R02201232553	chr1	1084338	50M	165	1084503	1084339	1084504	V350256906L2C003R02201232553_chr1_1084338	0	0	CGGA	CTGG
V350256906L2C003R02300284196	chr1	619043	50M	166	619209	619044	619210	V350256906L2C003R02300284196_chr1_619043	75	46	ggca	tcaa
V350256906L2C003R02300536387	chr1	567362	50M	122	567484	567363	567485	V350256906L2C003R02300536387_chr1_567362	144	266	CATA	TCCT
V350256906L2C003R02300569651	chr1	1132275	50M	172	1132447	1132276	1132448	V350256906L2C003R02300569651_chr1_1132275	58	64	AACT	CTCA
V350256906L2C003R02300684319	chr1	59089	50M	159	59248	59090	59249	V350256906L2C003R02300684319_chr1_59089	0	0	tgag	GGGA
V350256906L2C003R02300816770	chr1	1425543	50M	162	1425705	1425544	1425706	V350256906L2C003R02300816770_chr1_1425543	61	77	AAAA	CGTC
V350256906L2C003R02300852502	chr1	1395432	18M1I31M	157	1395589	1395433	1395590	V350256906L2C003R02300852502_chr1_1395432	52	43	CTGG	ccca
V350256906L2C003R02300917095	chr1	996990	50M	171	997161	996991	997162	V350256906L2C003R02300917095_chr1_996990	27	23	cctg	GAGG
V350256906L2C003R02300975771	chr1	107369	50M	165	107534	107370	107535	V350256906L2C003R02300975771_chr1_107369	21	3	TGTA	ctct
V350256906L2C003R02300989391	chr1	327256	50M	161	327417	327257	327418	V350256906L2C003R02300989391_chr1_327256	13	0	AGAC	AACA
V350256906L2C003R02301077087	chr1	917695	50M	160	917855	917696	917856	V350256906L2C003R02301077087_chr1_917695	0	2	CGCT	CCAG
V350256906L2C003R02301141639	chr1	883200	50M	155	883355	883201	883356	V350256906L2C003R02301141639_chr1_883200	65	50	TGAG	GGCT
V350256906L2C003R02301143305	chr1	945162	50M	138	945300	945163	945301	V350256906L2C003R02301143305_chr1_945162	47	66	gctt	ctgg
V350256906L2C003R02400149259	chr1	798825	50M	183	799008	798826	799009	V350256906L2C003R02400149259_chr1_798825	49	59	CGGA	taca
V350256906L2C003R02400161140	chr1	374614	50M	160	374774	374615	374775	V350256906L2C003R02400161140_chr1_374614	138	193	cctt	ccac
V350256906L2C003R02400224198	chr1	850304	50M	145	850449	850305	850450	V350256906L2C003R02400224198_chr1_850304	0	32	ggca	agcc
V350256906L2C003R02400229631	chr1	1196680	50M	181	1196861	1196681	1196862	V350256906L2C003R02400229631_chr1_1196680	113	29	GAAG	CCCC
V350256906L2C003R02400929805	chr1	773735	50M	195	773930	773736	773931	V350256906L2C003R02400929805_chr1_773735	24	43	agct	tgtg
V350256906L2C003R02401143558	chr1	1327159	50M	190	1327349	1327160	1327350	V350256906L2C003R02401143558_chr1_1327159	1	175	CTAA	CATG
V350256906L2C003R02401272731	chr1	237477	50M	131	237608	237478	237609	V350256906L2C003R02401272731_chr1_237477	20	2	gcca	CCTT
V350256906L2C003R02401366619	chr1	731389	50M	172	731561	731390	731562	V350256906L2C003R02401366619_chr1_731389	0	0	ataa	TAGG
V350256906L2C003R02500140552	chr1	1071377	50M	192	1071569	1071378	1071570	V350256906L2C003R02500140552_chr1_1071377	105	63	CGGA	CCAG
V350256906L2C003R02500190823	chr1	1242049	50M	147	1242196	1242050	1242197	V350256906L2C003R02500190823_chr1_1242049	17	147	cacc	CGCG
V350256906L2C003R02500637886	chr1	1059749	50M	156	1059905	1059750	1059906	V350256906L2C003R02500637886_chr1_1059749	283	127	CCAG	TGAG
V350256906L2C003R02500903291	chr1	726188	46M4S	164	726352	726189	726353	V350256906L2C003R02500903291_chr1_726188	61	59	gaat	ttcc
V350256906L2C003R02500934814	chr1	921492	50M	165	921657	921493	921658	V350256906L2C003R02500934814_chr1_921492	10	122	caga	ctac
V350256906L2C003R02501131017	chr1	958147	50M	151	958298	958148	958299	V350256906L2C003R02501131017_chr1_958147	61	1	GGGA	CCAC
V350256906L2C003R02600287867	chr1	428127	50M	167	428294	428128	428295	V350256906L2C003R02600287867_chr1_428127	69	31	CTTA	ccta
V350256906L2C003R02600454506	chr1	1288866	50M	200	1289066	1288867	1289067	V350256906L2C003R02600454506_chr1_1288866	35	7	CCAG	CCAC
V350256906L2C003R02600701540	chr1	1139105	50M	171	1139276	1139106	1139277	V350256906L2C003R02600701540_chr1_1139105	0	21	CCCA	GGGC
V350256906L2C003R02600926034	chr1	1275701	50M	180	1275881	1275702	1275882	V350256906L2C003R02600926034_chr1_1275701	52	95	GGAG	CAGC
V350256906L2C003R02600969107	chr1	81170	50M	183	81353	81171	81354	V350256906L2C003R02600969107_chr1_81170	42	55	gtgc	ctaa
V350256906L2C003R02600999792	chr1	762550	50M	124	762674	762551	762675	V350256906L2C003R02600999792_chr1_762550	0	61	GACG	GTCC
V350256906L2C003R02700005749	chr1	672092	50M	157	672249	672093	672250	V350256906L2C003R02700005749_chr1_672092	69	190	ccat	cacc
V350256906L2C003R02700537560	chr1	1172432	50M	226	1172658	1172433	1172659	V350256906L2C003R02700537560_chr1_1172432	201	0	CCTC	CCTC
V350256906L2C003R02700587465	chr1	398881	50M	168	399049	398882	399050	V350256906L2C003R02700587465_chr1_398881	184	50	cata	tgat
V350256906L2C003R02701164668	chr1	558492	50M	154	558646	558493	558647	V350256906L2C003R02701164668_chr1_558492	65	22	GGTT	TCCT
V350256906L2C003R02701377538	chr1	376679	50M	164	376843	376680	376844	V350256906L2C003R02701377538_chr1_376679	329	236	tatt	cctg
V350256906L2C003R02800172090	chr1	1019875	50M	174	1020049	1019876	1020050	V350256906L2C003R02800172090_chr1_1019875	60	64	GCAG	GTTG
V350256906L2C003R02800334643	chr1	659485	50M	120	659605	659486	659606	V350256906L2C003R02800334643_chr1_659485	67	18	CTTT	GGAA
V350256906L2C003R02800453959	chr1	937937	50M	162	938099	937938	938100	V350256906L2C003R02800453959_chr1_937937	57	58	acca	ggtg
V350256906L2C003R02800592815	chr1	1123085	50M	160	1123245	1123086	1123246	V350256906L2C003R02800592815_chr1_1123085	66	64	gacc	agtg
V350256906L2C003R02800723012	chr1	718136	50M	178	718314	718137	718315	V350256906L2C003R02800723012_chr1_718136	142	0	tgat	cagt
V350256906L2C003R02800741805	chr1	1033403	50M	150	1033553	1033404	1033554	V350256906L2C003R02800741805_chr1_1033403	0	26	cagt	ctta
V350256906L2C003R02801169101	chr1	808800	50M	184	808984	808801	808985	V350256906L2C003R02801169101_chr1_808800	50	100	ACCC	CCAC
V350256906L2C003R02801251828	chr1	58490	50M	171	58661	58491	58662	V350256906L2C003R02801251828_chr1_58490	90	259	CTTC	GGAC
V350256906L2C003R02801287054	chr1	69067	50M	191	69258	69068	69259	V350256906L2C003R02801287054_chr1_69067	57	47	TCAA	AGCA
V350256906L2C003R02801381736	chr1	898639	50M	140	898779	898640	898780	V350256906L2C003R02801381736_chr1_898639	0	26	CCTG	GCCA
V350256906L2C003R02900048280	chr1	582215	50M	149	582364	582216	582365	V350256906L2C003R02900048280_chr1_582215	70	23	CATA	TACA
V350256906L2C003R02900290661	chr1	254939	50M	163	255102	254940	255103	V350256906L2C003R02900290661_chr1_254939	2	0	agag	TGTT
V350256906L2C003R02900313828	chr1	172039	50M	168	172207	172040	172208	V350256906L2C003R02900313828_chr1_172039	15	169	GAGC	TACC
V350256906L2C003R02900647010	chr1	717712	50M	152	717864	717713	717865	V350256906L2C003R02900647010_chr1_717712	46	60	tcat	tcta
V350256906L2C003R02900857745	chr1	702118	50M	202	702320	702119	702321	V350256906L2C003R02900857745_chr1_702118	19	158	cact	cgtc
V350256906L2C003R02900891518	chr1	724932	40M10S	154	725086	724933	725087	V350256906L2C003R02900891518_chr1_724932	0	116	gaat	attc
V350256906L2C003R02901108974	chr1	557673	50M	160	557833	557674	557834	V350256906L2C003R02901108974_chr1_557673	4	0	CTAC	CTCA
V350256906L2C003R02901118394	chr1	15140	50M	192	15332	15141	15333	V350256906L2C003R02901118394_chr1_15140	34	40	CTGT	tgcc
V350256906L2C003R02901322399	chr1	733381	50M	195	733576	733382	733577	V350256906L2C003R02901322399_chr1_733381	166	0	ACTG	AGTC
V350256906L2C003R03000113895	chr1	854529	50M	192	854721	854530	854722	V350256906L2C003R03000113895_chr1_854529	18	19	cggt	CCTC
V350256906L2C003R03000197164	chr1	672148	50M	147	672295	672149	672296	V350256906L2C003R03000197164_chr1_672148	125	144	cacc	ccac
V350256906L2C003R03000491559	chr1	930022	50M	163	930185	930023	930186	V350256906L2C003R03000491559_chr1_930022	91	26	ccag	ATTT
V350256906L2C003R03000545644	chr1	260284	50M	167	260451	260285	260452	V350256906L2C003R03000545644_chr1_260284	52	31	gatg	TTTC
V350256906L2C003R03000846752	chr1	1129431	50M	176	1129607	1129432	1129608	V350256906L2C003R03000846752_chr1_1129431	0	13	gggg	tgta
V350256906L2C003R03100497375	chr1	1184157	50M	169	1184326	1184158	1184327	V350256906L2C003R03100497375_chr1_1184157	11	40	GGGA	CCCG
V350256906L2C003R03101012694	chr1	943848	50M	184	944032	943849	944033	V350256906L2C003R03101012694_chr1_943848	35	102	agat	tggg
V350256906L2C003R03101196930	chr1	330110	50M	185	330295	330111	330296	V350256906L2C003R03101196930_chr1_330110	16	67	GGAA	TGCT
V350256906L2C003R03101251642	chr1	228577	50M	142	228719	228578	228720	V350256906L2C003R03101251642_chr1_228577	61	33	CCTG	CCTT
V350256906L2C003R03101375766	chr1	861647	50M	170	861817	861648	861818	V350256906L2C003R03101375766_chr1_861647	50	61	TCCC	CCCC
V350256906L2C003R03101396136	chr1	87565	50M	180	87745	87566	87746	V350256906L2C003R03101396136_chr1_87565	66	44	CAGA	TGCT
V350256906L2C003R03200042529	chr1	695427	50M	187	695614	695428	695615	V350256906L2C003R03200042529_chr1_695427	236	49	CTTC	CCTC
V350256906L2C003R03200160819	chr1	259038	50M	197	259235	259039	259236	V350256906L2C003R03200160819_chr1_259038	0	0	GATA	TAAG
V350256906L2C003R03200448211	chr1	601669	50M	161	601830	601670	601831	V350256906L2C003R03200448211_chr1_601669	13	82	tgaa	actt
V350256906L2C003R03200485388	chr1	1014343	46M1D4M	198	1014541	1014344	1014542	V350256906L2C003R03200485388_chr1_1014343	23	221	GCTA	GCAC
V350256906L2C003R03200544095	chr1	72181	50M	178	72359	72182	72360	V350256906L2C003R03200544095_chr1_72181	36	214	GGTC	tcac
V350256906L2C003R03200780236	chr1	537506	50M	262	537768	537507	537769	V350256906L2C003R03200780236_chr1_537506	84	17	TGCC	GCAG
V350256906L2C003R03201067695	chr1	1149482	50M	184	1149666	1149483	1149667	V350256906L2C003R03201067695_chr1_1149482	41	58	CCCA	CCCC
V350256906L2C003R03201127787	chr1	1199149	50M	183	1199332	1199150	1199333	V350256906L2C003R03201127787_chr1_1199149	74	61	gatc	ggca
V350256906L2C003R03201197986	chr1	695546	50M	182	695728	695547	695729	V350256906L2C003R03201197986_chr1_695546	117	8	CCCA	GGCT
V350256906L2C003R03300081555	chr1	1218071	50M	188	1218259	1218072	1218260	V350256906L2C003R03300081555_chr1_1218071	145	1	TGAG	gggg
V350256906L2C003R03300902862	chr1	34934	50M	188	35122	34935	35123	V350256906L2C003R03300902862_chr1_34934	30	29	GCTG	CCCG
V350256906L2C003R03400019616	chr1	105380	50M	159	105539	105381	105540	V350256906L2C003R03400019616_chr1_105380	66	30	TAAC	TAAT
V350256906L2C003R03400259705	chr1	1244624	50M	157	1244781	1244625	1244782	V350256906L2C003R03400259705_chr1_1244624	0	12	CAAC	CACA
V350256906L2C003R03400659605	chr1	1292926	50M	169	1293095	1292927	1293096	V350256906L2C003R03400659605_chr1_1292926	180	37	cctg	cctc
V350256906L2C003R03400843832	chr1	786227	50M	163	786390	786228	786391	V350256906L2C003R03400843832_chr1_786227	14	177	ccat	ccat
V350256906L2C003R03401205459	chr1	853473	50M	192	853665	853474	853666	V350256906L2C003R03401205459_chr1_853473	17	15	CAGA	CACA
V350256906L2C003R03500020677	chr1	253066	50M	170	253236	253067	253237	V350256906L2C003R03500020677_chr1_253066	0	0	AACC	CCAT
V350256906L2C003R03500103571	chr1	1133069	50M	162	1133231	1133070	1133232	V350256906L2C003R03500103571_chr1_1133069	29	62	CCCC	CCCC
V350256906L2C003R03500199272	chr1	259460	50M	170	259630	259461	259631	V350256906L2C003R03500199272_chr1_259460	11	0	CTTG	GGTT
V350256906L2C003R03500774335	chr1	1131890	50M	199	1132089	1131891	1132090	V350256906L2C003R03500774335_chr1_1131890	61	60	CAGG	TGTC
V350256906L2C003R03500882327	chr1	785171	50M	181	785352	785172	785353	V350256906L2C003R03500882327_chr1_785171	0	14	aatc	CAGC
V350256906L2C003R03500931369	chr1	32934	50M	184	33118	32935	33119	V350256906L2C003R03500931369_chr1_32934	73	83	aggc	cttt
V350256906L2C003R03500939110	chr1	1213913	50M	169	1214082	1213914	1214083	V350256906L2C003R03500939110_chr1_1213913	51	53	ccct	gacc
V350256906L2C003R03501364244	chr1	260263	50M	155	260418	260264	260419	V350256906L2C003R03501364244_chr1_260263	31	0	taag	tcat
V350256906L2C003R03600116680	chr1	47252	50M	176	47428	47253	47429	V350256906L2C003R03600116680_chr1_47252	5	31	TGAT	CTTA
V350256906L2C003R03600587753	chr1	155278	50M	192	155470	155279	155471	V350256906L2C003R03600587753_chr1_155278	201	9	tata	GAAA
V350256906L2C003R03700196482	chr1	856897	50M	157	857054	856898	857055	V350256906L2C003R03700196482_chr1_856897	70	21	CACA	CACT
V350256906L2C003R03700637283	chr1	835533	50M	155	835688	835534	835689	V350256906L2C003R03700637283_chr1_835533	11	166	CCCT	ccac
V350256906L2C003R03700811729	chr1	821654	50M	210	821864	821655	821865	V350256906L2C003R03700811729_chr1_821654	38	21	ccag	tgcc
V350256906L2C003R03700863156	chr1	1172581	50M	157	1172738	1172582	1172739	V350256906L2C003R03700863156_chr1_1172581	52	62	GGAA	CTTC
V350256906L2C003R03701160887	chr1	877699	50M	168	877867	877700	877868	V350256906L2C003R03701160887_chr1_877699	114	35	CGGA	GGCC
V350256906L2C003R03800086011	chr1	1250326	50M	165	1250491	1250327	1250492	V350256906L2C003R03800086011_chr1_1250326	0	0	TGTC	GCCC
V350256906L2C003R03800218075	chr1	646542	50M	170	646712	646543	646713	V350256906L2C003R03800218075_chr1_646542	67	43	ACTT	TATT
V350256906L2C003R03800945014	chr1	1069888	50M	157	1070045	1069889	1070046	V350256906L2C003R03800945014_chr1_1069888	72	32	CTCC	GCAC
V350256906L2C003R03801396991	chr1	1069005	50M	167	1069172	1069006	1069173	V350256906L2C003R03801396991_chr1_1069005	0	14	CCAC	CTGT
V350256906L2C003R03900172937	chr1	117088	50M	170	117258	117089	117259	V350256906L2C003R03900172937_chr1_117088	24	44	caaa	gtta
V350256906L2C003R03900210774	chr1	383581	47M3S	174	383755	383582	383756	V350256906L2C003R03900210774_chr1_383581	7	0	ccca	agag
V350256906L2C003R03900456731	chr1	1186895	50M	124	1187019	1186896	1187020	V350256906L2C003R03900456731_chr1_1186895	0	5	ggct	gctc
V350256906L2C003R03900706346	chr1	725792	10S40M	152	725944	725793	725945	V350256906L2C003R03900706346_chr1_725792	91	19	gaat	tcca
V350256906L2C003R03901166343	chr1	103349	50M	132	103481	103350	103482	V350256906L2C003R03901166343_chr1_103349	41	39	catt	ccaa
V350256906L2C003R03901242131	chr1	792851	50M	179	793030	792852	793031	V350256906L2C003R03901242131_chr1_792851	198	83	CAGA	CCCA
V350256906L2C003R04000055444	chr1	107838	50M	169	108007	107839	108008	V350256906L2C003R04000055444_chr1_107838	40	59	cagg	ttaa
V350256906L2C003R04000833800	chr1	1274833	50M	157	1274990	1274834	1274991	V350256906L2C003R04000833800_chr1_1274833	21	60	ACGT	CCCC
V350256906L2C003R04000930817	chr1	645829	50M	152	645981	645830	645982	V350256906L2C003R04000930817_chr1_645829	45	197	cata	ccca
V350256906L2C003R04000994887	chr1	748617	50M	102	748719	748618	748720	V350256906L2C003R04000994887_chr1_748617	64	0	CCCC	CTGT
V350256906L2C003R04001382609	chr1	125365	50M	169	125534	125366	125535	V350256906L2C003R04001382609_chr1_125365	100	269	AATT	TAAC
V350256906L2C003R04100619087	chr1	1158722	50M	209	1158931	1158723	1158932	V350256906L2C003R04100619087_chr1_1158722	87	173	TCCC	CCCG
V350256906L2C003R04100829745	chr1	142706	50M	164	142870	142707	142871	V350256906L2C003R04100829745_chr1_142706	0	0	GTAC	ctgg
V350256906L2C003R04101219202	chr1	547493	50M	168	547661	547494	547662	V350256906L2C003R04101219202_chr1_547493	0	154	tgtt	CTAC
V350256906L2C003R04200488654	chr1	151774	50M	172	151946	151775	151947	V350256906L2C003R04200488654_chr1_151774	17	99	aaat	cttt
V350256906L2C003R04200627575	chr1	577250	50M	165	577415	577251	577416	V350256906L2C003R04200627575_chr1_577250	0	147	gccc	ACAA
V350256906L2C003R04200812792	chr1	1041254	50M	190	1041444	1041255	1041445	V350256906L2C003R04200812792_chr1_1041254	23	22	caaa	tgtt
V350256906L2C003R04200906354	chr1	640126	50M	180	640306	640127	640307	V350256906L2C003R04200906354_chr1_640126	51	19	tata	ggcc
V350256906L2C003R04200920207	chr1	733306	50M	171	733477	733307	733478	V350256906L2C003R04200920207_chr1_733306	241	70	AGAA	TAAG
V350256906L2C003R04201162915	chr1	591130	50M	179	591309	591131	591310	V350256906L2C003R04201162915_chr1_591130	145	41	ACCA	tgta
V350256906L2C003R04201343850	chr1	1023778	50M	184	1023962	1023779	1023963	V350256906L2C003R04201343850_chr1_1023778	20	0	TCCC	GGCT
V350256906L2C003R04201380429	chr1	76071	50M	170	76241	76072	76242	V350256906L2C003R04201380429_chr1_76071	66	19	taaa	tatg
V350256906L2C003R04300170943	chr1	317834	50M	121	317955	317835	317956	V350256906L2C003R04300170943_chr1_317834	0	119	GCAT	cctc
V350256906L2C003R04300326936	chr1	235871	50M	123	235994	235872	235995	V350256906L2C003R04300326936_chr1_235871	0	26	gaca	AAAG
V350256906L2C003R04300635756	chr1	1215378	50M	174	1215552	1215379	1215553	V350256906L2C003R04300635756_chr1_1215378	55	229	ATGG	tatt
V350256906L2C003R04301257129	chr1	599681	50M	163	599844	599682	599845	V350256906L2C003R04301257129_chr1_599681	39	31	attg	acaa
V350256906L2C003R04400330095	chr1	902206	50M	178	902384	902207	902385	V350256906L2C003R04400330095_chr1_902206	57	59	CTGT	TGCG
V350256906L2C003R04400504306	chr1	22369	50M	156	22525	22370	22526	V350256906L2C003R04400504306_chr1_22369	56	46	GGTT	CCTA
V350256906L2C003R04400845158	chr1	972097	50M	224	972321	972098	972322	V350256906L2C003R04400845158_chr1_972097	52	50	CCAA	CCCT
V350256906L2C003R04401335201	chr1	136775	50M	174	136949	136776	136950	V350256906L2C003R04401335201_chr1_136775	293	211	GGCC	GCCC
V350256906L2C003R04500352983	chr1	551501	50M	207	551708	551502	551709	V350256906L2C003R04500352983_chr1_551501	14	221	agaa	taag
V350256906L2C003R04500756155	chr1	332528	50M	169	332697	332529	332698	V350256906L2C003R04500756155_chr1_332528	20	0	ccga	taac
V350256906L2C003R04500823561	chr1	1253740	50M	208	1253948	1253741	1253949	V350256906L2C003R04500823561_chr1_1253740	0	1	aatg	ccca
V350256906L2C003R04501174008	chr1	664421	50M	160	664581	664422	664582	V350256906L2C003R04501174008_chr1_664421	239	161	CCTG	CATC
V350256906L2C003R04600056580	chr1	1071712	50M	166	1071878	1071713	1071879	V350256906L2C003R04600056580_chr1_1071712	56	126	CCTC	CCTG
V350256906L2C003R04600232221	chr1	656745	50M	162	656907	656746	656908	V350256906L2C003R04600232221_chr1_656745	67	55	gaat	gcaa
V350256906L2C003R04600295504	chr1	917577	50M	183	917760	917578	917761	V350256906L2C003R04600295504_chr1_917577	81	52	AGCC	GGTC
V350256906L2C003R04600301998	chr1	1278287	50M	171	1278458	1278288	1278459	V350256906L2C003R04600301998_chr1_1278287	59	69	CTTC	GCCC
V350256906L2C003R04600883421	chr1	88822	50M	170	88992	88823	88993	V350256906L2C003R04600883421_chr1_88822	216	107	ccCA	ggga
V350256906L2C003R04601168427	chr1	1182178	50M	174	1182352	1182179	1182353	V350256906L2C003R04601168427_chr1_1182178	25	49	cccg	TGCG
V350256906L2C003R04700193925	chr1	1365662	50M	154	1365816	1365663	1365817	V350256906L2C003R04700193925_chr1_1365662	19	67	cctt	CCCC
V350256906L2C003R04700256741	chr1	815014	50M	156	815170	815015	815171	V350256906L2C003R04700256741_chr1_815014	0	0	tgtt	acct
V350256906L2C003R04700305763	chr1	389393	50M	204	389597	389394	389598	V350256906L2C003R04700305763_chr1_389393	52	57	ctat	ccct
V350256906L2C003R04700506403	chr1	1071772	50M	190	1071962	1071773	1071963	V350256906L2C003R04700506403_chr1_1071772	116	42	GAGG	GTGC
V350256906L2C003R04700603774	chr1	1308167	50M	188	1308355	1308168	1308356	V350256906L2C003R04700603774_chr1_1308167	64	59	agga	ccca
V350256906L2C003R04701025726	chr1	1337441	50M	170	1337611	1337442	1337612	V350256906L2C003R04701025726_chr1_1337441	0	0	CTAA	CCTA
V350256906L2C003R04701294548	chr1	1207228	50M	168	1207396	1207229	1207397	V350256906L2C003R04701294548_chr1_1207228	15	0	cctg	cacc
V350256906L2C003R04800114829	chr1	410791	50M	182	410973	410792	410974	V350256906L2C003R04800114829_chr1_410791	2	0	CTTT	ttaa
V350256906L2C003R04800158574	chr1	784520	50M	174	784694	784521	784695	V350256906L2C003R04800158574_chr1_784520	72	48	TCAA	AAAA
V350256906L2C003R04800220524	chr1	1006976	50M	169	1007145	1006977	1007146	V350256906L2C003R04800220524_chr1_1006976	20	41	CTCT	CCCC
V350256906L2C003R04800514917	chr1	754657	50M	167	754824	754658	754825	V350256906L2C003R04800514917_chr1_754657	89	40	caga	GCCG
V350256906L2C003R04900158553	chr1	132701	50M	222	132923	132702	132924	V350256906L2C003R04900158553_chr1_132701	240	26	CCTT	CTCC
V350256906L2C003R04900377983	chr1	986034	50M	149	986183	986035	986184	V350256906L2C003R04900377983_chr1_986034	42	1	GGTC	CACG
V350256906L2C003R04900468381	chr1	356591	50M	192	356783	356592	356784	V350256906L2C003R04900468381_chr1_356591	42	143	tggT	tttt
V350256906L2C003R04900768107	chr1	1395118	50M	144	1395262	1395119	1395263	V350256906L2C003R04900768107_chr1_1395118	14	43	TGTG	CCAT
V350256906L2C003R04900805500	chr1	1278134	50M	175	1278309	1278135	1278310	V350256906L2C003R04900805500_chr1_1278134	22	37	CCAC	CCAG
V350256906L2C003R04901228807	chr1	741144	50M	204	741348	741145	741349	V350256906L2C003R04901228807_chr1_741144	0	18	AGTC	CGCA
V350256906L2C003R04901268365	chr1	111507	50M	181	111688	111508	111689	V350256906L2C003R04901268365_chr1_111507	61	41	CATA	TACT
V350256906L2C003R04901303601	chr1	1217541	50M	160	1217701	1217542	1217702	V350256906L2C003R04901303601_chr1_1217541	24	0	ggca	CCTG
V350256906L2C003R05000215076	chr1	1278825	50M	175	1279000	1278826	1279001	V350256906L2C003R05000215076_chr1_1278825	55	155	CCAG	GGCA
V350256906L2C003R05000228116	chr1	1052731	50M	168	1052899	1052732	1052900	V350256906L2C003R05000228116_chr1_1052731	40	39	AGGA	CTGG
V350256906L2C003R05000271881	chr1	335588	50M	145	335733	335589	335734	V350256906L2C003R05000271881_chr1_335588	84	229	CTGG	acaa
V350256906L2C003R05000929353	chr1	325057	50M	199	325256	325058	325257	V350256906L2C003R05000929353_chr1_325057	13	0	CTCA	CCCC
V350256906L2C003R05100396461	chr1	112743	50M	173	112916	112744	112917	V350256906L2C003R05100396461_chr1_112743	143	0	CACT	AGTT
V350256906L2C003R05100551492	chr1	837601	50M	171	837772	837602	837773	V350256906L2C003R05100551492_chr1_837601	74	55	TCCG	AGTG
V350256906L2C003R05100663850	chr1	704113	50M	188	704301	704114	704302	V350256906L2C003R05100663850_chr1_704113	46	15	CAAG	TATT
V350256906L2C003R05100843251	chr1	402824	50M	178	403002	402825	403003	V350256906L2C003R05100843251_chr1_402824	105	83	ccaa	ccaa
V350256906L2C003R05101118815	chr1	141690	50M	157	141847	141691	141848	V350256906L2C003R05101118815_chr1_141690	42	74	ctgt	ccct
V350256906L2C003R05200157886	chr1	663540	50M	182	663722	663541	663723	V350256906L2C003R05200157886_chr1_663540	40	47	GCCA	GTGG
V350256906L2C003R05200874116	chr1	1061160	50M	156	1061316	1061161	1061317	V350256906L2C003R05200874116_chr1_1061160	103	2	CCAG	GCCC
V350256906L2C003R05201039897	chr1	724932	47M3S	158	725090	724933	725091	V350256906L2C003R05201039897_chr1_724932	0	120	gaat	ttcc
V350256906L2C003R05300053327	chr1	666554	50M	176	666730	666555	666731	V350256906L2C003R05300053327_chr1_666554	221	101	CAAT	CATG
V350256906L2C003R05300136909	chr1	561484	50M	167	561651	561485	561652	V350256906L2C003R05300136909_chr1_561484	0	68	CTGT	CCTC
V350256906L2C003R05300369119	chr1	1104551	50M	169	1104720	1104552	1104721	V350256906L2C003R05300369119_chr1_1104551	4	17	CACT	CCCC
V350256906L2C003R05300434999	chr1	1410839	50M	164	1411003	1410840	1411004	V350256906L2C003R05300434999_chr1_1410839	32	16	CGCC	CTGC
V350256906L2C003R05300653595	chr1	93520	50M	190	93710	93521	93711	V350256906L2C003R05300653595_chr1_93520	101	23	CTTT	TGTA
V350256906L2C003R05300847805	chr1	633486	50M	158	633644	633487	633645	V350256906L2C003R05300847805_chr1_633486	0	78	TAAA	tatg
V350256906L2C003R05301166249	chr1	90313	50M	154	90467	90314	90468	V350256906L2C003R05301166249_chr1_90313	193	116	CCTC	catg
V350256906L2C003R05301223553	chr1	693445	50M	197	693642	693446	693643	V350256906L2C003R05301223553_chr1_693445	76	44	ctga	tgca
V350256906L2C003R05301380252	chr1	1392723	50M	241	1392964	1392724	1392965	V350256906L2C003R05301380252_chr1_1392723	68	33	ccag	cgct
V350256906L2C003R05400472544	chr1	1037602	50M	142	1037744	1037603	1037745	V350256906L2C003R05400472544_chr1_1037602	78	30	cttc	agga
V350256906L2C003R05400706400	chr1	763571	50M	157	763728	763572	763729	V350256906L2C003R05400706400_chr1_763571	30	65	ATAC	CTAC
V350256906L2C003R05400826497	chr1	413002	50M	110	413112	413003	413113	V350256906L2C003R05400826497_chr1_413002	256	146	TTGG	TCCA
V350256906L2C003R05401012264	chr1	102959	50M	153	103112	102960	103113	V350256906L2C003R05401012264_chr1_102959	84	98	gttt	ggct
V350256906L2C003R05401198178	chr1	232764	50M	178	232942	232765	232943	V350256906L2C003R05401198178_chr1_232764	0	18	CCAG	GTTG
V350256906L2C003R05500642607	chr1	1174857	50M	180	1175037	1174858	1175038	V350256906L2C003R05500642607_chr1_1174857	17	16	CCTG	GGTG
V350256906L2C003R05500780692	chr1	335724	50M	161	335885	335725	335886	V350256906L2C003R05500780692_chr1_335724	220	133	ttgc	TACA
V350256906L2C003R05501055589	chr1	1084899	50M	134	1085033	1084900	1085034	V350256906L2C003R05501055589_chr1_1084899	0	46	GACC	cacg
V350256906L2C003R05501075090	chr1	1085329	50M	120	1085449	1085330	1085450	V350256906L2C003R05501075090_chr1_1085329	8	55	CCCC	GAGG
V350256906L2C003R05600199161	chr1	1085644	50M	160	1085804	1085645	1085805	V350256906L2C003R05600199161_chr1_1085644	113	124	CACC	GGGG
V350256906L2C003R05600309073	chr1	1135529	50M	212	1135741	1135530	1135742	V350256906L2C003R05600309073_chr1_1135529	50	31	CCTG	CGAT
V350256906L2C003R05700532358	chr1	933647	50M	170	933817	933648	933818	V350256906L2C003R05700532358_chr1_933647	39	19	TCCC	GCAG
V350256906L2C003R05700624560	chr1	716331	21M4D29M	188	716519	716332	716520	V350256906L2C003R05700624560_chr1_716331	47	0	CTAG	ACAG
V350256906L2C003R05700624755	chr1	716331	21M4D29M	188	716519	716332	716520	V350256906L2C003R05700624755_chr1_716331	47	0	CTAG	ACAG
V350256906L2C003R05701035419	chr1	367289	50M	172	367461	367290	367462	V350256906L2C003R05701035419_chr1_367289	123	29	TAAG	TGAT
V350256906L2C003R05701079669	chr1	392000	50M	188	392188	392001	392189	V350256906L2C003R05701079669_chr1_392000	103	70	cctc	aaga
V350256906L2C003R05800006551	chr1	711899	50M	182	712081	711900	712082	V350256906L2C003R05800006551_chr1_711899	95	96	cttg	TACT
V350256906L2C003R05800063707	chr1	24187	50M	171	24358	24188	24359	V350256906L2C003R05800063707_chr1_24187	43	85	tgaa	cctc
V350256906L2C003R05800457347	chr1	464553	50M	193	464746	464554	464747	V350256906L2C003R05800457347_chr1_464553	26	115	ccat	ccag
V350256906L2C003R05800484801	chr1	364485	50M	159	364644	364486	364645	V350256906L2C003R05800484801_chr1_364485	38	57	AATC	GGGG
V350256906L2C003R05801035982	chr1	1156888	50M	167	1157055	1156889	1157056	V350256906L2C003R05801035982_chr1_1156888	55	27	gaac	CCTC
V350256906L2C003R05900290440	chr1	1279998	50M	150	1280148	1279999	1280149	V350256906L2C003R05900290440_chr1_1279998	90	0	GAGA	GGGC
V350256906L2C003R05900724768	chr1	1146309	50M	182	1146491	1146310	1146492	V350256906L2C003R05900724768_chr1_1146309	64	89	TGGG	ACCT
V350256906L2C003R05900996443	chr1	726720	8S24M18S	235	726955	726721	726956	V350256906L2C003R05900996443_chr1_726720	71	40	gaat	catt
V350256906L2C003R05901381702	chr1	760794	50M	201	760995	760795	760996	V350256906L2C003R05901381702_chr1_760794	84	69	CCTC	GGAT
V350256906L2C003R06000096090	chr1	1375326	50M	139	1375465	1375327	1375466	V350256906L2C003R06000096090_chr1_1375326	147	156	CTTC	CAGT
V350256906L2C003R06000184008	chr1	34200	50M	174	34374	34201	34375	V350256906L2C003R06000184008_chr1_34200	78	46	CAAG	CCCC
V350256906L2C003R06000312893	chr1	1282243	50M	170	1282413	1282244	1282414	V350256906L2C003R06000312893_chr1_1282243	0	13	CCAA	CATC
V350256906L2C003R06000378908	chr1	341268	50M	137	341405	341269	341406	V350256906L2C003R06000378908_chr1_341268	54	55	CACT	CCCA
V350256906L2C003R06000438844	chr1	433768	50M	213	433981	433769	433982	V350256906L2C003R06000438844_chr1_433768	107	66	CCCG	CTGA
V350256906L2C003R06000460178	chr1	979625	50M	229	979854	979626	979855	V350256906L2C003R06000460178_chr1_979625	67	70	CCCA	CCTG
V350256906L2C003R06000503036	chr1	656266	50M	132	656398	656267	656399	V350256906L2C003R06000503036_chr1_656266	0	27	acag	caaa
V350256906L2C003R06000860048	chr1	726297	50M	188	726485	726298	726486	V350256906L2C003R06000860048_chr1_726297	6	8	caga	atta
V350256906L2C003R06001030108	chr1	21034	50M	167	21201	21035	21202	V350256906L2C003R06001030108_chr1_21034	53	56	GGAG	CCGC
V350256906L2C003R06001107391	chr1	76039	50M	179	76218	76040	76219	V350256906L2C003R06001107391_chr1_76039	42	0	caag	ccaa
V350256906L2C003R06001191711	chr1	233161	50M	197	233358	233162	233359	V350256906L2C003R06001191711_chr1_233161	157	0	CTAT	TGAG
V350256906L2C003R06001378728	chr1	919134	50M	190	919324	919135	919325	V350256906L2C003R06001378728_chr1_919134	60	69	cctt	CCTG
V350256906L2C003R06001392645	chr1	1381528	50M	182	1381710	1381529	1381711	V350256906L2C003R06001392645_chr1_1381528	82	77	acaa	ccta
V350256906L2C003R06100258897	chr1	1424959	50M	190	1425149	1424960	1425150	V350256906L2C003R06100258897_chr1_1424959	61	63	TGAT	CAGG
V350256906L2C003R06100319159	chr1	1172350	50M	156	1172506	1172351	1172507	V350256906L2C003R06100319159_chr1_1172350	131	127	CCCC	GCCA
V350256906L2C003R06100763701	chr1	693190	50M	158	693348	693191	693349	V350256906L2C003R06100763701_chr1_693190	6	10	tttc	ctgt
V350256906L2C003R06100810735	chr1	109012	50M	167	109179	109013	109180	V350256906L2C003R06100810735_chr1_109012	5	0	ACTC	TCGT
V350256906L2C003R06200015176	chr1	667713	50M	221	667934	667714	667935	V350256906L2C003R06200015176_chr1_667713	52	62	TCTG	ACTT
V350256906L2C003R06200019366	chr1	900423	50M	180	900603	900424	900604	V350256906L2C003R06200019366_chr1_900423	32	24	TCGA	GGGA
V350256906L2C003R06200227188	chr1	823381	44M6S	172	823553	823382	823554	V350256906L2C003R06200227188_chr1_823381	65	39	ACAC	tcac
V350256906L2C003R06200425647	chr1	108887	50M	192	109079	108888	109080	V350256906L2C003R06200425647_chr1_108887	105	68	TGAT	CTTC
V350256906L2C003R06201003210	chr1	652112	50M	156	652268	652113	652269	V350256906L2C003R06201003210_chr1_652112	75	53	AAAT	CAAA
V350256906L2C003R06201097857	chr1	547146	50M	167	547313	547147	547314	V350256906L2C003R06201097857_chr1_547146	270	103	ccac	CCCA
V350256906L2C003R06201356694	chr1	162118	50M	179	162297	162119	162298	V350256906L2C003R06201356694_chr1_162118	60	43	cttt	cctt
V350256906L2C003R06300245026	chr1	1423794	50M	165	1423959	1423795	1423960	V350256906L2C003R06300245026_chr1_1423794	71	42	gatg	ccat
V350256906L2C003R06301036101	chr1	965701	6M2I42M	168	965869	965702	965870	V350256906L2C003R06301036101_chr1_965701	174	32	tggt	CACA
V350256906L2C003R06301118403	chr1	172888	50M	175	173063	172889	173064	V350256906L2C003R06301118403_chr1_172888	137	49	ccct	TGTA
V350256906L2C003R06301371263	chr1	702872	50M	165	703037	702873	703038	V350256906L2C003R06301371263_chr1_702872	33	83	ATGA	cgag
V350256906L2C003R06400136877	chr1	452652	50M	232	452884	452653	452885	V350256906L2C003R06400136877_chr1_452652	20	75	CCTG	GCAG
V350256906L2C003R06400274118	chr1	1205975	50M	235	1206210	1205976	1206211	V350256906L2C003R06400274118_chr1_1205975	70	8	TCAC	AGGA
V350256906L2C003R06400408590	chr1	1120327	50M	163	1120490	1120328	1120491	V350256906L2C003R06400408590_chr1_1120327	142	0	TCCA	CTTG
V350256906L2C003R06400524951	chr1	58493	50M	169	58662	58494	58663	V350256906L2C003R06400524951_chr1_58493	93	258	CTGA	GGGA
V350256906L2C003R06400908376	chr1	578988	50M	159	579147	578989	579148	V350256906L2C003R06400908376_chr1_578988	14	18	TGCA	GAAG
V350256906L2C003R06401062232	chr1	10193	3S47M	215	10408	10194	10409	V350256906L2C003R06401062232_chr1_10193	330	115	aacc	aggg
V350256906L2C003R06401114280	chr1	436442	50M	150	436592	436443	436593	V350256906L2C003R06401114280_chr1_436442	41	69	caag	ggag
V350256906L2C003R06500286454	chr1	54292	50M	168	54460	54293	54461	V350256906L2C003R06500286454_chr1_54292	80	58	TACT	CAGC
V350256906L2C003R06500516658	chr1	114180	50M	147	114327	114181	114328	V350256906L2C003R06500516658_chr1_114180	61	57	ACTG	gaac
V350256906L2C003R06500628344	chr1	1350942	50M	186	1351128	1350943	1351129	V350256906L2C003R06500628344_chr1_1350942	29	60	cgtc	ggtg
V350256906L2C003R06500689325	chr1	1122015	50M	229	1122244	1122016	1122245	V350256906L2C003R06500689325_chr1_1122015	55	33	cgcc	aaaa
V350256906L2C003R06600234417	chr1	1014337	50M	193	1014530	1014338	1014531	V350256906L2C003R06600234417_chr1_1014337	17	210	GCTG	CCAT
V350256906L2C003R06600276973	chr1	923022	50M	140	923162	923023	923163	V350256906L2C003R06600276973_chr1_923022	119	0	ttcc	aggc
V350256906L2C003R06600323308	chr1	682089	50M	157	682246	682090	682247	V350256906L2C003R06600323308_chr1_682089	3	126	actg	CCTC
V350256906L2C003R06600388457	chr1	1147451	50M	161	1147612	1147452	1147613	V350256906L2C003R06600388457_chr1_1147451	109	34	TGTC	TGTG
V350256906L2C003R06600389246	chr1	676783	50M	170	676953	676784	676954	V350256906L2C003R06600389246_chr1_676783	67	62	cctc	catg
V350256906L2C003R06600485357	chr1	723348	50M	160	723508	723349	723509	V350256906L2C003R06600485357_chr1_723348	5	32	CTGG	ccca
V350256906L2C003R06600627507	chr1	10110	5M1I44M	150	10260	10111	10261	V350256906L2C003R06600627507_chr1_10110	413	263	accc	ggtt
V350256906L2C003R06600655306	chr1	725791	3S43M4S	157	725948	725792	725949	V350256906L2C003R06600655306_chr1_725791	92	23	cgaa	gcag
V350256906L2C003R06600821822	chr1	725914	50M	157	726071	725915	726072	V350256906L2C003R06600821822_chr1_725914	0	146	atgg	attc
V350256906L2C003R06600868471	chr1	83730	50M	151	83881	83731	83882	V350256906L2C003R06600868471_chr1_83730	12	7	ctat	cttt
V350256906L2C003R06600908777	chr1	361904	50M	161	362065	361905	362066	V350256906L2C003R06600908777_chr1_361904	101	45	ACCA	TGTG
V350256906L2C003R06601206115	chr1	628018	50M	167	628185	628019	628186	V350256906L2C003R06601206115_chr1_628018	54	54	AGAG	ATCT
V350256906L2C003R06601251860	chr1	460791	50M	194	460985	460792	460986	V350256906L2C003R06601251860_chr1_460791	42	48	tgac	gatg
V350256906L2C003R06700134938	chr1	1134541	50M	181	1134722	1134542	1134723	V350256906L2C003R06700134938_chr1_1134541	67	68	ACCA	CCTG
V350256906L2C003R06700522433	chr1	670433	50M	183	670616	670434	670617	V350256906L2C003R06700522433_chr1_670433	130	57	cctc	tgtg
V350256906L2C003R06700749359	chr1	1229994	50M	170	1230164	1229995	1230165	V350256906L2C003R06700749359_chr1_1229994	58	74	CCGA	CGGA
V350256906L2C003R06700822849	chr1	725523	18S29M3S	159	725682	725524	725683	V350256906L2C003R06700822849_chr1_725523	7	166	aatg	catt
V350256906L2C003R06700837950	chr1	1118338	50M	160	1118498	1118339	1118499	V350256906L2C003R06700837950_chr1_1118338	30	25	CGCC	GCTG
V350256906L2C003R06701036704	chr1	612239	50M	178	612417	612240	612418	V350256906L2C003R06701036704_chr1_612239	143	7	gctc	caaa
V350256906L2C003R06800453967	chr1	1092228	50M	174	1092402	1092229	1092403	V350256906L2C003R06800453967_chr1_1092228	61	63	AGAA	CCAC
V350256906L2C003R06800510707	chr1	1402306	50M	163	1402469	1402307	1402470	V350256906L2C003R06800510707_chr1_1402306	3	0	ggta	TGAT
V350256906L2C003R06800929262	chr1	254053	50M	178	254231	254054	254232	V350256906L2C003R06800929262_chr1_254053	12	0	ggta	CTTA
V350256906L2C003R06900148622	chr1	692662	50M	176	692838	692663	692839	V350256906L2C003R06900148622_chr1_692662	184	123	ggca	TAGC
V350256906L2C003R06900289145	chr1	631662	50M	186	631848	631663	631849	V350256906L2C003R06900289145_chr1_631662	73	80	AAAA	ttaa
V350256906L2C003R07000400093	chr1	1126297	50M	161	1126458	1126298	1126459	V350256906L2C003R07000400093_chr1_1126297	34	66	ccgg	cagg
V350256906L2C003R07000580532	chr1	613204	50M	169	613373	613205	613374	V350256906L2C003R07000580532_chr1_613204	138	8	ccct	tgtg
V350256906L2C003R07000643258	chr1	112548	50M	174	112722	112549	112723	V350256906L2C003R07000643258_chr1_112548	160	164	tgca	CAAG
V350256906L2C003R07000663703	chr1	1120423	50M	201	1120624	1120424	1120625	V350256906L2C003R07000663703_chr1_1120423	46	62	CTAC	CCAC
V350256906L2C003R07000805702	chr1	539805	50M	161	539966	539806	539967	V350256906L2C003R07000805702_chr1_539805	109	190	GCCT	CCCC
V350256906L2C003R07001097149	chr1	725032	50M	155	725187	725033	725188	V350256906L2C003R07001097149_chr1_725032	62	82	gtat	cact
V350256906L2C003R07001125195	chr1	923811	50M	168	923979	923812	923980	V350256906L2C003R07001125195_chr1_923811	52	58	caag	tttt
V350256906L2C003R07100092241	chr1	796275	50M	175	796450	796276	796451	V350256906L2C003R07100092241_chr1_796275	0	71	ctct	CAGG
V350256906L2C003R07100360328	chr1	1314168	50M	204	1314372	1314169	1314373	V350256906L2C003R07100360328_chr1_1314168	27	24	cagc	GGAT
V350256906L2C003R07100991311	chr1	406408	50M	191	406599	406409	406600	V350256906L2C003R07100991311_chr1_406408	8	140	CAAA	TGAT
V350256906L2C003R07101244092	chr1	1141554	50M	176	1141730	1141555	1141731	V350256906L2C003R07101244092_chr1_1141554	69	60	CCGG	AAGG
V350256906L2C003R07101336169	chr1	1401817	50M	241	1402058	1401818	1402059	V350256906L2C003R07101336169_chr1_1401817	49	23	cagc	aatc
V350256906L2C003R07200657581	chr1	14988	50M	175	15163	14989	15164	V350256906L2C003R07200657581_chr1_14988	186	11	GCTT	TCTG
V350256906L2C003R07200842465	chr1	1071414	50M	221	1071635	1071415	1071636	V350256906L2C003R07200842465_chr1_1071414	142	0	CGGG	TGCA
V350256906L2C003R07201152892	chr1	143832	50M	152	143984	143833	143985	V350256906L2C003R07201152892_chr1_143832	39	0	tccc	CTGC
V350256906L2C003R07201320681	chr1	114621	50M	174	114795	114622	114796	V350256906L2C003R07201320681_chr1_114621	58	27	ttta	CCTG
V350256906L2C003R07201357736	chr1	643325	50M	170	643495	643326	643496	V350256906L2C003R07201357736_chr1_643325	69	0	gttt	gatt
V350256906L2C004R00100457136	chr1	1073352	50M	153	1073505	1073353	1073506	V350256906L2C004R00100457136_chr1_1073352	66	63	TAAG	CCCT
V350256906L2C004R00200505525	chr1	77627	50M	179	77806	77628	77807	V350256906L2C004R00200505525_chr1_77627	59	56	GCTA	TCCA
V350256906L2C004R00200862430	chr1	842793	50M	151	842944	842794	842945	V350256906L2C004R00200862430_chr1_842793	64	55	cata	Cttt
V350256906L2C004R00300057527	chr1	700478	50M	175	700653	700479	700654	V350256906L2C004R00300057527_chr1_700478	138	75	cccc	TCCC
V350256906L2C004R00300275713	chr1	1074070	50M	184	1074254	1074071	1074255	V350256906L2C004R00300275713_chr1_1074070	53	47	CCAT	CCCA
V350256906L2C004R00300379477	chr1	1008472	50M	190	1008662	1008473	1008663	V350256906L2C004R00300379477_chr1_1008472	47	43	GCTC	TGCC
V350256906L2C004R00300894588	chr1	800762	50M	164	800926	800763	800927	V350256906L2C004R00300894588_chr1_800762	0	9	CCCT	CAAC
V350256906L2C004R00301221727	chr1	164470	50M	156	164626	164471	164627	V350256906L2C004R00301221727_chr1_164470	44	67	gact	acct
V350256906L2C004R00301329517	chr1	1389523	50M	187	1389710	1389524	1389711	V350256906L2C004R00301329517_chr1_1389523	53	50	GGCG	CGCA
V350256906L2C004R00400024995	chr1	1072230	50M	174	1072404	1072231	1072405	V350256906L2C004R00400024995_chr1_1072230	0	0	CGGG	TCGT
V350256906L2C004R00400286783	chr1	455429	50M	152	455581	455430	455582	V350256906L2C004R00400286783_chr1_455429	45	26	CCTT	GGGA
V350256906L2C004R00400744499	chr1	431744	50M	157	431901	431745	431902	V350256906L2C004R00400744499_chr1_431744	29	66	CCAA	CCAG
V350256906L2C004R00400818530	chr1	260378	50M	138	260516	260379	260517	V350256906L2C004R00400818530_chr1_260378	0	58	gctg	TGAG
V350256906L2C004R00400868935	chr1	1221422	50M	181	1221603	1221423	1221604	V350256906L2C004R00400868935_chr1_1221422	68	37	CTTC	CACA
V350256906L2C004R00400969069	chr1	112851	50M	179	113030	112852	113031	V350256906L2C004R00400969069_chr1_112851	35	46	TTAA	GTGT
V350256906L2C004R00500041414	chr1	48020	50M	149	48169	48021	48170	V350256906L2C004R00500041414_chr1_48020	66	0	ACAC	GAAC
V350256906L2C004R00500404609	chr1	667197	50M	192	667389	667198	667390	V350256906L2C004R00500404609_chr1_667197	237	45	gagc	gcat
V350256906L2C004R00500672049	chr1	1376374	50M	134	1376508	1376375	1376509	V350256906L2C004R00500672049_chr1_1376374	29	18	GGCT	GGGG
V350256906L2C004R00500680462	chr1	723233	50M	175	723408	723234	723409	V350256906L2C004R00500680462_chr1_723233	12	6	TTAT	TGAC
V350256906L2C004R00500689780	chr1	133870	50M	179	134049	133871	134050	V350256906L2C004R00500689780_chr1_133870	228	49	CACC	CCCA
V350256906L2C004R00500841641	chr1	235638	50M	166	235804	235639	235805	V350256906L2C004R00500841641_chr1_235638	190	24	CCCT	ACAA
V350256906L2C004R00500872638	chr1	712118	50M	172	712290	712119	712291	V350256906L2C004R00500872638_chr1_712118	59	63	ATAG	GGTA
V350256906L2C004R00501117081	chr1	766563	50M	176	766739	766564	766740	V350256906L2C004R00501117081_chr1_766563	60	40	aggg	CCAT
V350256906L2C004R00600021604	chr1	612592	50M	141	612733	612593	612734	V350256906L2C004R00600021604_chr1_612592	35	24	ggtt	cttt
V350256906L2C004R00600143627	chr1	843043	50M	167	843210	843044	843211	V350256906L2C004R00600143627_chr1_843043	49	76	GGAG	GGTG
V350256906L2C004R00600503632	chr1	350620	50M	204	350824	350621	350825	V350256906L2C004R00600503632_chr1_350620	18	45	CCAG	tgtt
V350256906L2C004R00600621458	chr1	637892	50M	205	638097	637893	638098	V350256906L2C004R00600621458_chr1_637892	41	29	TGTA	TCCA
V350256906L2C004R00600650445	chr1	1198558	50M	152	1198710	1198559	1198711	V350256906L2C004R00600650445_chr1_1198558	40	20	CCAG	TAGG
V350256906L2C004R00600675809	chr1	672795	50M	199	672994	672796	672995	V350256906L2C004R00600675809_chr1_672795	130	0	aatg	gcta
V350256906L2C004R00600893121	chr1	1121368	50M	144	1121512	1121369	1121513	V350256906L2C004R00600893121_chr1_1121368	53	57	attc	gggc
V350256906L2C004R00600897571	chr1	75385	50M	140	75525	75386	75526	V350256906L2C004R00600897571_chr1_75385	0	99	agtg	gttg
V350256906L2C004R00601012610	chr1	835611	50M	186	835797	835612	835798	V350256906L2C004R00601012610_chr1_835611	89	222	aacg	cctg
V350256906L2C004R00700173203	chr1	39434	50M	178	39612	39435	39613	V350256906L2C004R00700173203_chr1_39434	329	151	ggga	caat
V350256906L2C004R00700370199	chr1	542454	50M	133	542587	542455	542588	V350256906L2C004R00700370199_chr1_542454	67	23	AACT	CCCT
V350256906L2C004R00700662583	chr1	687483	50M	176	687659	687484	687660	V350256906L2C004R00700662583_chr1_687483	55	72	ggtc	gttt
V350256906L2C004R00700746188	chr1	422020	50M	165	422185	422021	422186	V350256906L2C004R00700746188_chr1_422020	6	124	TCTT	ggaa
V350256906L2C004R00700901354	chr1	762362	50M	184	762546	762363	762547	V350256906L2C004R00700901354_chr1_762362	7	0	TACA	CCCT
V350256906L2C004R00700916238	chr1	688967	50M	193	689160	688968	689161	V350256906L2C004R00700916238_chr1_688967	55	189	gcta	caaa
V350256906L2C004R00701112772	chr1	1298808	11M1D39M	195	1299003	1298809	1299004	V350256906L2C004R00701112772_chr1_1298808	0	0	TCAG	tctc
V350256906L2C004R00800117574	chr1	1026486	50M	133	1026619	1026487	1026620	V350256906L2C004R00800117574_chr1_1026486	43	44	CCCA	CCCA
V350256906L2C004R00800117575	chr1	1026486	50M	133	1026619	1026487	1026620	V350256906L2C004R00800117575_chr1_1026486	43	44	CCCA	CCCA
V350256906L2C004R00800341025	chr1	668838	50M	180	669018	668839	669019	V350256906L2C004R00800341025_chr1_668838	206	169	gggt	cccc
V350256906L2C004R00800539957	chr1	1027251	50M	162	1027413	1027252	1027414	V350256906L2C004R00800539957_chr1_1027251	66	153	GCCG	GGCA
V350256906L2C004R00800545137	chr1	94954	50M	225	95179	94955	95180	V350256906L2C004R00800545137_chr1_94954	28	0	caag	CCTA
V350256906L2C004R00800673583	chr1	1277895	50M	181	1278076	1277896	1278077	V350256906L2C004R00800673583_chr1_1277895	54	61	CCCA	CTCC
V350256906L2C004R00800685045	chr1	108117	50M	179	108296	108118	108297	V350256906L2C004R00800685045_chr1_108117	32	9	ggaa	cagc
V350256906L2C004R00800816979	chr1	1283119	50M	176	1283295	1283120	1283296	V350256906L2C004R00800816979_chr1_1283119	0	0	AAAC	CTCA
V350256906L2C004R00900315038	chr1	818733	45M5S	100	818833	818734	818834	V350256906L2C004R00900315038_chr1_818733	45	8	tttc	ataa
V350256906L2C004R00900619252	chr1	33512	50M	135	33647	33513	33648	V350256906L2C004R00900619252_chr1_33512	0	110	AGGT	taat
V350256906L2C004R00900887449	chr1	743785	50M	153	743938	743786	743939	V350256906L2C004R00900887449_chr1_743785	27	19	CTGC	AAAT
V350256906L2C004R01001154140	chr1	1416884	50M	167	1417051	1416885	1417052	V350256906L2C004R01001154140_chr1_1416884	104	9	AGTG	CAGC
V350256906L2C004R01001407132	chr1	1192252	17M1I32M	152	1192404	1192253	1192405	V350256906L2C004R01001407132_chr1_1192252	70	40	cgag	CCCT
V350256906L2C004R01100029968	chr1	775530	50M	170	775700	775531	775701	V350256906L2C004R01100029968_chr1_775530	55	86	caat	tttc
V350256906L2C004R01100594254	chr1	356623	50M	171	356794	356624	356795	V350256906L2C004R01100594254_chr1_356623	74	132	ctac	tata
V350256906L2C004R01100791563	chr1	770267	50M	169	770436	770268	770437	V350256906L2C004R01100791563_chr1_770267	126	32	tgtc	GGGA
V350256906L2C004R01101156556	chr1	95463	50M	176	95639	95464	95640	V350256906L2C004R01101156556_chr1_95463	51	115	AGAT	CCTG
V350256906L2C004R01101378912	chr1	1201569	50M	179	1201748	1201570	1201749	V350256906L2C004R01101378912_chr1_1201569	14	22	TCCT	tgcc
V350256906L2C004R01200167240	chr1	1102899	50M	159	1103058	1102900	1103059	V350256906L2C004R01200167240_chr1_1102899	3	125	CCCA	GCTG
V350256906L2C004R01200724857	chr1	628513	50M	244	628757	628514	628758	V350256906L2C004R01200724857_chr1_628513	25	64	aaag	tgcc
V350256906L2C004R01200803246	chr1	1345989	50M	213	1346202	1345990	1346203	V350256906L2C004R01200803246_chr1_1345989	32	72	aggg	ctcc
V350256906L2C004R01201296686	chr1	451041	50M	130	451171	451042	451172	V350256906L2C004R01201296686_chr1_451041	90	14	tgta	CCAT
V350256906L2C004R01201382699	chr1	725928	50M	137	726065	725929	726066	V350256906L2C004R01201382699_chr1_725928	3	140	actc	ttcc
V350256906L2C004R01300223544	chr1	737894	50M	201	738095	737895	738096	V350256906L2C004R01300223544_chr1_737894	116	144	tgtt	TCAC
V350256906L2C004R01300245095	chr1	1360319	50M	178	1360497	1360320	1360498	V350256906L2C004R01300245095_chr1_1360319	83	71	ccaa	ACTC
V350256906L2C004R01300834057	chr1	767632	50M	185	767817	767633	767818	V350256906L2C004R01300834057_chr1_767632	8	5	CGTG	GGGC
V350256906L2C004R01301004439	chr1	734946	50M	183	735129	734947	735130	V350256906L2C004R01301004439_chr1_734946	7	10	ccac	catg
V350256906L2C004R01301086924	chr1	121637	50M	247	121884	121638	121885	V350256906L2C004R01301086924_chr1_121637	17	30	Cttt	GCAG
V350256906L2C004R01301151059	chr1	254443	50M	165	254608	254444	254609	V350256906L2C004R01301151059_chr1_254443	43	7	ccat	caaa
V350256906L2C004R01301167596	chr1	132584	50M	170	132754	132585	132755	V350256906L2C004R01301167596_chr1_132584	123	195	CCCC	GGGC
V350256906L2C004R01400046180	chr1	1298587	50M	179	1298766	1298588	1298767	V350256906L2C004R01400046180_chr1_1298587	15	0	tggg	cgct
V350256906L2C004R01400160403	chr1	986477	50M	204	986681	986478	986682	V350256906L2C004R01400160403_chr1_986477	48	20	AGCT	GCCC
V350256906L2C004R01400264429	chr1	921444	50M	162	921606	921445	921607	V350256906L2C004R01400264429_chr1_921444	58	71	taac	ccca
V350256906L2C004R01400398600	chr1	965643	50M	189	965832	965644	965833	V350256906L2C004R01400398600_chr1_965643	116	69	gtgt	TCAC
V350256906L2C004R01400424394	chr1	1280146	50M	181	1280327	1280147	1280328	V350256906L2C004R01400424394_chr1_1280146	0	2	CCCA	GGTG
V350256906L2C004R01400689382	chr1	18141	50M	159	18300	18142	18301	V350256906L2C004R01400689382_chr1_18141	27	83	GGAA	AGAA
V350256906L2C004R01401006155	chr1	707435	50M	162	707597	707436	707598	V350256906L2C004R01401006155_chr1_707435	0	11	TAGA	CAGC
V350256906L2C004R01401137888	chr1	724837	13S32M5S	182	725019	724838	725020	V350256906L2C004R01401137888_chr1_724837	72	49	gaat	tcca
V350256906L2C004R01500168411	chr1	804002	50M	177	804179	804003	804180	V350256906L2C004R01500168411_chr1_804002	43	68	CCCA	CATC
V350256906L2C004R01500463381	chr1	1246264	50M	155	1246419	1246265	1246420	V350256906L2C004R01500463381_chr1_1246264	44	58	GGTC	AGCC
V350256906L2C004R01500559167	chr1	403063	50M	166	403229	403064	403230	V350256906L2C004R01500559167_chr1_403063	22	29	actg	taaa
V350256906L2C004R01500847300	chr1	1425781	50M	193	1425974	1425782	1425975	V350256906L2C004R01500847300_chr1_1425781	1	0	TAAG	CCCG
V350256906L2C004R01500960296	chr1	15320	50M	163	15483	15321	15484	V350256906L2C004R01500960296_chr1_15320	52	60	caga	CCTG
V350256906L2C004R01501121084	chr1	1342963	50M	141	1343104	1342964	1343105	V350256906L2C004R01501121084_chr1_1342963	43	56	cccg	aaca
V350256906L2C004R01501295736	chr1	556616	50M	212	556828	556617	556829	V350256906L2C004R01501295736_chr1_556616	23	82	cagc	CAGT
V350256906L2C004R01601148843	chr1	257875	50M	161	258036	257876	258037	V350256906L2C004R01601148843_chr1_257875	39	60	GCTC	TTTC
V350256906L2C004R01601157356	chr1	397990	50M	176	398166	397991	398167	V350256906L2C004R01601157356_chr1_397990	62	65	caaa	CAAG
V350256906L2C004R01601185170	chr1	707069	50M	105	707174	707070	707175	V350256906L2C004R01601185170_chr1_707069	0	43	tgcc	CCCC
V350256906L2C004R01601337884	chr1	704762	50M	153	704915	704763	704916	V350256906L2C004R01601337884_chr1_704762	71	55	caag	ccct
V350256906L2C004R01601341659	chr1	1112363	50M	158	1112521	1112364	1112522	V350256906L2C004R01601341659_chr1_1112363	21	62	CCTC	ccta
V350256906L2C004R01700023499	chr1	824385	50M	155	824540	824386	824541	V350256906L2C004R01700023499_chr1_824385	0	66	tcct	gagc
V350256906L2C004R01700706540	chr1	1010667	50M	170	1010837	1010668	1010838	V350256906L2C004R01700706540_chr1_1010667	31	28	GGCC	GGTC
V350256906L2C004R01700718302	chr1	29972	50M	169	30141	29973	30142	V350256906L2C004R01700718302_chr1_29972	38	49	caga	cagc
V350256906L2C004R01701096291	chr1	252098	50M	157	252255	252099	252256	V350256906L2C004R01701096291_chr1_252098	75	0	AGAG	GCAG
V350256906L2C004R01701216929	chr1	1228765	50M	194	1228959	1228766	1228960	V350256906L2C004R01701216929_chr1_1228765	0	0	CTCA	CTGG
V350256906L2C004R01701250217	chr1	366345	50M	167	366512	366346	366513	V350256906L2C004R01701250217_chr1_366345	416	583	CTAT	TATA
V350256906L2C004R01800094125	chr1	771587	50M	158	771745	771588	771746	V350256906L2C004R01800094125_chr1_771587	109	267	TAGG	CCCG
V350256906L2C004R01800336113	chr1	1161115	50M	161	1161276	1161116	1161277	V350256906L2C004R01800336113_chr1_1161115	17	13	ccac	TGGA
V350256906L2C004R01800869682	chr1	805279	50M	251	805530	805280	805531	V350256906L2C004R01800869682_chr1_805279	0	56	CCCG	GTAG
V350256906L2C004R01800940873	chr1	1274961	50M	187	1275148	1274962	1275149	V350256906L2C004R01800940873_chr1_1274961	31	58	CCCC	CGGG
V350256906L2C004R01800961459	chr1	673448	50M	175	673623	673449	673624	V350256906L2C004R01800961459_chr1_673448	184	60	cctc	CCAG
V350256906L2C004R01801138660	chr1	664063	50M	184	664247	664064	664248	V350256906L2C004R01801138660_chr1_664063	54	65	CTGT	CTCA
V350256906L2C004R01801268945	chr1	771143	50M	161	771304	771144	771305	V350256906L2C004R01801268945_chr1_771143	93	117	CTCA	CCAA
V350256906L2C004R01801278590	chr1	1365799	50M	187	1365986	1365800	1365987	V350256906L2C004R01801278590_chr1_1365799	53	72	CAGC	CAGG
V350256906L2C004R01900246452	chr1	1318790	50M	178	1318968	1318791	1318969	V350256906L2C004R01900246452_chr1_1318790	27	19	ctgt	gggc
V350256906L2C004R01900827317	chr1	16599	50M	168	16767	16600	16768	V350256906L2C004R01900827317_chr1_16599	74	33	GCTC	GACC
V350256906L2C004R01900876709	chr1	87001	50M	162	87163	87002	87164	V350256906L2C004R01900876709_chr1_87001	37	28	ccca	ctcc
V350256906L2C004R01901172759	chr1	899526	50M	121	899647	899527	899648	V350256906L2C004R01901172759_chr1_899526	38	41	CACA	CAGG
V350256906L2C004R01901352814	chr1	246600	50M	170	246770	246601	246771	V350256906L2C004R01901352814_chr1_246600	2	23	taat	CCTG
V350256906L2C004R02000087142	chr1	1297558	50M	197	1297755	1297559	1297756	V350256906L2C004R02000087142_chr1_1297558	24	19	ATCG	CCAG
V350256906L2C004R02000525116	chr1	64005	50M	196	64201	64006	64202	V350256906L2C004R02000525116_chr1_64005	28	36	TGCA	TGAT
V350256906L2C004R02000776430	chr1	735618	50M	162	735780	735619	735781	V350256906L2C004R02000776430_chr1_735618	54	79	ccat	cctg
V350256906L2C004R02000931849	chr1	97928	50M	180	98108	97929	98109	V350256906L2C004R02000931849_chr1_97928	0	178	ttaa	TTAT
V350256906L2C004R02000954539	chr1	1277920	50M	179	1278099	1277921	1278100	V350256906L2C004R02000954539_chr1_1277920	52	57	CAGG	CCCT
V350256906L2C004R02100622930	chr1	15215	50M	152	15367	15216	15368	V350256906L2C004R02100622930_chr1_15215	0	5	TGAG	CACT
V350256906L2C004R02100646676	chr1	692274	50M	188	692462	692275	692463	V350256906L2C004R02100646676_chr1_692274	0	0	CCAC	CAAT
V350256906L2C004R02100701343	chr1	911367	50M	253	911620	911368	911621	V350256906L2C004R02100701343_chr1_911367	36	5	GGAG	CCAT
V350256906L2C004R02101276248	chr1	266123	50M	187	266310	266124	266311	V350256906L2C004R02101276248_chr1_266123	32	20	caca	ACAC
V350256906L2C004R02200174476	chr1	719037	50M	151	719188	719038	719189	V350256906L2C004R02200174476_chr1_719037	86	34	gaac	taat
V350256906L2C004R02200415833	chr1	1280810	50M	193	1281003	1280811	1281004	V350256906L2C004R02200415833_chr1_1280810	59	47	CCCC	TCTG
V350256906L2C004R02200999353	chr1	547641	50M	174	547815	547642	547816	V350256906L2C004R02200999353_chr1_547641	134	95	GTGT	CCGA
V350256906L2C004R02300161068	chr1	714430	50M	176	714606	714431	714607	V350256906L2C004R02300161068_chr1_714430	39	20	CCAG	AGGG
V350256906L2C004R02300319161	chr1	428877	50M	187	429064	428878	429065	V350256906L2C004R02300319161_chr1_428877	35	0	taca	CTTA
V350256906L2C004R02300531245	chr1	1316147	50M	177	1316324	1316148	1316325	V350256906L2C004R02300531245_chr1_1316147	71	58	CCCT	CGAG
V350256906L2C004R02300645329	chr1	1409989	50M	171	1410160	1409990	1410161	V350256906L2C004R02300645329_chr1_1409989	80	32	cctg	cctg
V350256906L2C004R02301059061	chr1	452207	50M	148	452355	452208	452356	V350256906L2C004R02301059061_chr1_452207	177	29	tgat	gtat
V350256906L2C004R02301259922	chr1	1376648	50M	196	1376844	1376649	1376845	V350256906L2C004R02301259922_chr1_1376648	50	61	TCCC	CCAA
V350256906L2C004R02301285363	chr1	770201	50M	187	770388	770202	770389	V350256906L2C004R02301285363_chr1_770201	60	80	catc	GATC
V350256906L2C004R02400067728	chr1	64752	50M	163	64915	64753	64916	V350256906L2C004R02400067728_chr1_64752	79	52	CAAA	GAAA
V350256906L2C004R02400165550	chr1	159599	50M	172	159771	159600	159772	V350256906L2C004R02400165550_chr1_159599	78	56	ATTA	GGCC
V350256906L2C004R02400266734	chr1	794000	50M	190	794190	794001	794191	V350256906L2C004R02400266734_chr1_794000	29	30	GGAT	CCCG
V350256906L2C004R02400274417	chr1	1067362	50M	192	1067554	1067363	1067555	V350256906L2C004R02400274417_chr1_1067362	84	69	CTCT	CCCC
V350256906L2C004R02400511173	chr1	449777	50M	151	449928	449778	449929	V350256906L2C004R02400511173_chr1_449777	66	55	CGCA	GGAA
V350256906L2C004R02400803808	chr1	23290	50M	184	23474	23291	23475	V350256906L2C004R02400803808_chr1_23290	0	169	gagg	GCCT
V350256906L2C004R02400839083	chr1	244689	50M	158	244847	244690	244848	V350256906L2C004R02400839083_chr1_244689	99	257	GCTA	TGAG
V350256906L2C004R02401196793	chr1	464507	50M	191	464698	464508	464699	V350256906L2C004R02401196793_chr1_464507	72	67	ccta	cccg
V350256906L2C004R02401201854	chr1	441964	50M	168	442132	441965	442133	V350256906L2C004R02401201854_chr1_441964	24	12	GTTT	cacc
V350256906L2C004R02500153653	chr1	1305824	50M	147	1305971	1305825	1305972	V350256906L2C004R02500153653_chr1_1305824	59	46	gctc	CTCA
V350256906L2C004R02500165197	chr1	341978	50M	157	342135	341979	342136	V350256906L2C004R02500165197_chr1_341978	57	40	tgcg	CTGC
V350256906L2C004R02500199269	chr1	867384	50M	189	867573	867385	867574	V350256906L2C004R02500199269_chr1_867384	26	48	TGAA	ATAA
V350256906L2C004R02500335640	chr1	683810	50M	167	683977	683811	683978	V350256906L2C004R02500335640_chr1_683810	3	43	ctgg	acaa
V350256906L2C004R02500384225	chr1	344900	50M	154	345054	344901	345055	V350256906L2C004R02500384225_chr1_344900	13	0	tgtc	cata
V350256906L2C004R02500582447	chr1	732468	50M	184	732652	732469	732653	V350256906L2C004R02500582447_chr1_732468	0	170	cagc	GAAT
V350256906L2C004R02500964796	chr1	726313	5S19M26S	121	726434	726314	726435	V350256906L2C004R02500964796_chr1_726313	22	0	cgaa	catt
V350256906L2C004R02501141568	chr1	1040877	50M	160	1041037	1040878	1041038	V350256906L2C004R02501141568_chr1_1040877	55	67	cccc	accc
V350256906L2C004R02600348095	chr1	112539	50M	171	112710	112540	112711	V350256906L2C004R02600348095_chr1_112539	151	176	cctg	CCAG
V350256906L2C004R02600762657	chr1	1155728	50M	193	1155921	1155729	1155922	V350256906L2C004R02600762657_chr1_1155728	49	60	CCGC	CCCG
V350256906L2C004R02600858849	chr1	18434	50M	178	18612	18435	18613	V350256906L2C004R02600858849_chr1_18434	27	205	CTGC	GCCT
V350256906L2C004R02601019153	chr1	72390	50M	145	72535	72391	72536	V350256906L2C004R02601019153_chr1_72390	245	150	tggt	tgca
V350256906L2C004R02601087390	chr1	556398	50M	193	556591	556399	556592	V350256906L2C004R02601087390_chr1_556398	6	0	acca	ccAC
V350256906L2C004R02601165807	chr1	726569	14S31M5S	172	726741	726570	726742	V350256906L2C004R02601165807_chr1_726569	31	72	tcga	ccat
V350256906L2C004R02700235722	chr1	1186774	50M	178	1186952	1186775	1186953	V350256906L2C004R02700235722_chr1_1186774	113	39	gcca	agac
V350256906L2C004R02700351308	chr1	245272	50M	187	245459	245273	245460	V350256906L2C004R02700351308_chr1_245272	62	38	CCCA	gccg
V350256906L2C004R02700521223	chr1	385500	50M	164	385664	385501	385665	V350256906L2C004R02700521223_chr1_385500	232	68	cccc	catg
V350256906L2C004R02700574930	chr1	1387093	50M	168	1387261	1387094	1387262	V350256906L2C004R02700574930_chr1_1387093	141	0	ACGT	GGAC
V350256906L2C004R02701171206	chr1	780561	50M	206	780767	780562	780768	V350256906L2C004R02701171206_chr1_780561	65	36	CCCT	TGAG
V350256906L2C004R02800269277	chr1	464824	50M	139	464963	464825	464964	V350256906L2C004R02800269277_chr1_464824	193	231	GTCT	TACC
V350256906L2C004R02800363902	chr1	230917	50M	166	231083	230918	231084	V350256906L2C004R02800363902_chr1_230917	0	0	cttc	taag
V350256906L2C004R02800559561	chr1	531842	50M	164	532006	531843	532007	V350256906L2C004R02800559561_chr1_531842	258	94	cata	Ggtg
V350256906L2C004R02800899475	chr1	30687	50M	215	30902	30688	30903	V350256906L2C004R02800899475_chr1_30687	69	0	CCAC	gaga
V350256906L2C004R02801117042	chr1	803313	50M	145	803458	803314	803459	V350256906L2C004R02801117042_chr1_803313	73	0	GATA	CAAA
V350256906L2C004R02801132272	chr1	970608	50M	207	970815	970609	970816	V350256906L2C004R02801132272_chr1_970608	16	61	GGAG	CCTC
V350256906L2C004R02801289622	chr1	919764	50M	147	919911	919765	919912	V350256906L2C004R02801289622_chr1_919764	45	56	CCAG	CGAT
V350256906L2C004R02801381560	chr1	318730	50M	179	318909	318731	318910	V350256906L2C004R02801381560_chr1_318730	55	36	gaac	gcag
V350256906L2C004R02900256163	chr1	1347552	50M	146	1347698	1347553	1347699	V350256906L2C004R02900256163_chr1_1347552	46	51	ccag	gaat
V350256906L2C004R02900366602	chr1	236289	50M	168	236457	236290	236458	V350256906L2C004R02900366602_chr1_236289	45	37	TATG	tgga
V350256906L2C004R02900495009	chr1	141256	50M	210	141466	141257	141467	V350256906L2C004R02900495009_chr1_141256	68	26	ctgt	taat
V350256906L2C004R02900710028	chr1	1368798	50M	114	1368912	1368799	1368913	V350256906L2C004R02900710028_chr1_1368798	78	12	GGAA	GTCT
V350256906L2C004R02900874630	chr1	737567	50M	171	737738	737568	737739	V350256906L2C004R02900874630_chr1_737567	12	18	GCCC	ATAG
V350256906L2C004R02901091907	chr1	956327	50M	171	956498	956328	956499	V350256906L2C004R02901091907_chr1_956327	35	42	CGGG	ATTT
V350256906L2C004R02901231451	chr1	626235	50M	190	626425	626236	626426	V350256906L2C004R02901231451_chr1_626235	39	46	tagg	tgat
V350256906L2C004R03000325479	chr1	593088	50M	138	593226	593089	593227	V350256906L2C004R03000325479_chr1_593088	41	43	tatg	TGGT
V350256906L2C004R03000348220	chr1	93078	50M	182	93260	93079	93261	V350256906L2C004R03000348220_chr1_93078	60	43	GTGA	taag
V350256906L2C004R03000479926	chr1	32780	50M	167	32947	32781	32948	V350256906L2C004R03000479926_chr1_32780	65	61	CACC	aggt
V350256906L2C004R03001347924	chr1	344472	50M	186	344658	344473	344659	V350256906L2C004R03001347924_chr1_344472	173	209	ctta	taga
V350256906L2C004R03100114773	chr1	465500	50M	153	465653	465501	465654	V350256906L2C004R03100114773_chr1_465500	55	208	CATA	TGAA
V350256906L2C004R03100153569	chr1	385779	50M	191	385970	385780	385971	V350256906L2C004R03100153569_chr1_385779	21	58	cccc	tgga
V350256906L2C004R03100184055	chr1	1119682	50M	134	1119816	1119683	1119817	V350256906L2C004R03100184055_chr1_1119682	449	583	CGTG	TCAG
V350256906L2C004R03100542814	chr1	88419	50M	181	88600	88420	88601	V350256906L2C004R03100542814_chr1_88419	0	0	ggcc	tctg
V350256906L2C004R03100593043	chr1	350709	50M	172	350881	350710	350882	V350256906L2C004R03100593043_chr1_350709	42	19	CTGT	tgtt
V350256906L2C004R03100726001	chr1	28715	50M	194	28909	28716	28910	V350256906L2C004R03100726001_chr1_28715	5	23	CAGG	GGAG
V350256906L2C004R03100928514	chr1	1332384	50M	252	1332636	1332385	1332637	V350256906L2C004R03100928514_chr1_1332384	35	0	ccca	CCAG
V350256906L2C004R03101133225	chr1	1073939	11M3D39M	166	1074105	1073940	1074106	V350256906L2C004R03101133225_chr1_1073939	27	49	gact	CCGA
V350256906L2C004R03200534165	chr1	333680	50M	171	333851	333681	333852	V350256906L2C004R03200534165_chr1_333680	30	16	tggg	cctg
V350256906L2C004R03200624847	chr1	324496	50M	166	324662	324497	324663	V350256906L2C004R03200624847_chr1_324496	163	0	ACCA	CAGG
V350256906L2C004R03200645983	chr1	452124	50M	134	452258	452125	452259	V350256906L2C004R03200645983_chr1_452124	95	126	tatg	gaaa
V350256906L2C004R03200890557	chr1	449229	50M	150	449379	449230	449380	V350256906L2C004R03200890557_chr1_449229	125	275	gggg	AGCA
V350256906L2C004R03201095556	chr1	1265183	50M	160	1265343	1265184	1265344	V350256906L2C004R03201095556_chr1_1265183	48	208	tgca	CACA
V350256906L2C004R03300061874	chr1	793129	50M	160	793289	793130	793290	V350256906L2C004R03300061874_chr1_793129	0	53	CCCC	ACCT
V350256906L2C004R03300562785	chr1	1211722	50M	159	1211881	1211723	1211882	V350256906L2C004R03300562785_chr1_1211722	20	38	ggct	actt
V350256906L2C004R03300617093	chr1	257651	50M	176	257827	257652	257828	V350256906L2C004R03300617093_chr1_257651	78	70	cctg	GTAT
V350256906L2C004R03301124311	chr1	1022830	50M	172	1023002	1022831	1023003	V350256906L2C004R03301124311_chr1_1022830	58	75	TCCC	ATGC
V350256906L2C004R03400575473	chr1	856245	50M	181	856426	856246	856427	V350256906L2C004R03400575473_chr1_856245	0	19	GACA	TAGA
V350256906L2C004R03401202526	chr1	1395915	50M	162	1396077	1395916	1396078	V350256906L2C004R03401202526_chr1_1395915	20	13	CCCA	CAGG
V350256906L2C004R03500044675	chr1	110982	50M	145	111127	110983	111128	V350256906L2C004R03500044675_chr1_110982	57	60	TGAA	cctc
V350256906L2C004R03500794375	chr1	914273	50M	185	914458	914274	914459	V350256906L2C004R03500794375_chr1_914273	77	68	GAGC	CGTG
V350256906L2C004R03500804443	chr1	605941	50M	254	606195	605942	606196	V350256906L2C004R03500804443_chr1_605941	14	24	gaga	tact
V350256906L2C004R03500869844	chr1	1169073	50M	212	1169285	1169074	1169286	V350256906L2C004R03500869844_chr1_1169073	11	0	ATTT	CAGA
V350256906L2C004R03501276484	chr1	372585	50M	173	372758	372586	372759	V350256906L2C004R03501276484_chr1_372585	112	285	ctcc	acaa
V350256906L2C004R03600034048	chr1	1091193	50M	166	1091359	1091194	1091360	V350256906L2C004R03600034048_chr1_1091193	43	12	GCTT	gccc
V350256906L2C004R03600120902	chr1	888839	50M	135	888974	888840	888975	V350256906L2C004R03600120902_chr1_888839	43	0	GGTG	CCTG
V350256906L2C004R03600654354	chr1	1328367	50M	184	1328551	1328368	1328552	V350256906L2C004R03600654354_chr1_1328367	8	0	CATG	TCCC
V350256906L2C004R03600766391	chr1	371678	50M	195	371873	371679	371874	V350256906L2C004R03600766391_chr1_371678	0	22	CCTC	TCCT
V350256906L2C004R03600976754	chr1	521987	50M	166	522153	521988	522154	V350256906L2C004R03600976754_chr1_521987	0	0	gaag	cctg
V350256906L2C004R03700224026	chr1	1116659	50M	173	1116832	1116660	1116833	V350256906L2C004R03700224026_chr1_1116659	17	13	CCAA	CCAA
V350256906L2C004R03700523074	chr1	564516	50M	167	564683	564517	564684	V350256906L2C004R03700523074_chr1_564516	0	37	CGCC	CTGT
V350256906L2C004R03700698031	chr1	785931	50M	159	786090	785932	786091	V350256906L2C004R03700698031_chr1_785931	25	27	CTGC	tgta
V350256906L2C004R03700833341	chr1	318745	50M	143	318888	318746	318889	V350256906L2C004R03700833341_chr1_318745	40	57	ctca	ctag
V350256906L2C004R03700938396	chr1	888987	50M	159	889146	888988	889147	V350256906L2C004R03700938396_chr1_888987	0	16	AGAC	CCTC
V350256906L2C004R03701109160	chr1	1113630	50M	171	1113801	1113631	1113802	V350256906L2C004R03701109160_chr1_1113630	0	14	CCTT	ccca
V350256906L2C004R03800184528	chr1	470585	50M	147	470732	470586	470733	V350256906L2C004R03800184528_chr1_470585	31	78	ccca	ctga
V350256906L2C004R03800367876	chr1	1264362	50M	157	1264519	1264363	1264520	V350256906L2C004R03800367876_chr1_1264362	8	34	GGTG	CAAC
V350256906L2C004R03800575461	chr1	1300701	50M	161	1300862	1300702	1300863	V350256906L2C004R03800575461_chr1_1300701	322	161	tgtc	tgta
V350256906L2C004R03800616245	chr1	1398074	50M	182	1398256	1398075	1398257	V350256906L2C004R03800616245_chr1_1398074	28	18	GCCG	CGTG
V350256906L2C004R03801370355	chr1	1425377	50M	166	1425543	1425378	1425544	V350256906L2C004R03801370355_chr1_1425377	28	61	TGGG	TGGG
V350256906L2C004R03900018590	chr1	261135	50M	162	261297	261136	261298	V350256906L2C004R03900018590_chr1_261135	57	5	CTAT	TGAA
V350256906L2C004R03900168687	chr1	467251	50M	159	467410	467252	467411	V350256906L2C004R03900168687_chr1_467251	5	48	agag	gaat
V350256906L2C004R03900256700	chr1	631724	50M	194	631918	631725	631919	V350256906L2C004R03900256700_chr1_631724	16	10	ggct	gata
V350256906L2C004R03900702061	chr1	1083517	50M	159	1083676	1083518	1083677	V350256906L2C004R03900702061_chr1_1083517	21	66	caat	AGGG
V350256906L2C004R03901215863	chr1	832676	50M	176	832852	832677	832853	V350256906L2C004R03901215863_chr1_832676	62	42	aggc	tgaa
V350256906L2C004R04000017658	chr1	1313667	50M	132	1313799	1313668	1313800	V350256906L2C004R04000017658_chr1_1313667	71	37	agca	gaac
V350256906L2C004R04000464943	chr1	1361954	50M	168	1362122	1361955	1362123	V350256906L2C004R04000464943_chr1_1361954	168	220	CCCA	TGTT
V350256906L2C004R04000467242	chr1	1389513	50M	163	1389676	1389514	1389677	V350256906L2C004R04000467242_chr1_1389513	43	16	CCTG	CCTA
V350256906L2C004R04100080438	chr1	725001	50M	154	725155	725002	725156	V350256906L2C004R04100080438_chr1_725001	31	114	cgaa	ttcg
V350256906L2C004R04100471922	chr1	1082159	50M	172	1082331	1082160	1082332	V350256906L2C004R04100471922_chr1_1082159	0	60	CACG	CCTG
V350256906L2C004R04100728706	chr1	903338	50M	166	903504	903339	903505	V350256906L2C004R04100728706_chr1_903338	18	44	GAGG	CACA
V350256906L2C004R04100953530	chr1	344890	50M	133	345023	344891	345024	V350256906L2C004R04100953530_chr1_344890	3	28	gctt	tatt
V350256906L2C004R04100969840	chr1	1302836	50M	202	1303038	1302837	1303039	V350256906L2C004R04100969840_chr1_1302836	96	73	AGAG	CCAA
V350256906L2C004R04200509141	chr1	858622	50M	151	858773	858623	858774	V350256906L2C004R04200509141_chr1_858622	142	267	CCCC	agta
V350256906L2C004R04201018772	chr1	373578	50M	172	373750	373579	373751	V350256906L2C004R04201018772_chr1_373578	81	60	tcat	ctcc
V350256906L2C004R04201328712	chr1	1297134	50M	185	1297319	1297135	1297320	V350256906L2C004R04201328712_chr1_1297134	60	57	AGAG	TCTT
V350256906L2C004R04300002702	chr1	54310	50M	151	54461	54311	54462	V350256906L2C004R04300002702_chr1_54310	73	59	GTTT	GCAG
V350256906L2C004R04300227685	chr1	711130	50M	160	711290	711131	711291	V350256906L2C004R04300227685_chr1_711130	145	0	ggag	GCTG
V350256906L2C004R04300266507	chr1	960000	50M	185	960185	960001	960186	V350256906L2C004R04300266507_chr1_960000	58	65	CCCC	CCCT
V350256906L2C004R04300929776	chr1	1184984	50M	165	1185149	1184985	1185150	V350256906L2C004R04300929776_chr1_1184984	44	54	GGAC	tgtt
V350256906L2C004R04301017134	chr1	20683	50M	164	20847	20684	20848	V350256906L2C004R04301017134_chr1_20683	32	30	GCTA	GCTC
V350256906L2C004R04301069733	chr1	656196	50M	168	656364	656197	656365	V350256906L2C004R04301069733_chr1_656196	46	61	aggt	ccca
V350256906L2C004R04301209461	chr1	1327832	50M	167	1327999	1327833	1328000	V350256906L2C004R04301209461_chr1_1327832	0	1	CCAA	TGTT
V350256906L2C004R04400087363	chr1	1040177	50M	159	1040336	1040178	1040337	V350256906L2C004R04400087363_chr1_1040177	22	54	gagc	tgga
V350256906L2C004R04400593435	chr1	680500	50M	142	680642	680501	680643	V350256906L2C004R04400593435_chr1_680500	111	77	gaag	cttt
V350256906L2C004R04400745877	chr1	149767	50M	167	149934	149768	149935	V350256906L2C004R04400745877_chr1_149767	19	0	CAAG	tctt
V350256906L2C004R04400761607	chr1	1269447	50M	178	1269625	1269448	1269626	V350256906L2C004R04400761607_chr1_1269447	54	54	ACTG	GGCA
V350256906L2C004R04400778546	chr1	261712	50M	175	261887	261713	261888	V350256906L2C004R04400778546_chr1_261712	59	0	tgag	TATA
V350256906L2C004R04401106909	chr1	128241	50M	173	128414	128242	128415	V350256906L2C004R04401106909_chr1_128241	113	7	AAAA	TGTG
V350256906L2C004R04500361448	chr1	904304	50M	177	904481	904305	904482	V350256906L2C004R04500361448_chr1_904304	10	14	CGTT	caaa
V350256906L2C004R04500967681	chr1	808258	50M	153	808411	808259	808412	V350256906L2C004R04500967681_chr1_808258	0	41	CATC	GCAG
V350256906L2C004R04501108695	chr1	990461	50M	192	990653	990462	990654	V350256906L2C004R04501108695_chr1_990461	70	72	CTGC	CTGC
V350256906L2C004R04501234364	chr1	61354	50M	179	61533	61355	61534	V350256906L2C004R04501234364_chr1_61354	0	38	AAAA	TAAT
V350256906L2C004R04600070150	chr1	1060939	50M	149	1061088	1060940	1061089	V350256906L2C004R04600070150_chr1_1060939	71	175	GGAA	CCAG
V350256906L2C004R04600272014	chr1	833179	50M	143	833322	833180	833323	V350256906L2C004R04600272014_chr1_833179	13	64	ctgg	ttgt
V350256906L2C004R04600470345	chr1	367893	50M	148	368041	367894	368042	V350256906L2C004R04600470345_chr1_367893	67	58	CCCA	TACA
V350256906L2C004R04600705651	chr1	261422	50M	155	261577	261423	261578	V350256906L2C004R04600705651_chr1_261422	23	49	caat	TTTA
V350256906L2C004R04600708419	chr1	1347396	50M	178	1347574	1347397	1347575	V350256906L2C004R04600708419_chr1_1347396	202	24	ccca	cctg
V350256906L2C004R04600725642	chr1	67283	50M	172	67455	67284	67456	V350256906L2C004R04600725642_chr1_67283	54	46	CTTT	TATT
V350256906L2C004R04600772811	chr1	87002	50M	171	87173	87003	87174	V350256906L2C004R04600772811_chr1_87002	36	38	ccaa	cacc
V350256906L2C004R04600828793	chr1	916691	50M	163	916854	916692	916855	V350256906L2C004R04600828793_chr1_916691	0	0	TGCG	TGAA
V350256906L2C004R04601033947	chr1	1319919	50M	174	1320093	1319920	1320094	V350256906L2C004R04601033947_chr1_1319919	156	0	gcca	gaaa
V350256906L2C004R04601175179	chr1	1334719	50M	184	1334903	1334720	1334904	V350256906L2C004R04601175179_chr1_1334719	45	26	CTCA	CCCT
V350256906L2C004R04700002293	chr1	1417436	50M	191	1417627	1417437	1417628	V350256906L2C004R04700002293_chr1_1417436	26	0	TGGC	CGGA
V350256906L2C004R04700093633	chr1	805067	50M	167	805234	805068	805235	V350256906L2C004R04700093633_chr1_805067	60	37	catc	CCCG
V350256906L2C004R04700242396	chr1	992632	50M	164	992796	992633	992797	V350256906L2C004R04700242396_chr1_992632	21	57	agct	AGAC
V350256906L2C004R04700542317	chr1	647833	50M	166	647999	647834	648000	V350256906L2C004R04700542317_chr1_647833	14	41	ctga	aaag
V350256906L2C004R04700841016	chr1	847016	50M	162	847178	847017	847179	V350256906L2C004R04700841016_chr1_847016	134	0	CACC	ATCC
V350256906L2C004R04700950396	chr1	986871	50M	179	987050	986872	987051	V350256906L2C004R04700950396_chr1_986871	13	141	CGTG	CCCC
V350256906L2C004R04701290492	chr1	726831	9S41M	172	727003	726832	727004	V350256906L2C004R04701290492_chr1_726831	0	0	aatg	gtcc
V350256906L2C004R04800259241	chr1	819268	50M	192	819460	819269	819461	V350256906L2C004R04800259241_chr1_819268	59	38	gcaa	agaa
V350256906L2C004R04800285687	chr1	941303	50M	160	941463	941304	941464	V350256906L2C004R04800285687_chr1_941303	0	0	CCTG	GGGG
V350256906L2C004R04800829497	chr1	96611	50M	173	96784	96612	96785	V350256906L2C004R04800829497_chr1_96611	0	9	AAAA	CTTT
V350256906L2C004R04800848790	chr1	756549	50M	186	756735	756550	756736	V350256906L2C004R04800848790_chr1_756549	118	121	CCTG	GGGC
V350256906L2C004R04801276333	chr1	1430999	50M	160	1431159	1431000	1431160	V350256906L2C004R04801276333_chr1_1430999	2	48	CCCC	GCCA
V350256906L2C004R04900333730	chr1	1038224	50M	162	1038386	1038225	1038387	V350256906L2C004R04900333730_chr1_1038224	0	108	caag	caac
V350256906L2C004R04900335843	chr1	461306	50M	136	461442	461307	461443	V350256906L2C004R04900335843_chr1_461306	186	193	caag	cccc
V350256906L2C004R04900628362	chr1	342525	50M	177	342702	342526	342703	V350256906L2C004R04900628362_chr1_342525	65	145	TTAC	CCAA
V350256906L2C004R04900670764	chr1	1227639	26M4D24M	147	1227786	1227640	1227787	V350256906L2C004R04900670764_chr1_1227639	48	65	CCCT	AAGC
V350256906L2C004R04900670849	chr1	14020	50M	182	14202	14021	14203	V350256906L2C004R04900670849_chr1_14020	95	44	CTGG	AAAA
V350256906L2C004R04900766734	chr1	19875	50M	161	20036	19876	20037	V350256906L2C004R04900766734_chr1_19875	77	238	CCCA	agtg
V350256906L2C004R04900769557	chr1	765487	50M	207	765694	765488	765695	V350256906L2C004R04900769557_chr1_765487	65	47	ctta	cagt
V350256906L2C004R04901335958	chr1	74692	50M	187	74879	74693	74880	V350256906L2C004R04901335958_chr1_74692	433	246	tgtt	aaag
V350256906L2C004R05000083713	chr1	1088259	50M	158	1088417	1088260	1088418	V350256906L2C004R05000083713_chr1_1088259	99	61	CACA	CCAA
V350256906L2C004R05000976769	chr1	843479	50M	174	843653	843480	843654	V350256906L2C004R05000976769_chr1_843479	0	154	agtg	CCGC
V350256906L2C004R05001003479	chr1	770334	50M	235	770569	770335	770570	V350256906L2C004R05001003479_chr1_770334	134	45	tcca	TAGA
V350256906L2C004R05001004802	chr1	1211821	50M	165	1211986	1211822	1211987	V350256906L2C004R05001004802_chr1_1211821	30	31	gata	tcag
V350256906L2C004R05100309729	chr1	794630	50M	173	794803	794631	794804	V350256906L2C004R05100309729_chr1_794630	54	60	AATG	cact
V350256906L2C004R05100520152	chr1	234695	50M	173	234868	234696	234869	V350256906L2C004R05100520152_chr1_234695	0	0	TTAT	AGAA
V350256906L2C004R05100574247	chr1	824356	50M	178	824534	824357	824535	V350256906L2C004R05100574247_chr1_824356	6	72	cccc	aagg
V350256906L2C004R05101007086	chr1	263821	50M	157	263978	263822	263979	V350256906L2C004R05101007086_chr1_263821	0	30	TAAA	tcca
V350256906L2C004R05101018729	chr1	1198720	50M	183	1198903	1198721	1198904	V350256906L2C004R05101018729_chr1_1198720	30	17	CCTT	ATTT
V350256906L2C004R05101109127	chr1	602957	50M	170	603127	602958	603128	V350256906L2C004R05101109127_chr1_602957	36	2	taaa	gcta
V350256906L2C004R05101268376	chr1	878244	50M	179	878423	878245	878424	V350256906L2C004R05101268376_chr1_878244	73	55	CACA	GCTG
V350256906L2C004R05101375420	chr1	744757	50M	135	744892	744758	744893	V350256906L2C004R05101375420_chr1_744757	52	46	ccaa	tgtt
V350256906L2C004R05200085009	chr1	845724	50M	147	845871	845725	845872	V350256906L2C004R05200085009_chr1_845724	30	177	cAGC	CCCA
V350256906L2C004R05200401070	chr1	1320492	50M	189	1320681	1320493	1320682	V350256906L2C004R05200401070_chr1_1320492	13	12	tggt	ctac
V350256906L2C004R05200447995	chr1	352046	50M	184	352230	352047	352231	V350256906L2C004R05200447995_chr1_352046	131	181	caag	cacc
V350256906L2C004R05200539864	chr1	33707	50M	164	33871	33708	33872	V350256906L2C004R05200539864_chr1_33707	170	36	tgat	catt
V350256906L2C004R05200547922	chr1	973530	50M	140	973670	973531	973671	V350256906L2C004R05200547922_chr1_973530	9	0	CACC	CTCC
V350256906L2C004R05200631682	chr1	82296	50M	166	82462	82297	82463	V350256906L2C004R05200631682_chr1_82296	83	188	taac	cacc
V350256906L2C004R05200978066	chr1	249647	50M	151	249798	249648	249799	V350256906L2C004R05200978066_chr1_249647	78	38	catt	ccaa
V350256906L2C004R05300353259	chr1	1383759	50M	135	1383894	1383760	1383895	V350256906L2C004R05300353259_chr1_1383759	37	76	cgat	cctg
V350256906L2C004R05300672428	chr1	428375	50M	171	428546	428376	428547	V350256906L2C004R05300672428_chr1_428375	40	57	cagt	aaag
V350256906L2C004R05300732289	chr1	1118356	50M	137	1118493	1118357	1118494	V350256906L2C004R05300732289_chr1_1118356	12	20	CCGG	CTGC
V350256906L2C004R05300842557	chr1	411700	50M	173	411873	411701	411874	V350256906L2C004R05300842557_chr1_411700	174	1	TATC	ggtg
V350256906L2C004R05300906942	chr1	12126	50M	165	12291	12127	12292	V350256906L2C004R05300906942_chr1_12126	3	0	GGCC	AGCT
V350256906L2C004R05300938894	chr1	384721	50M	179	384900	384722	384901	V350256906L2C004R05300938894_chr1_384721	178	0	tgtg	tgga
V350256906L2C004R05301256387	chr1	620540	50M	193	620733	620541	620734	V350256906L2C004R05301256387_chr1_620540	46	54	ctct	cata
V350256906L2C004R05301260430	chr1	1384024	50M	141	1384165	1384025	1384166	V350256906L2C004R05301260430_chr1_1384024	28	8	tgtg	aaaa
V350256906L2C004R05400352608	chr1	1233896	50M	204	1234100	1233897	1234101	V350256906L2C004R05400352608_chr1_1233896	0	3	GACC	CCTG
V350256906L2C004R05400543683	chr1	547900	50M	155	548055	547901	548056	V350256906L2C004R05400543683_chr1_547900	10	8	TGAC	ccag
V350256906L2C004R05400606991	chr1	868202	50M	168	868370	868203	868371	V350256906L2C004R05400606991_chr1_868202	0	9	TCTG	CCCA
V350256906L2C004R05400727542	chr1	1028491	50M	206	1028697	1028492	1028698	V350256906L2C004R05400727542_chr1_1028491	11	38	TGAA	cctg
V350256906L2C004R05400979865	chr1	816123	50M	173	816296	816124	816297	V350256906L2C004R05400979865_chr1_816123	77	42	gggt	aacc
V350256906L2C004R05500137096	chr1	1406356	50M	169	1406525	1406357	1406526	V350256906L2C004R05500137096_chr1_1406356	58	74	tgtg	caag
V350256906L2C004R05500139942	chr1	660698	50M	180	660878	660699	660879	V350256906L2C004R05500139942_chr1_660698	185	282	ccca	GCTA
V350256906L2C004R05500274401	chr1	540133	50M	104	540237	540134	540238	V350256906L2C004R05500274401_chr1_540133	23	44	aaca	ctca
V350256906L2C004R05500471589	chr1	1002984	50M	268	1003252	1002985	1003253	V350256906L2C004R05500471589_chr1_1002984	62	2	CACG	CCGA
V350256906L2C004R05500611284	chr1	552073	50M	156	552229	552074	552230	V350256906L2C004R05500611284_chr1_552073	33	14	TCTC	cact
V350256906L2C004R05501029303	chr1	585317	50M	171	585488	585318	585489	V350256906L2C004R05501029303_chr1_585317	60	70	accc	ccag
V350256906L2C004R05501245367	chr1	932717	50M	183	932900	932718	932901	V350256906L2C004R05501245367_chr1_932717	30	69	TCCC	GAAG
V350256906L2C004R05501285798	chr1	1152092	50M	167	1152259	1152093	1152260	V350256906L2C004R05501285798_chr1_1152092	21	24	CCCC	CAGC
V350256906L2C004R05501333000	chr1	436062	50M	174	436236	436063	436237	V350256906L2C004R05501333000_chr1_436062	69	60	ctcc	TGAG
V350256906L2C004R05600090457	chr1	787586	50M	206	787792	787587	787793	V350256906L2C004R05600090457_chr1_787586	81	49	TACT	CCAA
V350256906L2C004R05600212874	chr1	690191	50M	194	690385	690192	690386	V350256906L2C004R05600212874_chr1_690191	0	0	gaat	catc
V350256906L2C004R05600363402	chr1	74250	50M	162	74412	74251	74413	V350256906L2C004R05600363402_chr1_74250	51	213	ggac	cctc
V350256906L2C004R05600380521	chr1	1390602	50M	156	1390758	1390603	1390759	V350256906L2C004R05600380521_chr1_1390602	30	70	aaaa	GCAG
V350256906L2C004R05600515026	chr1	339155	50M	170	339325	339156	339326	V350256906L2C004R05600515026_chr1_339155	10	0	ggag	gacc
V350256906L2C004R05600704317	chr1	90254	50M	152	90406	90255	90407	V350256906L2C004R05600704317_chr1_90254	134	177	CCTC	GGTT
V350256906L2C004R05600806743	chr1	1034438	50M	151	1034589	1034439	1034590	V350256906L2C004R05600806743_chr1_1034438	28	57	tgtc	gaca
V350256906L2C004R05600808043	chr1	777708	50M	148	777856	777709	777857	V350256906L2C004R05600808043_chr1_777708	0	25	TGAA	CCAG
V350256906L2C004R05700403765	chr1	701268	50M	175	701443	701269	701444	V350256906L2C004R05700403765_chr1_701268	0	82	AAAT	TGCA
V350256906L2C004R05700764039	chr1	824940	50M	184	825124	824941	825125	V350256906L2C004R05700764039_chr1_824940	90	50	GCTC	CATT
V350256906L2C004R05701277065	chr1	1409017	50M	122	1409139	1409018	1409140	V350256906L2C004R05701277065_chr1_1409017	13	58	aggc	actt
V350256906L2C004R05701365445	chr1	382360	50M	207	382567	382361	382568	V350256906L2C004R05701365445_chr1_382360	54	49	tctc	caaa
V350256906L2C004R05800258314	chr1	1063251	50M	168	1063419	1063252	1063420	V350256906L2C004R05800258314_chr1_1063251	48	80	CCAC	CAGG
V350256906L2C004R05800582270	chr1	409079	50M	171	409250	409080	409251	V350256906L2C004R05800582270_chr1_409079	52	75	AGCT	CCCA
V350256906L2C004R05800709618	chr1	1320743	50M	133	1320876	1320744	1320877	V350256906L2C004R05800709618_chr1_1320743	61	46	ctca	cgag
V350256906L2C004R05801212879	chr1	653322	50M	179	653501	653323	653502	V350256906L2C004R05801212879_chr1_653322	107	0	ctaa	aaaa
V350256906L2C004R05900098502	chr1	75972	50M	164	76136	75973	76137	V350256906L2C004R05900098502_chr1_75972	0	1	tcac	cacg
V350256906L2C004R05900465889	chr1	401685	50M	147	401832	401686	401833	V350256906L2C004R05900465889_chr1_401685	29	32	gatt	gaaa
V350256906L2C004R05900618308	chr1	1041586	50M	172	1041758	1041587	1041759	V350256906L2C004R05900618308_chr1_1041586	74	42	accc	cgtt
V350256906L2C004R05900680388	chr1	153591	50M	184	153775	153592	153776	V350256906L2C004R05900680388_chr1_153591	29	0	tgta	ttat
V350256906L2C004R05900712944	chr1	581031	50M	174	581205	581032	581206	V350256906L2C004R05900712944_chr1_581031	66	55	ACAC	catg
V350256906L2C004R05901129308	chr1	1049550	50M	202	1049752	1049551	1049753	V350256906L2C004R05901129308_chr1_1049550	29	24	ccac	cctc
V350256906L2C004R05901216038	chr1	628218	50M	207	628425	628219	628426	V350256906L2C004R05901216038_chr1_628218	21	15	ATTT	ACCT
V350256906L2C004R05901360502	chr1	725634	50M	180	725814	725635	725815	V350256906L2C004R05901360502_chr1_725634	118	69	ctcg	tcca
V350256906L2C004R06000083557	chr1	1264489	50M	166	1264655	1264490	1264656	V350256906L2C004R06000083557_chr1_1264489	64	63	CCCA	CCCC
V350256906L2C004R06000179819	chr1	876037	50M	164	876201	876038	876202	V350256906L2C004R06000179819_chr1_876037	5	20	CGAC	CGAG
V350256906L2C004R06000873801	chr1	76337	50M	140	76477	76338	76478	V350256906L2C004R06000873801_chr1_76337	115	235	gcta	cccc
V350256906L2C004R06000881450	chr1	263916	50M	175	264091	263917	264092	V350256906L2C004R06000881450_chr1_263916	78	46	CTAG	tgtg
V350256906L2C004R06100043322	chr1	410540	50M	132	410672	410541	410673	V350256906L2C004R06100043322_chr1_410540	253	121	CAAT	TCCT
V350256906L2C004R06100193911	chr1	455242	50M	189	455431	455243	455432	V350256906L2C004R06100193911_chr1_455242	125	43	CCCT	GGAG
V350256906L2C004R06100468228	chr1	124150	50M	174	124324	124151	124325	V350256906L2C004R06100468228_chr1_124150	68	34	tctc	gaac
V350256906L2C004R06100497910	chr1	742000	50M	172	742172	742001	742173	V350256906L2C004R06100497910_chr1_742000	26	37	AAAT	GTAG
V350256906L2C004R06101005012	chr1	600304	50M	150	600454	600305	600455	V350256906L2C004R06101005012_chr1_600304	39	70	cata	gaaa
V350256906L2C004R06101076396	chr1	1048575	50M	168	1048743	1048576	1048744	V350256906L2C004R06101076396_chr1_1048575	23	62	caaa	TGGA
V350256906L2C004R06200185898	chr1	426821	50M	157	426978	426822	426979	V350256906L2C004R06200185898_chr1_426821	22	20	GGAG	CTGG
V350256906L2C004R06200470323	chr1	619424	50M	183	619607	619425	619608	V350256906L2C004R06200470323_chr1_619424	28	34	ccca	tatt
V350256906L2C004R06200800798	chr1	946624	50M	167	946791	946625	946792	V350256906L2C004R06200800798_chr1_946624	45	6	cagg	AGGT
V350256906L2C004R06200898404	chr1	350476	50M	166	350642	350477	350643	V350256906L2C004R06200898404_chr1_350476	59	40	TAAT	GCTC
V350256906L2C004R06201213234	chr1	1324098	50M	180	1324278	1324099	1324279	V350256906L2C004R06201213234_chr1_1324098	48	152	ccca	ctcc
V350256906L2C004R06300031925	chr1	103981	50M	145	104126	103982	104127	V350256906L2C004R06300031925_chr1_103981	0	13	ctcg	aaga
V350256906L2C004R06300066727	chr1	1055028	50M	179	1055207	1055029	1055208	V350256906L2C004R06300066727_chr1_1055028	72	67	ttta	cctg
V350256906L2C004R06300410902	chr1	837831	50M	188	838019	837832	838020	V350256906L2C004R06300410902_chr1_837831	13	8	CCCA	cagc
V350256906L2C004R06300541465	chr1	1132333	50M	168	1132501	1132334	1132502	V350256906L2C004R06300541465_chr1_1132333	0	10	TCAG	GGTT
V350256906L2C004R06300755925	chr1	61371	50M	157	61528	61372	61529	V350256906L2C004R06300755925_chr1_61371	2	43	TATA	ACAA
V350256906L2C004R06300792177	chr1	823928	50M	184	824112	823929	824113	V350256906L2C004R06300792177_chr1_823928	67	53	gagg	CTGG
V350256906L2C004R06300881251	chr1	1127364	50M	136	1127500	1127365	1127501	V350256906L2C004R06300881251_chr1_1127364	94	0	ccca	ccta
V350256906L2C004R06400117674	chr1	424027	50M	170	424197	424028	424198	V350256906L2C004R06400117674_chr1_424027	135	0	gaat	TGAT
V350256906L2C004R06400149206	chr1	1414522	50M	167	1414689	1414523	1414690	V350256906L2C004R06400149206_chr1_1414522	33	36	CCCT	tgta
V350256906L2C004R06400178194	chr1	922999	50M	247	923246	923000	923247	V350256906L2C004R06400178194_chr1_922999	142	55	tatc	caac
V350256906L2C004R06400672557	chr1	773599	50M	166	773765	773600	773766	V350256906L2C004R06400672557_chr1_773599	63	54	agtt	ctct
V350256906L2C004R06400797031	chr1	808714	50M	176	808890	808715	808891	V350256906L2C004R06400797031_chr1_808714	24	6	CAGA	GTTT
V350256906L2C004R06401183754	chr1	1090016	50M	197	1090213	1090017	1090214	V350256906L2C004R06401183754_chr1_1090016	99	71	aaat	gtaa
V350256906L2C004R06500188892	chr1	544151	50M	167	544318	544152	544319	V350256906L2C004R06500188892_chr1_544151	135	96	TGTA	CCGT
V350256906L2C004R06500401378	chr1	1149201	50M	123	1149324	1149202	1149325	V350256906L2C004R06500401378_chr1_1149201	0	63	CCCA	GGGA
V350256906L2C004R06500406779	chr1	830542	50M	224	830766	830543	830767	V350256906L2C004R06500406779_chr1_830542	32	10	ccac	acaa
V350256906L2C004R06500469995	chr1	1264502	50M	165	1264667	1264503	1264668	V350256906L2C004R06500469995_chr1_1264502	51	65	CATC	GGCT
V350256906L2C004R06500485260	chr1	163878	50M	183	164061	163879	164062	V350256906L2C004R06500485260_chr1_163878	34	81	ccag	cttc
V350256906L2C004R06500608672	chr1	917861	50M	181	918042	917862	918043	V350256906L2C004R06500608672_chr1_917861	0	3	TGTG	TGTT
V350256906L2C004R06500616695	chr1	252873	50M	168	253041	252874	253042	V350256906L2C004R06500616695_chr1_252873	172	4	GGAA	GCAA
V350256906L2C004R06500676466	chr1	892999	50M	155	893154	893000	893155	V350256906L2C004R06500676466_chr1_892999	10	0	gcaa	cctt
V350256906L2C004R06501004069	chr1	768007	50M	145	768152	768008	768153	V350256906L2C004R06501004069_chr1_768007	36	173	CCAG	aaaa
V350256906L2C004R06501050766	chr1	1055049	50M	158	1055207	1055050	1055208	V350256906L2C004R06501050766_chr1_1055049	51	67	acaa	cctg
V350256906L2C004R06501196598	chr1	1430839	50M	183	1431022	1430840	1431023	V350256906L2C004R06501196598_chr1_1430839	54	0	CCCT	CGCC
V350256906L2C004R06600013031	chr1	579084	50M	190	579274	579085	579275	V350256906L2C004R06600013031_chr1_579084	34	145	CAAT	CTTA
V350256906L2C004R06600060540	chr1	677641	50M	171	677812	677642	677813	V350256906L2C004R06600060540_chr1_677641	0	48	gcct	caat
V350256906L2C004R06600112102	chr1	385004	50M	181	385185	385005	385186	V350256906L2C004R06600112102_chr1_385004	7	13	cctg	caca
V350256906L2C004R06600263646	chr1	1361445	50M	159	1361604	1361446	1361605	V350256906L2C004R06600263646_chr1_1361445	156	0	GCCC	CTGG
V350256906L2C004R06600353738	chr1	631183	50M	189	631372	631184	631373	V350256906L2C004R06600353738_chr1_631183	0	0	CTCT	ttta
V350256906L2C004R06600438779	chr1	430324	50M	168	430492	430325	430493	V350256906L2C004R06600438779_chr1_430324	36	82	atgc	cttg
V350256906L2C004R06600600288	chr1	1431375	50M	151	1431526	1431376	1431527	V350256906L2C004R06600600288_chr1_1431375	20	35	CTTT	GACC
V350256906L2C004R06600868721	chr1	448435	50M	178	448613	448436	448614	V350256906L2C004R06600868721_chr1_448435	20	52	caac	ccgg
V350256906L2C004R06600924717	chr1	648334	50M	166	648500	648335	648501	V350256906L2C004R06600924717_chr1_648334	0	0	CTAC	CCCA
V350256906L2C004R06601005621	chr1	755741	50M	159	755900	755742	755901	V350256906L2C004R06601005621_chr1_755741	0	144	CTAC	CTGC
V350256906L2C004R06601027726	chr1	523709	50M	175	523884	523710	523885	V350256906L2C004R06601027726_chr1_523709	183	164	CTTG	CCTT
V350256906L2C004R06700220909	chr1	1054037	50M	200	1054237	1054038	1054238	V350256906L2C004R06700220909_chr1_1054037	29	52	TCTA	CTGG
V350256906L2C004R06700232432	chr1	1213477	50M	146	1213623	1213478	1213624	V350256906L2C004R06700232432_chr1_1213477	150	4	ggat	gaga
V350256906L2C004R06700253514	chr1	1096060	50M	136	1096196	1096061	1096197	V350256906L2C004R06700253514_chr1_1096060	28	70	TGGG	GGCT
V350256906L2C004R06700758762	chr1	361038	50M	163	361201	361039	361202	V350256906L2C004R06700758762_chr1_361038	0	0	CCAC	tcca
V350256906L2C004R06701130739	chr1	924233	50M	127	924360	924234	924361	V350256906L2C004R06701130739_chr1_924233	231	104	GGGG	ACCC
V350256906L2C004R06701164497	chr1	795803	50M	166	795969	795804	795970	V350256906L2C004R06701164497_chr1_795803	65	52	cctg	CAGG
V350256906L2C004R06701177247	chr1	444314	50M	146	444460	444315	444461	V350256906L2C004R06701177247_chr1_444314	35	81	cgtc	tgtc
V350256906L2C004R06800171280	chr1	768393	50M	168	768561	768394	768562	V350256906L2C004R06800171280_chr1_768393	55	5	ccaa	TAGG
V350256906L2C004R06800290716	chr1	573950	50M	154	574104	573951	574105	V350256906L2C004R06800290716_chr1_573950	69	0	GGAA	cttg
V350256906L2C004R06800310106	chr1	1426087	50M	201	1426288	1426088	1426289	V350256906L2C004R06800310106_chr1_1426087	64	61	CCCC	CCCC
V350256906L2C004R06800429376	chr1	769078	50M	161	769239	769079	769240	V350256906L2C004R06800429376_chr1_769078	0	22	GGTT	TGTG
V350256906L2C004R06800572006	chr1	260972	50M	170	261142	260973	261143	V350256906L2C004R06800572006_chr1_260972	180	50	CACA	TTCA
V350256906L2C004R06800578892	chr1	452463	50M	183	452646	452464	452647	V350256906L2C004R06800578892_chr1_452463	3	14	TGAT	CAAG
V350256906L2C004R06800866661	chr1	1325632	50M	163	1325795	1325633	1325796	V350256906L2C004R06800866661_chr1_1325632	58	67	CCCC	CAGA
V350256906L2C004R06801249729	chr1	531453	50M	162	531615	531454	531616	V350256906L2C004R06801249729_chr1_531453	61	55	tact	ggag
V350256906L2C004R06900375562	chr1	438579	50M	158	438737	438580	438738	V350256906L2C004R06900375562_chr1_438579	84	53	ACAC	CCCA
V350256906L2C004R06900567132	chr1	979866	50M	167	980033	979867	980034	V350256906L2C004R06900567132_chr1_979866	58	85	TGGG	GGCC
V350256906L2C004R06900579967	chr1	18646	50M	198	18844	18647	18845	V350256906L2C004R06900579967_chr1_18646	227	29	CAGC	GCAG
V350256906L2C004R06900641961	chr1	595771	50M	175	595946	595772	595947	V350256906L2C004R06900641961_chr1_595771	0	173	cacc	gcat
V350256906L2C004R06900677871	chr1	650455	50M	222	650677	650456	650678	V350256906L2C004R06900677871_chr1_650455	16	0	cctc	gctt
V350256906L2C004R06901161364	chr1	1017184	50M	161	1017345	1017185	1017346	V350256906L2C004R06901161364_chr1_1017184	113	0	GAGC	CCCC
V350256906L2C004R07000226550	chr1	72594	50M	158	72752	72595	72753	V350256906L2C004R07000226550_chr1_72594	91	0	cagg	cagt
V350256906L2C004R07000386013	chr1	1196780	50M	192	1196972	1196781	1196973	V350256906L2C004R07000386013_chr1_1196780	13	0	ACAG	GTTT
V350256906L2C004R07000517315	chr1	1222274	50M	168	1222442	1222275	1222443	V350256906L2C004R07000517315_chr1_1222274	44	50	GCCC	CGCT
V350256906L2C004R07000548808	chr1	1018077	50M	200	1018277	1018078	1018278	V350256906L2C004R07000548808_chr1_1018077	15	96	CTGT	CTGA
V350256906L2C004R07000777053	chr1	75478	50M	176	75654	75479	75655	V350256906L2C004R07000777053_chr1_75478	52	228	catg	aagg
V350256906L2C004R07000802184	chr1	610701	50M	174	610875	610702	610876	V350256906L2C004R07000802184_chr1_610701	0	28	CATG	ACTG
V350256906L2C004R07000972561	chr1	231199	47M3S	172	231371	231200	231372	V350256906L2C004R07000972561_chr1_231199	32	99	cttc	tctc
V350256906L2C004R07001156392	chr1	467274	50M	176	467450	467275	467451	V350256906L2C004R07001156392_chr1_467274	0	29	ccta	cctg
V350256906L2C004R07001255261	chr1	630906	50M	189	631095	630907	631096	V350256906L2C004R07001255261_chr1_630906	45	60	CCAA	TACC
V350256906L2C004R07100036754	chr1	1051703	50M	166	1051869	1051704	1051870	V350256906L2C004R07100036754_chr1_1051703	60	63	CCCT	CCCA
V350256906L2C004R07100846423	chr1	441041	50M	164	441205	441042	441206	V350256906L2C004R07100846423_chr1_441041	45	27	CCTG	CTGC
V350256906L2C004R07101096297	chr1	116023	50M	191	116214	116024	116215	V350256906L2C004R07101096297_chr1_116023	59	88	tgtt	TGGT
V350256906L2C004R07101182878	chr1	593619	50M	181	593800	593620	593801	V350256906L2C004R07101182878_chr1_593619	31	28	AAAC	CTTG
V350256906L2C004R07101404328	chr1	725067	15S35M	188	725255	725068	725256	V350256906L2C004R07101404328_chr1_725067	97	14	gaat	ttcc
V350256906L2C004R07200060326	chr1	1350873	50M	93	1350966	1350874	1350967	V350256906L2C004R07200060326_chr1_1350873	0	53	actt	tcaa
V350256906L2C004R07200418989	chr1	129759	50M	140	129899	129760	129900	V350256906L2C004R07200418989_chr1_129759	118	0	ccca	CTAT
V350256906L2C004R07200829638	chr1	145018	50M	164	145182	145019	145183	V350256906L2C004R07200829638_chr1_145018	366	202	cagc	ccca
V350256906L2C004R07201058711	chr1	247404	50M	171	247575	247405	247576	V350256906L2C004R07201058711_chr1_247404	52	66	cagt	caag
V350256906L2C005R00100425447	chr1	355263	50M	173	355436	355264	355437	V350256906L2C005R00100425447_chr1_355263	276	103	gtaa	ctta
V350256906L2C005R00100461755	chr1	873494	50M	167	873661	873495	873662	V350256906L2C005R00100461755_chr1_873494	268	147	AGGG	CCAG
V350256906L2C005R00100765265	chr1	1174102	50M	155	1174257	1174103	1174258	V350256906L2C005R00100765265_chr1_1174102	0	0	AGGG	GACC
V350256906L2C005R00200003712	chr1	239705	50M	190	239895	239706	239896	V350256906L2C005R00200003712_chr1_239705	0	112	taca	ACAG
V350256906L2C005R00200166246	chr1	771354	50M	184	771538	771355	771539	V350256906L2C005R00200166246_chr1_771354	67	60	GTGC	GTTT
V350256906L2C005R00200290595	chr1	855109	50M	177	855286	855110	855287	V350256906L2C005R00200290595_chr1_855109	20	13	CGCA	CCAA
V350256906L2C005R00200849019	chr1	1121509	50M	148	1121657	1121510	1121658	V350256906L2C005R00200849019_chr1_1121509	54	202	ccca	tctc
V350256906L2C005R00200938387	chr1	1277020	50M	147	1277167	1277021	1277168	V350256906L2C005R00200938387_chr1_1277020	13	98	TACA	CCCA
V350256906L2C005R00200949045	chr1	613885	50M	172	614057	613886	614058	V350256906L2C005R00200949045_chr1_613885	19	40	caaa	gata
V350256906L2C005R00200994440	chr1	789171	50M	141	789312	789172	789313	V350256906L2C005R00200994440_chr1_789171	59	200	ACTG	CCAC
V350256906L2C005R00201008264	chr1	744278	50M	187	744465	744279	744466	V350256906L2C005R00201008264_chr1_744278	21	0	TAAA	aact
V350256906L2C005R00201189755	chr1	101253	50M	159	101412	101254	101413	V350256906L2C005R00201189755_chr1_101253	21	27	cctt	caca
V350256906L2C005R00201297420	chr1	47663	50M	171	47834	47664	47835	V350256906L2C005R00201297420_chr1_47663	51	77	AATG	CAGT
V350256906L2C005R00300043021	chr1	731650	50M	189	731839	731651	731840	V350256906L2C005R00300043021_chr1_731650	63	77	AGCT	GGCT
V350256906L2C005R00300233025	chr1	1425621	50M	167	1425788	1425622	1425789	V350256906L2C005R00300233025_chr1_1425621	0	0	CATC	CGGC
V350256906L2C005R00300490946	chr1	131549	50M	152	131701	131550	131702	V350256906L2C005R00300490946_chr1_131549	54	46	CCTG	TGAG
V350256906L2C005R00300598313	chr1	254720	50M	169	254889	254721	254890	V350256906L2C005R00300598313_chr1_254720	119	12	aaaa	ccat
V350256906L2C005R00301072867	chr1	60848	50M	174	61022	60849	61023	V350256906L2C005R00301072867_chr1_60848	0	152	CCCA	CGAA
V350256906L2C005R00301137996	chr1	531651	50M	202	531853	531652	531854	V350256906L2C005R00301137996_chr1_531651	91	247	gttc	gtat
V350256906L2C005R00301261588	chr1	958779	50M	109	958888	958780	958889	V350256906L2C005R00301261588_chr1_958779	0	88	CCCC	CCAA
V350256906L2C005R00400108739	chr1	733595	50M	200	733795	733596	733796	V350256906L2C005R00400108739_chr1_733595	9	44	CAAA	CTGA
V350256906L2C005R00400641875	chr1	1172414	50M	183	1172597	1172415	1172598	V350256906L2C005R00400641875_chr1_1172414	195	36	CCCC	CCCA
V350256906L2C005R00400772257	chr1	848013	50M	199	848212	848014	848213	V350256906L2C005R00400772257_chr1_848013	47	49	caag	CCCT
V350256906L2C005R00400796875	chr1	406139	50M	170	406309	406140	406310	V350256906L2C005R00400796875_chr1_406139	78	11	ttag	CTCA
V350256906L2C005R00401041013	chr1	1343287	50M	175	1343462	1343288	1343463	V350256906L2C005R00401041013_chr1_1343287	59	51	tcgg	ccca
V350256906L2C005R00401168660	chr1	1266789	50M	170	1266959	1266790	1266960	V350256906L2C005R00401168660_chr1_1266789	37	207	CCAT	CTGG
V350256906L2C005R00401355149	chr1	241456	50M	143	241599	241457	241600	V350256906L2C005R00401355149_chr1_241456	59	46	CCTG	CTCT
V350256906L2C005R00500085988	chr1	450963	50M	194	451157	450964	451158	V350256906L2C005R00500085988_chr1_450963	168	0	cgcc	TCTG
V350256906L2C005R00500283467	chr1	235019	50M	145	235164	235020	235165	V350256906L2C005R00500283467_chr1_235019	148	189	taca	aata
V350256906L2C005R00500579337	chr1	920665	50M	180	920845	920666	920846	V350256906L2C005R00500579337_chr1_920665	16	38	tttc	aaaa
V350256906L2C005R00500685588	chr1	151906	50M	182	152088	151907	152089	V350256906L2C005R00500685588_chr1_151906	59	241	CCCA	catt
V350256906L2C005R00500919835	chr1	983644	50M	148	983792	983645	983793	V350256906L2C005R00500919835_chr1_983644	39	47	CACA	CCCA
V350256906L2C005R00501006005	chr1	52731	50M	173	52904	52732	52905	V350256906L2C005R00501006005_chr1_52731	86	42	CAGA	GCAT
V350256906L2C005R00501166754	chr1	12040	50M	176	12216	12041	12217	V350256906L2C005R00501166754_chr1_12040	36	62	GCCA	TGAG
V350256906L2C005R00501210140	chr1	1358340	50M	165	1358505	1358341	1358506	V350256906L2C005R00501210140_chr1_1358340	11	13	caaa	gcaa
V350256906L2C005R00600102438	chr1	1225363	50M	152	1225515	1225364	1225516	V350256906L2C005R00600102438_chr1_1225363	148	164	cccg	cacg
V350256906L2C005R00600208847	chr1	852170	50M	166	852336	852171	852337	V350256906L2C005R00600208847_chr1_852170	0	0	CCCC	AGCC
V350256906L2C005R00600703850	chr1	166238	50M	164	166402	166239	166403	V350256906L2C005R00600703850_chr1_166238	63	227	aggc	acat
V350256906L2C005R00600895042	chr1	1196194	50M	192	1196386	1196195	1196387	V350256906L2C005R00600895042_chr1_1196194	0	0	actg	CACT
V350256906L2C005R00601185873	chr1	169186	50M	163	169349	169187	169350	V350256906L2C005R00601185873_chr1_169186	0	152	cccg	CTAC
V350256906L2C005R00601306433	chr1	552446	50M	173	552619	552447	552620	V350256906L2C005R00601306433_chr1_552446	149	0	CATC	attg
V350256906L2C005R00700904701	chr1	1187322	50M	169	1187491	1187323	1187492	V350256906L2C005R00700904701_chr1_1187322	70	58	cagg	caag
V350256906L2C005R00701017465	chr1	879032	50M	158	879190	879033	879191	V350256906L2C005R00701017465_chr1_879032	22	17	ATGG	CCTG
V350256906L2C005R00701346918	chr1	134495	50M	176	134671	134496	134672	V350256906L2C005R00701346918_chr1_134495	45	70	ACTT	TCCT
V350256906L2C005R00800048923	chr1	1319344	50M	167	1319511	1319345	1319512	V350256906L2C005R00800048923_chr1_1319344	45	45	GGCC	cttt
V350256906L2C005R00800372058	chr1	1028368	50M	191	1028559	1028369	1028560	V350256906L2C005R00800372058_chr1_1028368	71	34	tgca	ggac
V350256906L2C005R00800413775	chr1	942570	50M	158	942728	942571	942729	V350256906L2C005R00800413775_chr1_942570	21	61	CCCC	caaa
V350256906L2C005R00801241036	chr1	1126853	50M	189	1127042	1126854	1127043	V350256906L2C005R00801241036_chr1_1126853	38	43	aaaa	ctgt
V350256906L2C005R00900377972	chr1	256271	50M	165	256436	256272	256437	V350256906L2C005R00900377972_chr1_256271	132	26	ctcc	tggg
V350256906L2C005R00900587175	chr1	1213134	50M	182	1213316	1213135	1213317	V350256906L2C005R00900587175_chr1_1213134	5	187	ccag	catg
V350256906L2C005R00901179965	chr1	816726	50M	184	816910	816727	816911	V350256906L2C005R00901179965_chr1_816726	172	62	tttt	ACAA
V350256906L2C005R01000087401	chr1	600306	50M	170	600476	600307	600477	V350256906L2C005R01000087401_chr1_600306	37	48	taca	ttga
V350256906L2C005R01000333776	chr1	440631	50M	165	440796	440632	440797	V350256906L2C005R01000333776_chr1_440631	81	106	GGCA	GTGT
V350256906L2C005R01000441593	chr1	335145	50M	164	335309	335146	335310	V350256906L2C005R01000441593_chr1_335145	22	16	CCAT	cccg
V350256906L2C005R01000540262	chr1	39302	50M	169	39471	39303	39472	V350256906L2C005R01000540262_chr1_39302	232	292	tgta	acca
V350256906L2C005R01000705124	chr1	1279042	50M	236	1279278	1279043	1279279	V350256906L2C005R01000705124_chr1_1279042	113	63	CCCT	GGCC
V350256906L2C005R01000783635	chr1	1308026	50M	136	1308162	1308027	1308163	V350256906L2C005R01000783635_chr1_1308026	41	59	CCCA	caag
V350256906L2C005R01000883125	chr1	1266979	50M	161	1267140	1266980	1267141	V350256906L2C005R01000883125_chr1_1266979	227	124	GGGG	CCGA
V350256906L2C005R01000983190	chr1	1398021	50M	140	1398161	1398022	1398162	V350256906L2C005R01000983190_chr1_1398021	0	42	TAGA	GGCC
V350256906L2C005R01100061569	chr1	25103	50M	170	25273	25104	25274	V350256906L2C005R01100061569_chr1_25103	65	62	AAGG	CCTC
V350256906L2C005R01100100866	chr1	1390746	50M	147	1390893	1390747	1390894	V350256906L2C005R01100100866_chr1_1390746	58	49	CTCC	ACAA
V350256906L2C005R01100256400	chr1	1112799	50M	191	1112990	1112800	1112991	V350256906L2C005R01100256400_chr1_1112799	0	0	ctcc	gccg
V350256906L2C005R01100740584	chr1	49462	50M	190	49652	49463	49653	V350256906L2C005R01100740584_chr1_49462	27	58	ccta	CTGC
V350256906L2C005R01200061906	chr1	400640	50M	160	400800	400641	400801	V350256906L2C005R01200061906_chr1_400640	234	74	tgtc	ctaa
V350256906L2C005R01200073135	chr1	1176490	50M	170	1176660	1176491	1176661	V350256906L2C005R01200073135_chr1_1176490	16	0	CCCC	GCCT
V350256906L2C005R01200255281	chr1	618304	50M	163	618467	618305	618468	V350256906L2C005R01200255281_chr1_618304	63	61	ACAT	gtAC
V350256906L2C005R01200265288	chr1	236160	50M	161	236321	236161	236322	V350256906L2C005R01200265288_chr1_236160	62	51	AATG	AAAA
V350256906L2C005R01200354189	chr1	1122453	50M	169	1122622	1122454	1122623	V350256906L2C005R01200354189_chr1_1122453	53	61	cctg	caag
V350256906L2C005R01200606342	chr1	100915	50M	182	101097	100916	101098	V350256906L2C005R01200606342_chr1_100915	116	44	CCCT	caaa
V350256906L2C005R01200983392	chr1	1254389	50M	168	1254557	1254390	1254558	V350256906L2C005R01200983392_chr1_1254389	117	239	CCCA	CACT
V350256906L2C005R01201100545	chr1	151424	50M	154	151578	151425	151579	V350256906L2C005R01201100545_chr1_151424	69	62	tccc	cttg
V350256906L2C005R01201223280	chr1	97498	50M	188	97686	97499	97687	V350256906L2C005R01201223280_chr1_97498	12	13	CACA	CAGT
V350256906L2C005R01201310791	chr1	1083659	50M	181	1083840	1083660	1083841	V350256906L2C005R01201310791_chr1_1083659	67	66	GCCG	tcct
V350256906L2C005R01201367157	chr1	1356676	50M	186	1356862	1356677	1356863	V350256906L2C005R01201367157_chr1_1356676	0	0	CAGG	TCCC
V350256906L2C005R01300046677	chr1	1386681	50M	181	1386862	1386682	1386863	V350256906L2C005R01300046677_chr1_1386681	52	36	gctg	ccag
V350256906L2C005R01300424135	chr1	1399899	50M	172	1400071	1399900	1400072	V350256906L2C005R01300424135_chr1_1399899	36	4	ccag	caag
V350256906L2C005R01301102785	chr1	1419848	50M	172	1420020	1419849	1420021	V350256906L2C005R01301102785_chr1_1419848	31	72	accg	TAAC
V350256906L2C005R01301202726	chr1	1139240	50M	167	1139407	1139241	1139408	V350256906L2C005R01301202726_chr1_1139240	57	63	CCCA	ACAG
V350256906L2C005R01301218946	chr1	466990	50M	179	467169	466991	467170	V350256906L2C005R01301218946_chr1_466990	56	87	TGTG	TGTT
V350256906L2C005R01301269778	chr1	907955	50M	175	908130	907956	908131	V350256906L2C005R01301269778_chr1_907955	0	40	gacc	ctgt
V350256906L2C005R01301320297	chr1	866631	50M	201	866832	866632	866833	V350256906L2C005R01301320297_chr1_866631	0	8	CCCC	CTAG
V350256906L2C005R01301372396	chr1	1416535	50M	165	1416700	1416536	1416701	V350256906L2C005R01301372396_chr1_1416535	33	54	CTTC	gagc
V350256906L2C005R01400032051	chr1	1384504	50M	192	1384696	1384505	1384697	V350256906L2C005R01400032051_chr1_1384504	146	135	tctc	tgac
V350256906L2C005R01400201916	chr1	711977	50M	143	712120	711978	712121	V350256906L2C005R01400201916_chr1_711977	173	57	ccat	ATGA
V350256906L2C005R01400307981	chr1	829899	50M	142	830041	829900	830042	V350256906L2C005R01400307981_chr1_829899	60	42	CAGG	GAGG
V350256906L2C005R01400716380	chr1	377016	50M	149	377165	377017	377166	V350256906L2C005R01400716380_chr1_377016	63	35	tggt	caaa
V350256906L2C005R01400962289	chr1	105223	50M	172	105395	105224	105396	V350256906L2C005R01400962289_chr1_105223	59	75	CATC	AGAA
V350256906L2C005R01401335406	chr1	569356	50M	96	569452	569357	569453	V350256906L2C005R01401335406_chr1_569356	0	81	CAAC	CTAG
V350256906L2C005R01500027504	chr1	1302157	7S43M	146	1302303	1302158	1302304	V350256906L2C005R01500027504_chr1_1302157	74	36	agtg	cacc
V350256906L2C005R01500082821	chr1	1410080	50M	165	1410245	1410081	1410246	V350256906L2C005R01500082821_chr1_1410080	32	78	ccat	CGAG
V350256906L2C005R01500300688	chr1	459905	50M	169	460074	459906	460075	V350256906L2C005R01500300688_chr1_459905	79	90	CCTA	CATC
V350256906L2C005R01500481907	chr1	84450	50M	179	84629	84451	84630	V350256906L2C005R01500481907_chr1_84450	9	0	ccac	gata
V350256906L2C005R01500722470	chr1	1046783	50M	174	1046957	1046784	1046958	V350256906L2C005R01500722470_chr1_1046783	40	55	cgta	GGCA
V350256906L2C005R01500924230	chr1	29385	50M	167	29552	29386	29553	V350256906L2C005R01500924230_chr1_29385	68	0	GCCC	CGGG
V350256906L2C005R01500937356	chr1	402327	50M	162	402489	402328	402490	V350256906L2C005R01500937356_chr1_402327	89	84	gcca	caaa
V350256906L2C005R01501074749	chr1	64771	50M	227	64998	64772	64999	V350256906L2C005R01501074749_chr1_64771	60	39	CTCT	TGTT
V350256906L2C005R01501171410	chr1	903223	50M	135	903358	903224	903359	V350256906L2C005R01501171410_chr1_903223	10	0	TGTG	GGAC
V350256906L2C005R01600064006	chr1	353431	50M	153	353584	353432	353585	V350256906L2C005R01600064006_chr1_353431	152	0	tgtg	tgaa
V350256906L2C005R01600222537	chr1	847311	50M	157	847468	847312	847469	V350256906L2C005R01600222537_chr1_847311	67	29	cctc	GGCC
V350256906L2C005R01600994069	chr1	1255297	50M	152	1255449	1255298	1255450	V350256906L2C005R01600994069_chr1_1255297	65	31	CACC	CAGC
V350256906L2C005R01601124155	chr1	777134	50M	174	777308	777135	777309	V350256906L2C005R01601124155_chr1_777134	57	18	catg	AAAG
V350256906L2C005R01700117682	chr1	652472	50M	156	652628	652473	652629	V350256906L2C005R01700117682_chr1_652472	39	60	tatt	ctct
V350256906L2C005R01700136245	chr1	164314	50M	187	164501	164315	164502	V350256906L2C005R01700136245_chr1_164314	24	13	CAGG	atgc
V350256906L2C005R01700572382	chr1	601364	50M	185	601549	601365	601550	V350256906L2C005R01700572382_chr1_601364	10	0	ctag	ggaa
V350256906L2C005R01701204977	chr1	683817	50M	161	683978	683818	683979	V350256906L2C005R01701204977_chr1_683817	0	42	taca	taca
V350256906L2C005R01701226144	chr1	77059	50M	152	77211	77060	77212	V350256906L2C005R01701226144_chr1_77059	72	224	cagc	attt
V350256906L2C005R01701241677	chr1	804400	50M	182	804582	804401	804583	V350256906L2C005R01701241677_chr1_804400	35	32	CTAT	CCTG
V350256906L2C005R01701356416	chr1	154610	50M	168	154778	154611	154779	V350256906L2C005R01701356416_chr1_154610	34	41	ggga	aatt
V350256906L2C005R01800016399	chr1	922330	50M	184	922514	922331	922515	V350256906L2C005R01800016399_chr1_922330	158	26	tgta	acag
V350256906L2C005R01800145119	chr1	641029	50M	180	641209	641030	641210	V350256906L2C005R01800145119_chr1_641029	20	6	TAAT	CCAG
V350256906L2C005R01800575824	chr1	989746	50M	162	989908	989747	989909	V350256906L2C005R01800575824_chr1_989746	40	55	TAGG	CCAG
V350256906L2C005R01801176399	chr1	654550	50M	225	654775	654551	654776	V350256906L2C005R01801176399_chr1_654550	25	0	TGAC	TGCT
V350256906L2C005R01801367353	chr1	267509	50M	178	267687	267510	267688	V350256906L2C005R01801367353_chr1_267509	58	96	GCCA	tact
V350256906L2C005R01900133843	chr1	1284234	50M	159	1284393	1284235	1284394	V350256906L2C005R01900133843_chr1_1284234	54	66	CGAG	GGTC
V350256906L2C005R01900212600	chr1	699256	50M	189	699445	699257	699446	V350256906L2C005R01900212600_chr1_699256	26	21	TGTC	GGTG
V350256906L2C005R01900488834	chr1	554172	50M	180	554352	554173	554353	V350256906L2C005R01900488834_chr1_554172	0	8	ccta	ccct
V350256906L2C005R01900629692	chr1	638119	50M	165	638284	638120	638285	V350256906L2C005R01900629692_chr1_638119	7	94	CAAA	gcca
V350256906L2C005R01901008245	chr1	127427	50M	141	127568	127428	127569	V350256906L2C005R01901008245_chr1_127427	100	241	CAGC	ttat
V350256906L2C005R02000157521	chr1	159783	50M	186	159969	159784	159970	V350256906L2C005R02000157521_chr1_159783	67	80	CATT	TATA
V350256906L2C005R02000288041	chr1	1417324	50M	178	1417502	1417325	1417503	V350256906L2C005R02000288041_chr1_1417324	9	13	GGCC	GGGC
V350256906L2C005R02000981948	chr1	1037630	50M	165	1037795	1037631	1037796	V350256906L2C005R02000981948_chr1_1037630	57	65	ggac	ggaa
V350256906L2C005R02001111109	chr1	39135	50M	171	39306	39136	39307	V350256906L2C005R02001111109_chr1_39135	65	236	catg	taca
V350256906L2C005R02001217926	chr1	527619	50M	144	527763	527620	527764	V350256906L2C005R02001217926_chr1_527619	62	51	CGCC	GCTA
V350256906L2C005R02100169721	chr1	726825	25S22M3S	147	726972	726826	726973	V350256906L2C005R02100169721_chr1_726825	0	23	gaat	tcca
V350256906L2C005R02100743035	chr1	730652	50M	165	730817	730653	730818	V350256906L2C005R02100743035_chr1_730652	53	98	CAAA	atct
V350256906L2C005R02101021314	chr1	1140592	50M	175	1140767	1140593	1140768	V350256906L2C005R02101021314_chr1_1140592	40	31	TGTG	GGGG
V350256906L2C005R02200311770	chr1	1230782	50M	205	1230987	1230783	1230988	V350256906L2C005R02200311770_chr1_1230782	3	0	CCTT	CCTG
V350256906L2C005R02200797590	chr1	1256118	50M	165	1256283	1256119	1256284	V350256906L2C005R02200797590_chr1_1256118	0	0	AGCT	CAGC
V350256906L2C005R02200812161	chr1	339060	50M	174	339234	339061	339235	V350256906L2C005R02200812161_chr1_339060	105	14	atat	tcca
V350256906L2C005R02300176254	chr1	725852	11S39M	115	725967	725853	725968	V350256906L2C005R02300176254_chr1_725852	31	42	gaat	catt
V350256906L2C005R02300219789	chr1	606219	50M	175	606394	606220	606395	V350256906L2C005R02300219789_chr1_606219	48	61	ACAC	GGTA
V350256906L2C005R02300507018	chr1	585515	50M	158	585673	585516	585674	V350256906L2C005R02300507018_chr1_585515	43	68	ccta	acca
V350256906L2C005R02300664770	chr1	1301362	50M	168	1301530	1301363	1301531	V350256906L2C005R02300664770_chr1_1301362	25	34	GTGA	tcac
V350256906L2C005R02300742423	chr1	1033446	50M	178	1033624	1033447	1033625	V350256906L2C005R02300742423_chr1_1033446	16	97	tgag	taaa
V350256906L2C005R02400099825	chr1	428517	50M	225	428742	428518	428743	V350256906L2C005R02400099825_chr1_428517	75	55	ggag	CTTA
V350256906L2C005R02400386585	chr1	638254	50M	141	638395	638255	638396	V350256906L2C005R02400386585_chr1_638254	64	143	catt	TCTC
V350256906L2C005R02400908998	chr1	568119	50M	238	568357	568120	568358	V350256906L2C005R02400908998_chr1_568119	68	14	TAAA	CTAG
V350256906L2C005R02401049792	chr1	1290698	50M	170	1290868	1290699	1290869	V350256906L2C005R02401049792_chr1_1290698	45	65	TACA	GGCC
V350256906L2C005R02401366830	chr1	1328346	50M	189	1328535	1328347	1328536	V350256906L2C005R02401366830_chr1_1328346	0	0	CTTT	GAGC
V350256906L2C005R02500119582	chr1	1021418	50M	184	1021602	1021419	1021603	V350256906L2C005R02500119582_chr1_1021418	0	9	CGGG	CCAG
V350256906L2C005R02500725432	chr1	1061258	50M	178	1061436	1061259	1061437	V350256906L2C005R02500725432_chr1_1061258	5	13	CTCA	GTCT
V350256906L2C005R02501003878	chr1	444201	50M	169	444370	444202	444371	V350256906L2C005R02501003878_chr1_444201	6	0	cccc	aaca
V350256906L2C005R02501195521	chr1	1412747	50M	187	1412934	1412748	1412935	V350256906L2C005R02501195521_chr1_1412747	29	16	TGGG	CCCT
V350256906L2C005R02501275044	chr1	946471	50M	182	946653	946472	946654	V350256906L2C005R02501275044_chr1_946471	82	74	ccat	tttg
V350256906L2C005R02501289730	chr1	671409	50M	180	671589	671410	671590	V350256906L2C005R02501289730_chr1_671409	0	0	TACA	GTTC
V350256906L2C005R02600114115	chr1	366766	50M	201	366967	366767	366968	V350256906L2C005R02600114115_chr1_366766	646	445	AATC	CCCA
V350256906L2C005R02600237426	chr1	1117206	50M	193	1117399	1117207	1117400	V350256906L2C005R02600237426_chr1_1117206	105	20	CCCA	TGGC
V350256906L2C005R02600446258	chr1	1194472	50M	197	1194669	1194473	1194670	V350256906L2C005R02600446258_chr1_1194472	21	57	gtgt	gatg
V350256906L2C005R02600626458	chr1	1070461	50M	172	1070633	1070462	1070634	V350256906L2C005R02600626458_chr1_1070461	64	67	CGCC	CCTA
V350256906L2C005R02600729405	chr1	608228	50M	165	608393	608229	608394	V350256906L2C005R02600729405_chr1_608228	164	164	tgat	cagc
V350256906L2C005R02600817083	chr1	1335911	50M	183	1336094	1335912	1336095	V350256906L2C005R02600817083_chr1_1335911	0	25	AAAC	CCAA
V350256906L2C005R02601019292	chr1	659671	50M	189	659860	659672	659861	V350256906L2C005R02601019292_chr1_659671	31	33	CCCC	CTCC
V350256906L2C005R02601159930	chr1	368593	50M	178	368771	368594	368772	V350256906L2C005R02601159930_chr1_368593	55	49	CATA	GACT
V350256906L2C005R02601216305	chr1	131862	50M	164	132026	131863	132027	V350256906L2C005R02601216305_chr1_131862	31	195	TGCA	GGAG
V350256906L2C005R02700133990	chr1	1136502	50M	177	1136679	1136503	1136680	V350256906L2C005R02700133990_chr1_1136502	78	46	GGGA	TGGG
V350256906L2C005R02700190165	chr1	641769	50M	199	641968	641770	641969	V350256906L2C005R02700190165_chr1_641769	61	59	agca	actt
V350256906L2C005R02700346299	chr1	1379806	50M	165	1379971	1379807	1379972	V350256906L2C005R02700346299_chr1_1379806	0	15	CCAG	CTTA
V350256906L2C005R02700420853	chr1	723164	50M	187	723351	723165	723352	V350256906L2C005R02700420853_chr1_723164	10	2	actt	CAGA
V350256906L2C005R02700527891	chr1	1264159	50M	153	1264312	1264160	1264313	V350256906L2C005R02700527891_chr1_1264159	22	58	GGCA	CCCC
V350256906L2C005R02700972081	chr1	1203273	50M	194	1203467	1203274	1203468	V350256906L2C005R02700972081_chr1_1203273	30	39	CACA	GGCG
V350256906L2C005R02701076176	chr1	1127644	50M	155	1127799	1127645	1127800	V350256906L2C005R02701076176_chr1_1127644	10	37	gtgt	ACAT
V350256906L2C005R02701121155	chr1	125563	50M	168	125731	125564	125732	V350256906L2C005R02701121155_chr1_125563	298	224	CCAG	TATG
V350256906L2C005R02800079602	chr1	1134347	50M	205	1134552	1134348	1134553	V350256906L2C005R02800079602_chr1_1134347	47	56	CTGG	ACCA
V350256906L2C005R02800249353	chr1	725411	50M	124	725535	725412	725536	V350256906L2C005R02800249353_chr1_725411	74	19	ggaa	ttcc
V350256906L2C005R02800517834	chr1	1262297	50M	196	1262493	1262298	1262494	V350256906L2C005R02800517834_chr1_1262297	47	51	GACT	GGCA
V350256906L2C005R02800565944	chr1	371836	50M	166	372002	371837	372003	V350256906L2C005R02800565944_chr1_371836	59	60	GTTA	taaa
V350256906L2C005R02800615785	chr1	1425425	50M	162	1425587	1425426	1425588	V350256906L2C005R02800615785_chr1_1425425	0	17	CGAG	CCCG
V350256906L2C005R02800618869	chr1	251362	50M	171	251533	251363	251534	V350256906L2C005R02800618869_chr1_251362	57	55	cctc	TGTA
V350256906L2C005R02800730049	chr1	129659	50M	131	129790	129660	129791	V350256906L2C005R02800730049_chr1_129659	218	87	gctt	cagt
V350256906L2C005R02801219764	chr1	1060979	50M	167	1061146	1060980	1061147	V350256906L2C005R02801219764_chr1_1060979	111	117	TAGC	CCTG
V350256906L2C005R02801224496	chr1	1266873	50M	226	1267099	1266874	1267100	V350256906L2C005R02801224496_chr1_1266873	121	165	GGCC	GGCA
V350256906L2C005R02900280298	chr1	1373527	50M	169	1373696	1373528	1373697	V350256906L2C005R02900280298_chr1_1373527	61	56	GGGG	CCTG
V350256906L2C005R02900292703	chr1	1128977	50M	217	1129194	1128978	1129195	V350256906L2C005R02900292703_chr1_1128977	64	30	ggga	caaa
V350256906L2C005R02900757538	chr1	1091706	50M	182	1091888	1091707	1091889	V350256906L2C005R02900757538_chr1_1091706	8	37	CCTG	CTCT
V350256906L2C005R03000034818	chr1	1056110	50M	198	1056308	1056111	1056309	V350256906L2C005R03000034818_chr1_1056110	10	8	cccg	TCTC
V350256906L2C005R03000122488	chr1	376952	50M	138	377090	376953	377091	V350256906L2C005R03000122488_chr1_376952	127	0	tcca	caga
V350256906L2C005R03000325132	chr1	1136990	50M	166	1137156	1136991	1137157	V350256906L2C005R03000325132_chr1_1136990	136	302	ACGC	GGCG
V350256906L2C005R03000399546	chr1	1207848	50M	145	1207993	1207849	1207994	V350256906L2C005R03000399546_chr1_1207848	29	54	CTGA	AGGT
V350256906L2C005R03000671307	chr1	1271906	50M	187	1272093	1271907	1272094	V350256906L2C005R03000671307_chr1_1271906	58	20	GAAC	CCAC
V350256906L2C005R03000762281	chr1	719040	50M	161	719201	719041	719202	V350256906L2C005R03000762281_chr1_719040	89	47	ccct	aata
V350256906L2C005R03000957148	chr1	1391175	50M	165	1391340	1391176	1391341	V350256906L2C005R03000957148_chr1_1391175	30	37	GCCT	CCCC
V350256906L2C005R03001051609	chr1	725061	3S47M	165	725226	725062	725227	V350256906L2C005R03001051609_chr1_725061	91	43	ggaa	attc
V350256906L2C005R03001214034	chr1	68273	50M	202	68475	68274	68476	V350256906L2C005R03001214034_chr1_68273	77	54	CCCC	AGAG
V350256906L2C005R03001260808	chr1	1066130	50M	171	1066301	1066131	1066302	V350256906L2C005R03001260808_chr1_1066130	21	17	cgtg	CACA
V350256906L2C005R03001311901	chr1	237809	50M	198	238007	237810	238008	V350256906L2C005R03001311901_chr1_237809	0	24	GGGG	caca
V350256906L2C005R03100257826	chr1	777787	50M	175	777962	777788	777963	V350256906L2C005R03100257826_chr1_777787	52	53	CCAT	CGCA
V350256906L2C005R03100349300	chr1	1175662	50M	172	1175834	1175663	1175835	V350256906L2C005R03100349300_chr1_1175662	74	64	CCAG	GCCA
V350256906L2C005R03100367206	chr1	94330	50M	193	94523	94331	94524	V350256906L2C005R03100367206_chr1_94330	57	52	ctgc	cccA
V350256906L2C005R03100657784	chr1	605976	50M	172	606148	605977	606149	V350256906L2C005R03100657784_chr1_605976	49	0	ggag	tatg
V350256906L2C005R03100751336	chr1	726825	23S20M7S	145	726970	726826	726971	V350256906L2C005R03100751336_chr1_726825	0	25	gaat	catt
V350256906L2C005R03100800543	chr1	704473	50M	171	704644	704474	704645	V350256906L2C005R03100800543_chr1_704473	29	72	cctg	TAAG
V350256906L2C005R03100902944	chr1	55679	50M	185	55864	55680	55865	V350256906L2C005R03100902944_chr1_55679	76	54	CCAG	CAAT
V350256906L2C005R03200394658	chr1	691747	50M	157	691904	691748	691905	V350256906L2C005R03200394658_chr1_691747	0	7	tgca	actt
V350256906L2C005R03200857702	chr1	1046656	50M	187	1046843	1046657	1046844	V350256906L2C005R03200857702_chr1_1046656	46	29	ccat	ccca
V350256906L2C005R03201352489	chr1	356637	50M	186	356823	356638	356824	V350256906L2C005R03201352489_chr1_356637	88	103	tggt	catt
V350256906L2C005R03201400779	chr1	134131	50M	155	134286	134132	134287	V350256906L2C005R03201400779_chr1_134131	1	62	cagt	ggcc
V350256906L2C005R03300130493	chr1	887323	50M	165	887488	887324	887489	V350256906L2C005R03300130493_chr1_887323	21	0	CCAG	TGTG
V350256906L2C005R03300329886	chr1	1058073	50M	181	1058254	1058074	1058255	V350256906L2C005R03300329886_chr1_1058073	56	43	CCCT	CCCT
V350256906L2C005R03300390734	chr1	53805	50M	165	53970	53806	53971	V350256906L2C005R03300390734_chr1_53805	123	0	GAAT	ATTT
V350256906L2C005R03300508935	chr1	1091041	50M	166	1091207	1091042	1091208	V350256906L2C005R03300508935_chr1_1091041	92	57	CTTC	CACT
V350256906L2C005R03400433602	chr1	119830	50M	168	119998	119831	119999	V350256906L2C005R03400433602_chr1_119830	0	152	ccat	CCTA
V350256906L2C005R03400457582	chr1	725034	8S42M	110	725144	725035	725145	V350256906L2C005R03400457582_chr1_725034	64	125	atgg	tcca
V350256906L2C005R03400779061	chr1	1187664	50M	163	1187827	1187665	1187828	V350256906L2C005R03400779061_chr1_1187664	49	12	ccca	ttat
V350256906L2C005R03401140337	chr1	865670	50M	175	865845	865671	865846	V350256906L2C005R03401140337_chr1_865670	0	16	GGCT	CAAA
V350256906L2C005R03401403882	chr1	825515	50M	159	825674	825516	825675	V350256906L2C005R03401403882_chr1_825515	67	0	cctg	caac
V350256906L2C005R03500136864	chr1	1119242	50M	131	1119373	1119243	1119374	V350256906L2C005R03500136864_chr1_1119242	9	140	GATG	GGTG
V350256906L2C005R03500311947	chr1	564760	50M	166	564926	564761	564927	V350256906L2C005R03500311947_chr1_564760	22	0	ATAT	ggag
V350256906L2C005R03500434860	chr1	1272998	50M	139	1273137	1272999	1273138	V350256906L2C005R03500434860_chr1_1272998	234	95	ACCA	CAGG
V350256906L2C005R03500540844	chr1	592437	50M	193	592630	592438	592631	V350256906L2C005R03500540844_chr1_592437	22	62	aact	ATAT
V350256906L2C005R03501043113	chr1	685448	50M	164	685612	685449	685613	V350256906L2C005R03501043113_chr1_685448	12	0	CATT	ccat
V350256906L2C005R03501112051	chr1	601399	50M	200	601599	601400	601600	V350256906L2C005R03501112051_chr1_601399	45	45	tctg	ctat
V350256906L2C005R03501217347	chr1	82014	50M	190	82204	82015	82205	V350256906L2C005R03501217347_chr1_82014	8	0	attg	tgac
V350256906L2C005R03501354954	chr1	426345	50M	173	426518	426346	426519	V350256906L2C005R03501354954_chr1_426345	9	29	CAGA	GGAT
V350256906L2C005R03501367052	chr1	1314708	50M	162	1314870	1314709	1314871	V350256906L2C005R03501367052_chr1_1314708	218	87	ggag	cgcc
V350256906L2C005R03600671382	chr1	921633	50M	186	921819	921634	921820	V350256906L2C005R03600671382_chr1_921633	98	0	ctaa	ccag
V350256906L2C005R03600824038	chr1	712492	50M	152	712644	712493	712645	V350256906L2C005R03600824038_chr1_712492	31	50	ACCT	TGAT
V350256906L2C005R03601281883	chr1	376953	50M	157	377110	376954	377111	V350256906L2C005R03601281883_chr1_376953	126	0	ccag	catc
V350256906L2C005R03700328420	chr1	157811	50M	171	157982	157812	157983	V350256906L2C005R03700328420_chr1_157811	82	31	catg	CTGA
V350256906L2C005R03700673557	chr1	608364	50M	199	608563	608365	608564	V350256906L2C005R03700673557_chr1_608364	193	0	ccaa	ctgt
V350256906L2C005R03700697565	chr1	796733	50M	158	796891	796734	796892	V350256906L2C005R03700697565_chr1_796733	11	55	CCCC	CCTA
V350256906L2C005R03701268329	chr1	394131	50M	145	394276	394132	394277	V350256906L2C005R03701268329_chr1_394131	71	202	ccat	gttt
V350256906L2C005R03800074132	chr1	595438	50M	186	595624	595439	595625	V350256906L2C005R03800074132_chr1_595438	274	98	ccca	tatc
V350256906L2C005R03801141632	chr1	74057	50M	174	74231	74058	74232	V350256906L2C005R03801141632_chr1_74057	35	32	catt	aaga
V350256906L2C005R03801255966	chr1	1392340	50M	183	1392523	1392341	1392524	V350256906L2C005R03801255966_chr1_1392340	55	60	CTTC	CAAA
V350256906L2C005R03900169386	chr1	966789	50M	169	966958	966790	966959	V350256906L2C005R03900169386_chr1_966789	59	69	CCCA	CTTG
V350256906L2C005R03900394276	chr1	1173141	50M	196	1173337	1173142	1173338	V350256906L2C005R03900394276_chr1_1173141	51	50	CCGA	GGTG
V350256906L2C005R04000075573	chr1	96772	50M	187	96959	96773	96960	V350256906L2C005R04000075573_chr1_96772	21	50	TATG	TTAG
V350256906L2C005R04000131284	chr1	1198452	50M	148	1198600	1198453	1198601	V350256906L2C005R04000131284_chr1_1198452	41	46	CCCC	GCTT
V350256906L2C005R04000385013	chr1	1110764	50M	174	1110938	1110765	1110939	V350256906L2C005R04000385013_chr1_1110764	0	29	GCTT	TGAA
V350256906L2C005R04000900238	chr1	101921	50M	202	102123	101922	102124	V350256906L2C005R04000900238_chr1_101921	26	0	tggt	tttc
V350256906L2C005R04000922666	chr1	320184	50M	208	320392	320185	320393	V350256906L2C005R04000922666_chr1_320184	17	225	ccag	CAAA
V350256906L2C005R04001191633	chr1	882507	50M	154	882661	882508	882662	V350256906L2C005R04001191633_chr1_882507	28	60	CTGC	CTTG
V350256906L2C005R04001260253	chr1	1306213	50M	165	1306378	1306214	1306379	V350256906L2C005R04001260253_chr1_1306213	58	62	CGTG	CCGC
V350256906L2C005R04100428211	chr1	1258560	50M	165	1258725	1258561	1258726	V350256906L2C005R04100428211_chr1_1258560	48	32	CGCC	CTGG
V350256906L2C005R04100507070	chr1	1004656	50M	159	1004815	1004657	1004816	V350256906L2C005R04100507070_chr1_1004656	68	8	GCAG	CTCG
V350256906L2C005R04100977334	chr1	1157804	50M	170	1157974	1157805	1157975	V350256906L2C005R04100977334_chr1_1157804	68	64	GCCC	GGGG
V350256906L2C005R04101115099	chr1	1367931	50M	165	1368096	1367932	1368097	V350256906L2C005R04101115099_chr1_1367931	22	64	CCCC	CTGC
V350256906L2C005R04200585835	chr1	320413	50M	168	320581	320414	320582	V350256906L2C005R04200585835_chr1_320413	236	68	AGCT	CCCT
V350256906L2C005R04200921512	chr1	233323	50M	170	233493	233324	233494	V350256906L2C005R04200921512_chr1_233323	0	7	GTGT	tatc
V350256906L2C005R04201022936	chr1	546367	50M	177	546544	546368	546545	V350256906L2C005R04201022936_chr1_546367	150	0	CCTT	CCTG
V350256906L2C005R04201132962	chr1	162666	50M	150	162816	162667	162817	V350256906L2C005R04201132962_chr1_162666	25	13	gagt	TGAC
V350256906L2C005R04201170076	chr1	987959	50M	179	988138	987960	988139	V350256906L2C005R04201170076_chr1_987959	27	111	tgtc	ccca
V350256906L2C005R04201184163	chr1	64707	50M	193	64900	64708	64901	V350256906L2C005R04201184163_chr1_64707	124	37	TACA	CCTT
V350256906L2C005R04300133225	chr1	966179	50M	151	966330	966180	966331	V350256906L2C005R04300133225_chr1_966179	28	163	GCTG	ccat
V350256906L2C005R04300149210	chr1	1376924	50M	237	1377161	1376925	1377162	V350256906L2C005R04300149210_chr1_1376924	0	53	GGTG	CCTG
V350256906L2C005R04300234262	chr1	1036194	50M	167	1036361	1036195	1036362	V350256906L2C005R04300234262_chr1_1036194	154	0	ctta	aaat
V350256906L2C005R04300356467	chr1	427139	50M	194	427333	427140	427334	V350256906L2C005R04300356467_chr1_427139	148	22	CTTC	CTCA
V350256906L2C005R04300398044	chr1	43915	50M	155	44070	43916	44071	V350256906L2C005R04300398044_chr1_43915	3	106	taag	ctaa
V350256906L2C005R04300442748	chr1	432932	50M	187	433119	432933	433120	V350256906L2C005R04300442748_chr1_432932	6	81	acac	taaa
V350256906L2C005R04300463248	chr1	1411387	50M	182	1411569	1411388	1411570	V350256906L2C005R04300463248_chr1_1411387	42	33	CCCT	GGAA
V350256906L2C005R04301110857	chr1	1331328	50M	178	1331506	1331329	1331507	V350256906L2C005R04301110857_chr1_1331328	42	33	aggc	ctca
V350256906L2C005R04400028194	chr1	586821	50M	148	586969	586822	586970	V350256906L2C005R04400028194_chr1_586821	0	31	aatg	cttt
V350256906L2C005R04400110311	chr1	888498	50M	143	888641	888499	888642	V350256906L2C005R04400110311_chr1_888498	62	56	TAGG	AAGA
V350256906L2C005R04400137953	chr1	466082	50M	172	466254	466083	466255	V350256906L2C005R04400137953_chr1_466082	73	37	ccag	gggc
V350256906L2C005R04400552464	chr1	117749	50M	158	117907	117750	117908	V350256906L2C005R04400552464_chr1_117749	33	0	ccca	tcag
V350256906L2C005R04400753280	chr1	106679	50M	152	106831	106680	106832	V350256906L2C005R04400753280_chr1_106679	37	75	CTGT	CCCA
V350256906L2C005R04400847920	chr1	109926	50M	158	110084	109927	110085	V350256906L2C005R04400847920_chr1_109926	23	61	atag	TTTG
V350256906L2C005R04401216785	chr1	1403898	50M	188	1404086	1403899	1404087	V350256906L2C005R04401216785_chr1_1403898	13	29	ACCC	CCCC
V350256906L2C005R04401217993	chr1	333212	50M	170	333382	333213	333383	V350256906L2C005R04401217993_chr1_333212	28	44	cccg	gaga
V350256906L2C005R04500165973	chr1	141605	50M	146	141751	141606	141752	V350256906L2C005R04500165973_chr1_141605	56	0	tctc	caca
V350256906L2C005R04500474454	chr1	1047813	50M	165	1047978	1047814	1047979	V350256906L2C005R04500474454_chr1_1047813	121	286	CCAG	TATT
V350256906L2C005R04500591758	chr1	824257	50M	188	824445	824258	824446	V350256906L2C005R04500591758_chr1_824257	28	25	ACCA	gaat
V350256906L2C005R04500741312	chr1	943551	50M	159	943710	943552	943711	V350256906L2C005R04500741312_chr1_943551	27	67	TTTT	atag
V350256906L2C005R04500783823	chr1	1323329	50M	168	1323497	1323330	1323498	V350256906L2C005R04500783823_chr1_1323329	36	84	CCTA	TATT
V350256906L2C005R04500877353	chr1	1379574	50M	200	1379774	1379575	1379775	V350256906L2C005R04500877353_chr1_1379574	24	0	GATG	GTTC
V350256906L2C005R04500936310	chr1	462211	50M	168	462379	462212	462380	V350256906L2C005R04500936310_chr1_462211	108	276	gcag	agac
V350256906L2C005R04501232138	chr1	80048	50M	166	80214	80049	80215	V350256906L2C005R04501232138_chr1_80048	55	47	ttac	ccca
V350256906L2C005R04600502191	chr1	1078018	50M	181	1078199	1078019	1078200	V350256906L2C005R04600502191_chr1_1078018	36	41	CCCC	GATC
V350256906L2C005R04700098971	chr1	350078	50M	186	350264	350079	350265	V350256906L2C005R04700098971_chr1_350078	63	27	GGTC	CTGT
V350256906L2C005R04700384360	chr1	51058	50M	173	51231	51059	51232	V350256906L2C005R04700384360_chr1_51058	10	143	TCTC	CTTT
V350256906L2C005R04701059621	chr1	460351	50M	185	460536	460352	460537	V350256906L2C005R04701059621_chr1_460351	0	0	tagc	ccca
V350256906L2C005R04701288690	chr1	235643	50M	167	235810	235644	235811	V350256906L2C005R04701288690_chr1_235643	185	18	ACCC	CAGT
V350256906L2C005R04800465231	chr1	723349	50M	245	723594	723350	723595	V350256906L2C005R04800465231_chr1_723349	4	32	TGGA	ttgt
V350256906L2C005R04800596173	chr1	1083506	50M	148	1083654	1083507	1083655	V350256906L2C005R04800596173_chr1_1083506	32	62	aaac	AGGG
V350256906L2C005R04801046257	chr1	1398703	50M	179	1398882	1398704	1398883	V350256906L2C005R04801046257_chr1_1398703	128	34	CAGA	gcct
V350256906L2C005R04801216128	chr1	793228	50M	187	793415	793229	793416	V350256906L2C005R04801216128_chr1_793228	15	41	AGCC	TGTT
V350256906L2C005R04900004654	chr1	945899	50M	152	946051	945900	946052	V350256906L2C005R04900004654_chr1_945899	76	10	tatt	CATG
V350256906L2C005R04900226784	chr1	1378544	50M	175	1378719	1378545	1378720	V350256906L2C005R04900226784_chr1_1378544	40	88	cgat	AAAC
V350256906L2C005R04900237370	chr1	1076329	50M	137	1076466	1076330	1076467	V350256906L2C005R04900237370_chr1_1076329	10	147	TTCT	AGTG
V350256906L2C005R04900459352	chr1	546927	50M	166	547093	546928	547094	V350256906L2C005R04900459352_chr1_546927	108	274	gtgt	cacC
V350256906L2C005R04900928648	chr1	571589	50M	172	571761	571590	571762	V350256906L2C005R04900928648_chr1_571589	26	54	cagc	tgta
V350256906L2C005R04901017112	chr1	833949	50M	239	834188	833950	834189	V350256906L2C005R04901017112_chr1_833949	42	0	ccgg	GACC
V350256906L2C005R05000204155	chr1	740303	50M	181	740484	740304	740485	V350256906L2C005R05000204155_chr1_740303	36	103	CGTG	GCTT
V350256906L2C005R05001097731	chr1	1405375	50M	164	1405539	1405376	1405540	V350256906L2C005R05001097731_chr1_1405375	69	43	tgta	gtga
V350256906L2C005R05100033526	chr1	1268897	50M	187	1269084	1268898	1269085	V350256906L2C005R05100033526_chr1_1268897	42	48	TGCA	GAAC
V350256906L2C005R05100226561	chr1	126845	50M	140	126985	126846	126986	V350256906L2C005R05100226561_chr1_126845	59	34	tgtt	atta
V350256906L2C005R05101167928	chr1	30457	50M	214	30671	30458	30672	V350256906L2C005R05101167928_chr1_30457	70	85	aaaa	TACC
V350256906L2C005R05200024273	chr1	679179	50M	181	679360	679180	679361	V350256906L2C005R05200024273_chr1_679179	112	53	ccac	cccc
V350256906L2C005R05200334856	chr1	62670	50M	169	62839	62671	62840	V350256906L2C005R05200334856_chr1_62670	83	66	ATTC	ACAA
V350256906L2C005R05200494125	chr1	653780	50M	197	653977	653781	653978	V350256906L2C005R05200494125_chr1_653780	68	56	CCCT	cact
V350256906L2C005R05200567688	chr1	158037	50M	190	158227	158038	158228	V350256906L2C005R05200567688_chr1_158037	18	9	TGTC	tCCC
V350256906L2C005R05201383753	chr1	653552	50M	142	653694	653553	653695	V350256906L2C005R05201383753_chr1_653552	44	10	TGTT	CCTT
V350256906L2C005R05300243294	chr1	22417	50M	161	22578	22418	22579	V350256906L2C005R05300243294_chr1_22417	36	52	CCAA	CTCC
V350256906L2C005R05300733943	chr1	704502	50M	205	704707	704503	704708	V350256906L2C005R05300733943_chr1_704502	0	126	ggca	CAAT
V350256906L2C005R05300868959	chr1	710284	50M	174	710458	710285	710459	V350256906L2C005R05300868959_chr1_710284	0	2	ctct	tgcc
V350256906L2C005R05300992952	chr1	1265650	50M	160	1265810	1265651	1265811	V350256906L2C005R05300992952_chr1_1265650	195	35	CCAT	GGCG
V350256906L2C005R05301318373	chr1	1231111	50M	155	1231266	1231112	1231267	V350256906L2C005R05301318373_chr1_1231111	22	74	CCCA	GGAA
V350256906L2C005R05400450380	chr1	94289	50M	217	94506	94290	94507	V350256906L2C005R05400450380_chr1_94289	16	35	aact	TGCA
V350256906L2C005R05400578811	chr1	381069	50M	173	381242	381070	381243	V350256906L2C005R05400578811_chr1_381069	44	104	atca	ccca
V350256906L2C005R05400612270	chr1	256434	50M	159	256593	256435	256594	V350256906L2C005R05400612270_chr1_256434	28	82	catt	atag
V350256906L2C005R05400820560	chr1	1223610	50M	140	1223750	1223611	1223751	V350256906L2C005R05400820560_chr1_1223610	67	33	tgct	cggg
V350256906L2C005R05400954436	chr1	786457	50M	150	786607	786458	786608	V350256906L2C005R05400954436_chr1_786457	244	97	tgct	TTTT
V350256906L2C005R05401064903	chr1	267534	26M1I23M	100	267634	267535	267635	V350256906L2C005R05401064903_chr1_267534	33	43	CGCT	ggtg
V350256906L2C005R05401131024	chr1	453967	50M	185	454152	453968	454153	V350256906L2C005R05401131024_chr1_453967	40	21	CAGG	TCCA
V350256906L2C005R05500619092	chr1	829500	50M	191	829691	829501	829692	V350256906L2C005R05500619092_chr1_829500	77	74	tctc	CATC
V350256906L2C005R05600943386	chr1	1413605	50M	171	1413776	1413606	1413777	V350256906L2C005R05600943386_chr1_1413605	62	68	gacc	CACC
V350256906L2C005R05700893428	chr1	666159	50M	170	666329	666160	666330	V350256906L2C005R05700893428_chr1_666159	0	0	aaaa	GTTG
V350256906L2C005R05701081779	chr1	1294535	50M	170	1294705	1294536	1294706	V350256906L2C005R05701081779_chr1_1294535	48	86	GTCA	CCCA
V350256906L2C005R05701336570	chr1	85035	50M	182	85217	85036	85218	V350256906L2C005R05701336570_chr1_85035	189	7	ccca	tatc
V350256906L2C005R05701361038	chr1	638971	50M	166	639137	638972	639138	V350256906L2C005R05701361038_chr1_638971	17	18	TCAT	CCAA
V350256906L2C005R05800676452	chr1	1110252	50M	172	1110424	1110253	1110425	V350256906L2C005R05800676452_chr1_1110252	59	24	cttt	ccca
V350256906L2C005R05800696915	chr1	536071	50M	186	536257	536072	536258	V350256906L2C005R05800696915_chr1_536071	223	68	cctg	ATGC
V350256906L2C005R05800870737	chr1	1019851	50M	177	1020028	1019852	1020029	V350256906L2C005R05800870737_chr1_1019851	71	43	GGTT	CCGG
V350256906L2C005R05800900973	chr1	1195219	50M	168	1195387	1195220	1195388	V350256906L2C005R05800900973_chr1_1195219	62	40	ccaa	AGGA
V350256906L2C005R05800934213	chr1	173377	50M	182	173559	173378	173560	V350256906L2C005R05800934213_chr1_173377	62	33	TGGG	AAAG
V350256906L2C005R05801035313	chr1	1390922	50M	152	1391074	1390923	1391075	V350256906L2C005R05801035313_chr1_1390922	78	10	GGGG	CGGG
V350256906L2C005R05801198680	chr1	235710	50M	222	235932	235711	235933	V350256906L2C005R05801198680_chr1_235710	118	56	GCTC	cacg
V350256906L2C005R05900402479	chr1	916588	50M	171	916759	916589	916760	V350256906L2C005R05900402479_chr1_916588	67	54	CCGC	TGAG
V350256906L2C005R05900673777	chr1	1205400	50M	170	1205570	1205401	1205571	V350256906L2C005R05900673777_chr1_1205400	0	56	gaaa	aaag
V350256906L2C005R05900696521	chr1	37861	50M	170	38031	37862	38032	V350256906L2C005R05900696521_chr1_37861	260	90	tGCC	ACAC
V350256906L2C005R05900966398	chr1	137458	50M	182	137640	137459	137641	V350256906L2C005R05900966398_chr1_137458	44	65	GCAG	CTGA
V350256906L2C005R05901020548	chr1	38451	50M	139	38590	38452	38591	V350256906L2C005R05901020548_chr1_38451	80	219	ccaa	acaa
V350256906L2C005R05901214674	chr1	843297	50M	164	843461	843298	843462	V350256906L2C005R05901214674_chr1_843297	0	4	CTGC	cttg
V350256906L2C005R06000817869	chr1	1259704	50M	124	1259828	1259705	1259829	V350256906L2C005R06000817869_chr1_1259704	196	72	CCCC	CGGG
V350256906L2C005R06000939686	chr1	792036	50M	166	792202	792037	792203	V350256906L2C005R06000939686_chr1_792036	54	62	CCTA	CTCA
V350256906L2C005R06001202331	chr1	609746	50M	171	609917	609747	609918	V350256906L2C005R06001202331_chr1_609746	114	22	catc	tctt
V350256906L2C005R06001240770	chr1	1033329	50M	167	1033496	1033330	1033497	V350256906L2C005R06001240770_chr1_1033329	73	0	cgca	gcct
V350256906L2C005R06100670767	chr1	1417036	50M	162	1417198	1417037	1417199	V350256906L2C005R06100670767_chr1_1417036	0	62	GAGT	TGGT
V350256906L2C005R06100897413	chr1	1250052	50M	192	1250244	1250053	1250245	V350256906L2C005R06100897413_chr1_1250052	263	71	CCTC	CCTG
V350256906L2C005R06101143916	chr1	1035973	50M	179	1036152	1035974	1036153	V350256906L2C005R06101143916_chr1_1035973	11	148	gttg	acaa
V350256906L2C005R06200465535	chr1	662878	50M	178	663056	662879	663057	V350256906L2C005R06200465535_chr1_662878	10	0	CCCC	CCCA
V350256906L2C005R06200480993	chr1	1126299	50M	154	1126453	1126300	1126454	V350256906L2C005R06200480993_chr1_1126299	36	71	gggt	ggat
V350256906L2C005R06200797886	chr1	46545	50M	230	46775	46546	46776	V350256906L2C005R06200797886_chr1_46545	0	213	GACA	GTAA
V350256906L2C005R06200982353	chr1	124356	50M	104	124460	124357	124461	V350256906L2C005R06200982353_chr1_124356	63	20	cacc	TCTA
V350256906L2C005R06201166253	chr1	872921	50M	165	873086	872922	873087	V350256906L2C005R06201166253_chr1_872921	0	28	GGTG	ggcg
V350256906L2C005R06201209374	chr1	641812	50M	204	642016	641813	642017	V350256906L2C005R06201209374_chr1_641812	55	74	TGAA	ccct
V350256906L2C005R06201253437	chr1	820716	50M	161	820877	820717	820878	V350256906L2C005R06201253437_chr1_820716	66	15	ggcc	ccaa
V350256906L2C005R06201275959	chr1	582613	50M	173	582786	582614	582787	V350256906L2C005R06201275959_chr1_582613	63	56	ctgt	ttct
V350256906L2C005R06201362951	chr1	333896	50M	260	334156	333897	334157	V350256906L2C005R06201362951_chr1_333896	61	25	gcac	TTTA
V350256906L2C005R06300004390	chr1	1424386	50M	173	1424559	1424387	1424560	V350256906L2C005R06300004390_chr1_1424386	78	72	gcct	GGCA
V350256906L2C005R06300115579	chr1	955878	50M	208	956086	955879	956087	V350256906L2C005R06300115579_chr1_955878	184	1	CCAA	CCCC
V350256906L2C005R06300145652	chr1	123190	50M	153	123343	123191	123344	V350256906L2C005R06300145652_chr1_123190	60	23	ctac	ACTG
V350256906L2C005R06300521715	chr1	336530	50M	168	336698	336531	336699	V350256906L2C005R06300521715_chr1_336530	60	55	ctta	ctct
V350256906L2C005R06300623882	chr1	134752	50M	170	134922	134753	134923	V350256906L2C005R06300623882_chr1_134752	0	76	CCCC	TATG
V350256906L2C005R06300660898	chr1	726319	50M	192	726511	726320	726512	V350256906L2C005R06300660898_chr1_726319	28	34	gaat	gtgt
V350256906L2C005R06301094692	chr1	535073	50M	205	535278	535074	535279	V350256906L2C005R06301094692_chr1_535073	194	0	tttt	tata
V350256906L2C005R06301274294	chr1	974288	50M	194	974482	974289	974483	V350256906L2C005R06301274294_chr1_974288	44	67	TGAG	cagt
V350256906L2C005R06301303637	chr1	1017106	50M	153	1017259	1017107	1017260	V350256906L2C005R06301303637_chr1_1017106	35	82	GGCG	GGCC
V350256906L2C005R06400041150	chr1	51008	50M	162	51170	51009	51171	V350256906L2C005R06400041150_chr1_51008	17	122	GATA	CAGA
V350256906L2C005R06400279882	chr1	618212	50M	165	618377	618213	618378	V350256906L2C005R06400279882_chr1_618212	0	0	CCGC	CCCA
V350256906L2C005R06400326688	chr1	54135	50M	170	54305	54136	54306	V350256906L2C005R06400326688_chr1_54135	45	78	TCTT	CATG
V350256906L2C005R06400340032	chr1	1356516	50M	164	1356680	1356517	1356681	V350256906L2C005R06400340032_chr1_1356516	18	0	AGGG	CCTG
V350256906L2C005R06400472119	chr1	18361	50M	170	18531	18362	18532	V350256906L2C005R06400472119_chr1_18361	22	124	CTCT	CCTG
V350256906L2C005R06400547628	chr1	1032627	50M	174	1032801	1032628	1032802	V350256906L2C005R06400547628_chr1_1032627	0	0	cagg	aaca
V350256906L2C005R06400688066	chr1	748081	50M	159	748240	748082	748241	V350256906L2C005R06400688066_chr1_748081	70	45	agga	cccc
V350256906L2C005R06401020732	chr1	899282	50M	194	899476	899283	899477	V350256906L2C005R06401020732_chr1_899282	49	70	CGGT	CAAC
V350256906L2C005R06401074710	chr1	251521	50M	145	251666	251522	251667	V350256906L2C005R06401074710_chr1_251521	67	40	CTAG	TTGT
V350256906L2C005R06401143742	chr1	1121447	26M1I23M	151	1121598	1121448	1121599	V350256906L2C005R06401143742_chr1_1121447	0	143	cgta	actt
V350256906L2C005R06500231773	chr1	773482	50M	143	773625	773483	773626	V350256906L2C005R06500231773_chr1_773482	13	37	cgct	caaa
V350256906L2C005R06500789081	chr1	611117	50M	177	611294	611118	611295	V350256906L2C005R06500789081_chr1_611117	71	58	CTCC	gcAA
V350256906L2C005R06500814759	chr1	30850	50M	96	30946	30851	30947	V350256906L2C005R06500814759_chr1_30850	28	0	CATT	gaga
V350256906L2C005R06500906360	chr1	1279835	50M	144	1279979	1279836	1279980	V350256906L2C005R06500906360_chr1_1279835	42	71	CACC	CCTC
V350256906L2C005R06500937690	chr1	641156	50M	182	641338	641157	641339	V350256906L2C005R06500937690_chr1_641156	59	102	GGCA	TCTG
V350256906L2C005R06501125801	chr1	82681	50M	156	82837	82682	82838	V350256906L2C005R06501125801_chr1_82681	0	96	cact	tccc
V350256906L2C005R06600049875	chr1	816705	50M	178	816883	816706	816884	V350256906L2C005R06600049875_chr1_816705	151	89	ctta	TGAA
V350256906L2C005R06600117151	chr1	161395	50M	163	161558	161396	161559	V350256906L2C005R06600117151_chr1_161395	59	36	caag	ttat
V350256906L2C005R06601053667	chr1	65795	50M	153	65948	65796	65949	V350256906L2C005R06601053667_chr1_65795	120	114	GCTG	ACCA
V350256906L2C005R06700043119	chr1	940805	5M1I44M	154	940959	940806	940960	V350256906L2C005R06700043119_chr1_940805	72	58	CTCT	cctc
V350256906L2C005R06700106618	chr1	52592	50M	127	52719	52593	52720	V350256906L2C005R06700106618_chr1_52592	225	98	CACA	TGGA
V350256906L2C005R06700158166	chr1	1112400	50M	162	1112562	1112401	1112563	V350256906L2C005R06700158166_chr1_1112400	0	46	ctgc	ACAG
V350256906L2C005R06700256151	chr1	1091992	50M	181	1092173	1091993	1092174	V350256906L2C005R06700256151_chr1_1091992	30	27	TGTG	CACA
V350256906L2C005R06700455794	chr1	336342	50M	175	336517	336343	336518	V350256906L2C005R06700455794_chr1_336342	96	73	ACTG	aaat
V350256906L2C005R06700550364	chr1	42362	50M	152	42514	42363	42515	V350256906L2C005R06700550364_chr1_42362	186	34	ATTT	CTCA
V350256906L2C005R06700559741	chr1	1340011	50M	165	1340176	1340012	1340177	V350256906L2C005R06700559741_chr1_1340011	70	60	gctg	CCCC
V350256906L2C005R06700951601	chr1	725639	42M8S	204	725843	725640	725844	V350256906L2C005R06700951601_chr1_725639	123	40	atgg	caat
V350256906L2C005R06701239774	chr1	35593	50M	167	35760	35594	35761	V350256906L2C005R06701239774_chr1_35593	38	66	GTGT	CGTG
V350256906L2C005R06701273763	chr1	883576	50M	183	883759	883577	883760	V350256906L2C005R06701273763_chr1_883576	64	63	CCAG	GGTC
V350256906L2C005R06800371482	chr1	28409	50M	163	28572	28410	28573	V350256906L2C005R06800371482_chr1_28409	73	41	CGGA	TACT
V350256906L2C005R06800472590	chr1	1247549	30M2I18M	133	1247682	1247550	1247683	V350256906L2C005R06800472590_chr1_1247549	42	42	CCCT	TCAC
V350256906L2C005R06800573527	chr1	1391176	50M	188	1391364	1391177	1391365	V350256906L2C005R06800573527_chr1_1391176	29	13	CCTG	CCAG
V350256906L2C005R06801043999	chr1	760606	50M	186	760792	760607	760793	V350256906L2C005R06801043999_chr1_760606	81	82	CAGA	CTGA
V350256906L2C005R06801255090	chr1	901655	50M	177	901832	901656	901833	V350256906L2C005R06801255090_chr1_901655	60	60	AGGT	CGGG
V350256906L2C005R06900019386	chr1	1031578	50M	139	1031717	1031579	1031718	V350256906L2C005R06900019386_chr1_1031578	0	34	tcct	ctgt
V350256906L2C005R06900993571	chr1	77049	50M	158	77207	77050	77208	V350256906L2C005R06900993571_chr1_77049	62	220	cttg	ggtt
V350256906L2C005R06901043126	chr1	1230740	50M	195	1230935	1230741	1230936	V350256906L2C005R06901043126_chr1_1230740	45	27	TGGC	TGGG
V350256906L2C005R06901104331	chr1	53195	50M	147	53342	53196	53343	V350256906L2C005R06901104331_chr1_53195	30	76	TGTA	ATCC
V350256906L2C005R06901134291	chr1	1365637	50M	176	1365813	1365638	1365814	V350256906L2C005R06901134291_chr1_1365637	44	67	ccag	CGAG
V350256906L2C005R07000062044	chr1	777385	50M	174	777559	777386	777560	V350256906L2C005R07000062044_chr1_777385	77	75	GATG	CCAG
V350256906L2C005R07000255642	chr1	1065479	50M	142	1065621	1065480	1065622	V350256906L2C005R07000255642_chr1_1065479	0	7	atcg	CAAG
V350256906L2C005R07000879163	chr1	102104	50M	181	102285	102105	102286	V350256906L2C005R07000879163_chr1_102104	0	0	aaaa	CCAG
V350256906L2C005R07001155417	chr1	120377	50M	165	120542	120378	120543	V350256906L2C005R07001155417_chr1_120377	36	0	CCAA	CTTC
V350256906L2C005R07001159342	chr1	30172	50M	271	30443	30173	30444	V350256906L2C005R07001159342_chr1_30172	18	56	tgta	ccca
V350256906L2C005R07001206765	chr1	1222378	50M	228	1222606	1222379	1222607	V350256906L2C005R07001206765_chr1_1222378	14	62	GCAG	CCAT
V350256906L2C005R07001362269	chr1	82780	50M	166	82946	82781	82947	V350256906L2C005R07001362269_chr1_82780	91	0	taaa	tctt
V350256906L2C005R07100027815	chr1	658166	50M	161	658327	658167	658328	V350256906L2C005R07100027815_chr1_658166	113	24	CCCT	TCTC
V350256906L2C005R07100282315	chr1	79847	50M	165	80012	79848	80013	V350256906L2C005R07100282315_chr1_79847	32	19	acca	tgct
V350256906L2C005R07101157492	chr1	175677	50M	168	175845	175678	175846	V350256906L2C005R07101157492_chr1_175677	102	52	ctgc	caag
V350256906L2C005R07101209452	chr1	1128779	7S43M	177	1128956	1128780	1128957	V350256906L2C005R07101209452_chr1_1128779	65	61	tgtc	agga
V350256906L2C005R07101373126	chr1	1332626	50M	179	1332805	1332627	1332806	V350256906L2C005R07101373126_chr1_1332626	6	14	TCTC	cact
V350256906L2C005R07200268693	chr1	803066	50M	148	803214	803067	803215	V350256906L2C005R07200268693_chr1_803066	10	0	GCTC	TTTC
V350256906L2C005R07200477387	chr1	611480	50M	158	611638	611481	611639	V350256906L2C005R07200477387_chr1_611480	50	47	caag	tagg
V350256906L2C005R07200582080	chr1	19066	50M	188	19254	19067	19255	V350256906L2C005R07200582080_chr1_19066	50	238	GTGT	TGCA
V350256906L2C005R07200722079	chr1	456633	50M	138	456771	456634	456772	V350256906L2C005R07200722079_chr1_456633	331	193	ctag	ctaa
V350256906L2C005R07200907663	chr1	924224	50M	236	924460	924225	924461	V350256906L2C005R07200907663_chr1_924224	240	4	ATTG	GAAA
V350256906L2C005R07200976650	chr1	1293298	50M	196	1293494	1293299	1293495	V350256906L2C005R07200976650_chr1_1293298	8	0	TGCA	GTGG
V350256906L2C005R07200989785	chr1	151439	50M	213	151652	151440	151653	V350256906L2C005R07200989785_chr1_151439	54	37	ccta	acta
V350256906L2C006R00100155380	chr1	1088328	50M	177	1088505	1088329	1088506	V350256906L2C006R00100155380_chr1_1088328	150	2	CAGG	CCCT
V350256906L2C006R00100246659	chr1	1113976	50M	216	1114192	1113977	1114193	V350256906L2C006R00100246659_chr1_1113976	17	0	CCCC	TGTC
V350256906L2C006R00100337529	chr1	942526	50M	173	942699	942527	942700	V350256906L2C006R00100337529_chr1_942526	65	51	CATT	ccgc
V350256906L2C006R00100757932	chr1	781283	50M	184	781467	781284	781468	V350256906L2C006R00100757932_chr1_781283	62	30	CTGC	tatc
V350256906L2C006R00100877346	chr1	153134	50M	160	153294	153135	153295	V350256906L2C006R00100877346_chr1_153134	384	224	tgag	cctc
V350256906L2C006R00100881107	chr1	745943	50M	152	746095	745944	746096	V350256906L2C006R00100881107_chr1_745943	39	5	ACTC	AATA
V350256906L2C006R00100900434	chr1	926554	50M	146	926700	926555	926701	V350256906L2C006R00100900434_chr1_926554	32	81	catc	acct
V350256906L2C006R00101146826	chr1	940416	50M	109	940525	940417	940526	V350256906L2C006R00101146826_chr1_940416	37	38	CTGT	CAAT
V350256906L2C006R00200361158	chr1	828875	50M	190	829065	828876	829066	V350256906L2C006R00200361158_chr1_828875	46	58	agcc	ctgc
V350256906L2C006R00200476226	chr1	318738	50M	180	318918	318739	318919	V350256906L2C006R00200476226_chr1_318738	47	27	tacg	tgtg
V350256906L2C006R00200885550	chr1	748617	50M	169	748786	748618	748787	V350256906L2C006R00200885550_chr1_748617	64	66	CCCC	TGTT
V350256906L2C006R00201358379	chr1	1099824	50M	162	1099986	1099825	1099987	V350256906L2C006R00201358379_chr1_1099824	49	57	CAGA	GGCG
V350256906L2C006R00201360475	chr1	1193335	50M	187	1193522	1193336	1193523	V350256906L2C006R00201360475_chr1_1193335	120	42	CCTG	cttg
V350256906L2C006R00300297371	chr1	1038440	50M	163	1038603	1038441	1038604	V350256906L2C006R00300297371_chr1_1038440	162	174	cttg	acaa
V350256906L2C006R00300616746	chr1	1317113	50M	159	1317272	1317114	1317273	V350256906L2C006R00300616746_chr1_1317113	47	65	CCCA	CCCT
V350256906L2C006R00300660401	chr1	368093	50M	162	368255	368094	368256	V350256906L2C006R00300660401_chr1_368093	33	59	GGCT	ACCA
V350256906L2C006R00301039247	chr1	16117	50M	139	16256	16118	16257	V350256906L2C006R00301039247_chr1_16117	105	11	CTGA	CTCT
V350256906L2C006R00400058321	chr1	843491	50M	147	843638	843492	843639	V350256906L2C006R00400058321_chr1_843491	0	139	cgtg	CCTG
V350256906L2C006R00400154548	chr1	1431944	50M	152	1432096	1431945	1432097	V350256906L2C006R00400154548_chr1_1431944	33	80	GCCT	CCCA
V350256906L2C006R00400254683	chr1	1014965	50M	155	1015120	1014966	1015121	V350256906L2C006R00400254683_chr1_1014965	0	45	CACT	CCCG
V350256906L2C006R00400351887	chr1	1328276	50M	163	1328439	1328277	1328440	V350256906L2C006R00400351887_chr1_1328276	47	80	CCCT	GTTT
V350256906L2C006R00400806947	chr1	1161452	50M	182	1161634	1161453	1161635	V350256906L2C006R00400806947_chr1_1161452	95	200	cctg	TGCA
V350256906L2C006R00400988382	chr1	674409	50M	139	674548	674410	674549	V350256906L2C006R00400988382_chr1_674409	27	60	ctca	CAGA
V350256906L2C006R00400990447	chr1	1204048	50M	192	1204240	1204049	1204241	V350256906L2C006R00400990447_chr1_1204048	42	24	CCAG	acaa
V350256906L2C006R00500477071	chr1	233107	50M	155	233262	233108	233263	V350256906L2C006R00500477071_chr1_233107	124	56	GGAA	CACA
V350256906L2C006R00500537750	chr1	84944	50M	148	85092	84945	85093	V350256906L2C006R00500537750_chr1_84944	264	132	acta	ctct
V350256906L2C006R00500731244	chr1	751983	50M	262	752245	751984	752246	V350256906L2C006R00500731244_chr1_751983	21	132	AACA	agat
V350256906L2C006R00501122794	chr1	1254251	50M	178	1254429	1254252	1254430	V350256906L2C006R00501122794_chr1_1254251	0	157	CCCT	CCAG
V350256906L2C006R00600124798	chr1	877393	50M	149	877542	877394	877543	V350256906L2C006R00600124798_chr1_877393	65	214	TAAC	GCAA
V350256906L2C006R00600363994	chr1	344219	50M	186	344405	344220	344406	V350256906L2C006R00600363994_chr1_344219	59	106	ccct	ctgt
V350256906L2C006R00600509632	chr1	714227	50M	170	714397	714228	714398	V350256906L2C006R00600509632_chr1_714227	22	72	GCAG	CGAT
V350256906L2C006R00600520204	chr1	892866	50M	135	893001	892867	893002	V350256906L2C006R00600520204_chr1_892866	44	12	CCCT	gcct
V350256906L2C006R00600714902	chr1	456348	50M	194	456542	456349	456543	V350256906L2C006R00600714902_chr1_456348	616	422	ccaa	caaa
V350256906L2C006R00600799265	chr1	108995	50M	144	109139	108996	109140	V350256906L2C006R00600799265_chr1_108995	0	8	CAAT	ATGC
V350256906L2C006R00700394227	chr1	670413	50M	158	670571	670414	670572	V350256906L2C006R00700394227_chr1_670413	110	102	gggc	cagg
V350256906L2C006R00700763667	chr1	670737	50M	167	670904	670738	670905	V350256906L2C006R00700763667_chr1_670737	19	0	ccct	ctca
V350256906L2C006R00700803931	chr1	420139	50M	161	420300	420140	420301	V350256906L2C006R00700803931_chr1_420139	35	24	TCAG	CACC
V350256906L2C006R00700826185	chr1	93126	50M	163	93289	93127	93290	V350256906L2C006R00700826185_chr1_93126	33	72	CAGA	tgat
V350256906L2C006R00700874115	chr1	916304	50M	169	916473	916305	916474	V350256906L2C006R00700874115_chr1_916304	6	0	CCCC	CTGA
V350256906L2C006R00700903485	chr1	1331707	50M	168	1331875	1331708	1331876	V350256906L2C006R00700903485_chr1_1331707	29	52	cgcg	cggg
V350256906L2C006R00701363115	chr1	16433	50M	168	16601	16434	16602	V350256906L2C006R00701363115_chr1_16433	188	72	CCAG	GCAG
V350256906L2C006R00800129359	chr1	111189	50M	160	111349	111190	111350	V350256906L2C006R00800129359_chr1_111189	50	58	cccc	cttg
V350256906L2C006R00800456241	chr1	568698	50M	183	568881	568699	568882	V350256906L2C006R00800456241_chr1_568698	50	70	CGAC	TAAC
V350256906L2C006R00800537411	chr1	155908	50M	158	156066	155909	156067	V350256906L2C006R00800537411_chr1_155908	296	163	TAAA	gatt
V350256906L2C006R00800544618	chr1	681475	50M	167	681642	681476	681643	V350256906L2C006R00800544618_chr1_681475	4	29	cccc	ataa
V350256906L2C006R00800660942	chr1	1131670	50M	158	1131828	1131671	1131829	V350256906L2C006R00800660942_chr1_1131670	28	46	ccaa	CACA
V350256906L2C006R00800798028	chr1	1206265	50M	151	1206416	1206266	1206417	V350256906L2C006R00800798028_chr1_1206265	28	179	CCAA	GGAA
V350256906L2C006R00800798086	chr1	123788	50M	179	123967	123789	123968	V350256906L2C006R00800798086_chr1_123788	85	62	acag	gtag
V350256906L2C006R00800820321	chr1	739363	50M	251	739614	739364	739615	V350256906L2C006R00800820321_chr1_739363	9	10	TGCA	acta
V350256906L2C006R00801046501	chr1	407270	50M	185	407455	407271	407456	V350256906L2C006R00801046501_chr1_407270	0	144	ctct	tgga
V350256906L2C006R00801225436	chr1	940612	50M	164	940776	940613	940777	V350256906L2C006R00801225436_chr1_940612	71	74	CACC	GCAG
V350256906L2C006R00801273139	chr1	1306549	50M	185	1306734	1306550	1306735	V350256906L2C006R00801273139_chr1_1306549	49	43	GGTT	CCCT
V350256906L2C006R00801282293	chr1	769614	50M	163	769777	769615	769778	V350256906L2C006R00801282293_chr1_769614	302	139	TGAG	CCCC
V350256906L2C006R00801356501	chr1	585099	50M	173	585272	585100	585273	V350256906L2C006R00801356501_chr1_585099	55	38	caaa	acat
V350256906L2C006R00900290881	chr1	348183	50M	169	348352	348184	348353	V350256906L2C006R00900290881_chr1_348183	116	0	tgat	CAGA
V350256906L2C006R00900313676	chr1	327714	50M	168	327882	327715	327883	V350256906L2C006R00900313676_chr1_327714	184	176	CCTG	GGAC
V350256906L2C006R00900338814	chr1	403021	50M	164	403185	403022	403186	V350256906L2C006R00900338814_chr1_403021	64	39	atct	ttga
V350256906L2C006R00900430239	chr1	778241	50M	191	778432	778242	778433	V350256906L2C006R00900430239_chr1_778241	56	80	TGCA	TGAT
V350256906L2C006R00900478063	chr1	319176	50M	139	319315	319177	319316	V350256906L2C006R00900478063_chr1_319176	0	56	ccaa	ccct
V350256906L2C006R00900674555	chr1	816934	50M	176	817110	816935	817111	V350256906L2C006R00900674555_chr1_816934	38	5	CATG	CTTA
V350256906L2C006R00900748074	chr1	1169015	50M	162	1169177	1169016	1169178	V350256906L2C006R00900748074_chr1_1169015	63	55	TTTT	ACCA
V350256906L2C006R01000071613	chr1	728649	50M	206	728855	728650	728856	V350256906L2C006R01000071613_chr1_728649	273	67	tcat	atat
V350256906L2C006R01000106610	chr1	1354163	50M	158	1354321	1354164	1354322	V350256906L2C006R01000106610_chr1_1354163	42	63	actt	CCAG
V350256906L2C006R01000205708	chr1	854935	50M	171	855106	854936	855107	V350256906L2C006R01000205708_chr1_854935	0	23	GCTG	CCCT
V350256906L2C006R01000263550	chr1	559621	50M	148	559769	559622	559770	V350256906L2C006R01000263550_chr1_559621	159	11	CATG	cagg
V350256906L2C006R01000380574	chr1	797464	50M	147	797611	797465	797612	V350256906L2C006R01000380574_chr1_797464	59	37	ggat	CTTT
V350256906L2C006R01000570012	chr1	56797	50M	144	56941	56798	56942	V350256906L2C006R01000570012_chr1_56797	56	46	TATA	GAAA
V350256906L2C006R01000741100	chr1	12803	50M	153	12956	12804	12957	V350256906L2C006R01000741100_chr1_12803	99	53	GCTT	CCCA
V350256906L2C006R01000764165	chr1	1029938	50M	112	1030050	1029939	1030051	V350256906L2C006R01000764165_chr1_1029938	18	20	gccc	ctag
V350256906L2C006R01001153107	chr1	1112645	50M	197	1112842	1112646	1112843	V350256906L2C006R01001153107_chr1_1112645	0	15	tgtg	tggg
V350256906L2C006R01001228946	chr1	1127076	50M	147	1127223	1127077	1127224	V350256906L2C006R01001228946_chr1_1127076	9	23	cctc	cctt
V350256906L2C006R01001305134	chr1	1427229	50M	195	1427424	1427230	1427425	V350256906L2C006R01001305134_chr1_1427229	71	99	CCAG	cggc
V350256906L2C006R01100253252	chr1	1371623	50M	180	1371803	1371624	1371804	V350256906L2C006R01100253252_chr1_1371623	49	50	TGGG	CAGA
V350256906L2C006R01100311361	chr1	427730	50M	194	427924	427731	427925	V350256906L2C006R01100311361_chr1_427730	36	88	CTGT	gatt
V350256906L2C006R01100532535	chr1	20694	50M	186	20880	20695	20881	V350256906L2C006R01100532535_chr1_20694	21	0	GTTA	GGGG
V350256906L2C006R01100841478	chr1	1098504	50M	170	1098674	1098505	1098675	V350256906L2C006R01100841478_chr1_1098504	140	2	CCCC	CCCT
V350256906L2C006R01100878008	chr1	721247	50M	156	721403	721248	721404	V350256906L2C006R01100878008_chr1_721247	54	20	CACT	CAGT
V350256906L2C006R01100880307	chr1	769478	50M	163	769641	769479	769642	V350256906L2C006R01100880307_chr1_769478	192	275	TGGG	TGCT
V350256906L2C006R01101127298	chr1	53139	50M	178	53317	53140	53318	V350256906L2C006R01101127298_chr1_53139	25	51	AAAG	AGAC
V350256906L2C006R01101137547	chr1	642810	50M	147	642957	642811	642958	V350256906L2C006R01101137547_chr1_642810	5	43	agag	gacc
V350256906L2C006R01101150422	chr1	1418958	50M	202	1419160	1418959	1419161	V350256906L2C006R01101150422_chr1_1418958	162	10	cctg	ggcc
V350256906L2C006R01101310964	chr1	1358003	50M	166	1358169	1358004	1358170	V350256906L2C006R01101310964_chr1_1358003	38	2	ctcc	ggtt
V350256906L2C006R01101390706	chr1	897540	50M	173	897713	897541	897714	V350256906L2C006R01101390706_chr1_897540	57	51	CCTG	CTGA
V350256906L2C006R01200132998	chr1	813947	50M	186	814133	813948	814134	V350256906L2C006R01200132998_chr1_813947	58	105	GAGA	CCCA
V350256906L2C006R01200153047	chr1	625050	50M	155	625205	625051	625206	V350256906L2C006R01200153047_chr1_625050	52	70	GGAT	TCAT
V350256906L2C006R01200718280	chr1	122642	2S48M	164	122806	122643	122807	V350256906L2C006R01200718280_chr1_122642	50	72	ATAT	CCAC
V350256906L2C006R01200806529	chr1	170931	50M	151	171082	170932	171083	V350256906L2C006R01200806529_chr1_170931	451	300	caag	tgta
V350256906L2C006R01201093529	chr1	53017	50M	146	53163	53018	53164	V350256906L2C006R01201093529_chr1_53017	29	49	AACT	GATC
V350256906L2C006R01201344907	chr1	769856	50M	165	770021	769857	770022	V350256906L2C006R01201344907_chr1_769856	60	58	TGAT	CCCT
V350256906L2C006R01300022422	chr1	1403559	50M	157	1403716	1403560	1403717	V350256906L2C006R01300022422_chr1_1403559	10	22	CGCA	CCCC
V350256906L2C006R01300036927	chr1	56079	50M	178	56257	56080	56258	V350256906L2C006R01300036927_chr1_56079	106	78	TGTA	CAGG
V350256906L2C006R01300104883	chr1	61055	50M	185	61240	61056	61241	V350256906L2C006R01300104883_chr1_61055	185	77	GGCA	CTAC
V350256906L2C006R01300585204	chr1	612829	50M	172	613001	612830	613002	V350256906L2C006R01300585204_chr1_612829	81	64	ccca	tatc
V350256906L2C006R01300680345	chr1	443026	50M	170	443196	443027	443197	V350256906L2C006R01300680345_chr1_443026	63	43	CTCC	tgca
V350256906L2C006R01300865754	chr1	169466	50M	159	169625	169467	169626	V350256906L2C006R01300865754_chr1_169466	245	86	gcca	agtg
V350256906L2C006R01400169062	chr1	1256191	50M	178	1256369	1256192	1256370	V350256906L2C006R01400169062_chr1_1256191	1	45	AGGG	CCTT
V350256906L2C006R01400656816	chr1	164750	50M	160	164910	164751	164911	V350256906L2C006R01400656816_chr1_164750	0	0	GGTA	TCAC
V350256906L2C006R01400875984	chr1	120153	50M	133	120286	120154	120287	V350256906L2C006R01400875984_chr1_120153	156	23	TAAA	CAGA
V350256906L2C006R01401002884	chr1	75708	50M	166	75874	75709	75875	V350256906L2C006R01401002884_chr1_75708	223	57	tgtt	ctga
V350256906L2C006R01401166220	chr1	1120611	50M	167	1120778	1120612	1120779	V350256906L2C006R01401166220_chr1_1120611	49	38	CCTG	CACT
V350256906L2C006R01401256031	chr1	1288875	50M	173	1289048	1288876	1289049	V350256906L2C006R01401256031_chr1_1288875	26	25	CGGG	AGGA
V350256906L2C006R01401383669	chr1	340685	50M	170	340855	340686	340856	V350256906L2C006R01401383669_chr1_340685	98	82	AAAG	ACAA
V350256906L2C006R01500010592	chr1	104766	50M	164	104930	104767	104931	V350256906L2C006R01500010592_chr1_104766	48	0	agaa	attt
V350256906L2C006R01500068592	chr1	773215	50M	177	773392	773216	773393	V350256906L2C006R01500068592_chr1_773215	106	53	ccag	tgag
V350256906L2C006R01501241142	chr1	1065205	50M	167	1065372	1065206	1065373	V350256906L2C006R01501241142_chr1_1065205	54	67	ACCT	gctt
V350256906L2C006R01501334600	chr1	172858	50M	159	173017	172859	173018	V350256906L2C006R01501334600_chr1_172858	107	95	gatt	GCAC
V350256906L2C006R01501397015	chr1	831430	50M	154	831584	831431	831585	V350256906L2C006R01501397015_chr1_831430	133	0	cttt	aaag
V350256906L2C006R01600039832	chr1	1087879	50M	220	1088099	1087880	1088100	V350256906L2C006R01600039832_chr1_1087879	77	12	CCCA	CTGG
V350256906L2C006R01600259598	chr1	75516	50M	160	75676	75517	75677	V350256906L2C006R01600259598_chr1_75516	90	250	aaat	ccct
V350256906L2C006R01600285822	chr1	1226534	50M	179	1226713	1226535	1226714	V350256906L2C006R01600285822_chr1_1226534	0	22	CCCT	GGAG
V350256906L2C006R01600347131	chr1	527299	50M	169	527468	527300	527469	V350256906L2C006R01600347131_chr1_527299	71	0	atgc	tccc
V350256906L2C006R01600403719	chr1	1191593	50M	165	1191758	1191594	1191759	V350256906L2C006R01600403719_chr1_1191593	14	23	GCAG	CGGG
V350256906L2C006R01601319014	chr1	251715	50M	160	251875	251716	251876	V350256906L2C006R01601319014_chr1_251715	82	51	GTAA	CTTT
V350256906L2C006R01700008732	chr1	1213963	50M	165	1214128	1213964	1214129	V350256906L2C006R01700008732_chr1_1213963	21	56	tcta	gcca
V350256906L2C006R01700202283	chr1	441356	50M	182	441538	441357	441539	V350256906L2C006R01700202283_chr1_441356	19	201	CCTG	CTCT
V350256906L2C006R01700374305	chr1	703208	50M	171	703379	703209	703380	V350256906L2C006R01700374305_chr1_703208	60	22	cctg	ctca
V350256906L2C006R01700397644	chr1	882292	50M	162	882454	882293	882455	V350256906L2C006R01700397644_chr1_882292	12	81	ctgg	TAGT
V350256906L2C006R01700595869	chr1	262079	50M	164	262243	262080	262244	V350256906L2C006R01700595869_chr1_262079	8	0	CTCT	caag
V350256906L2C006R01700672735	chr1	574858	50M	168	575026	574859	575027	V350256906L2C006R01700672735_chr1_574858	0	12	caat	gttt
V350256906L2C006R01700768031	chr1	783425	50M	159	783584	783426	783585	V350256906L2C006R01700768031_chr1_783425	0	153	CTGA	CCTA
V350256906L2C006R01800806324	chr1	447927	50M	152	448079	447928	448080	V350256906L2C006R01800806324_chr1_447927	0	5	aaaa	gggg
V350256906L2C006R01800821505	chr1	409239	50M	184	409423	409240	409424	V350256906L2C006R01800821505_chr1_409239	78	83	CTGG	CTCA
V350256906L2C006R01801092746	chr1	583277	50M	187	583464	583278	583465	V350256906L2C006R01801092746_chr1_583277	139	0	taag	tgtt
V350256906L2C006R01801392164	chr1	1213699	50M	234	1213933	1213700	1213934	V350256906L2C006R01801392164_chr1_1213699	27	51	gaat	ccat
V350256906L2C006R01900148896	chr1	1313006	50M	153	1313159	1313007	1313160	V350256906L2C006R01900148896_chr1_1313006	0	0	atag	ataG
V350256906L2C006R01900181574	chr1	99341	50M	143	99484	99342	99485	V350256906L2C006R01900181574_chr1_99341	99	85	accc	TCCA
V350256906L2C006R01900365268	chr1	320760	50M	174	320934	320761	320935	V350256906L2C006R01900365268_chr1_320760	54	53	cgtt	tgta
V350256906L2C006R01900442430	chr1	1314836	50M	154	1314990	1314837	1314991	V350256906L2C006R01900442430_chr1_1314836	121	4	cgtc	tctt
V350256906L2C006R01901398617	chr1	638365	50M	174	638539	638366	638540	V350256906L2C006R01901398617_chr1_638365	173	0	ACCT	agtt
V350256906L2C006R02000087610	chr1	62819	50M	172	62991	62820	62992	V350256906L2C006R02000087610_chr1_62819	86	79	CTAT	TAAT
V350256906L2C006R02000540997	chr1	1134244	50M	157	1134401	1134245	1134402	V350256906L2C006R02000540997_chr1_1134244	0	0	CTCC	CAGA
V350256906L2C006R02000721856	chr1	139462	50M	168	139630	139463	139631	V350256906L2C006R02000721856_chr1_139462	164	0	CTTG	TGAC
V350256906L2C006R02000737578	chr1	700678	50M	172	700850	700679	700851	V350256906L2C006R02000737578_chr1_700678	50	75	AAGA	cact
V350256906L2C006R02001086783	chr1	578191	50M	187	578378	578192	578379	V350256906L2C006R02001086783_chr1_578191	152	0	CCTT	CCGA
V350256906L2C006R02001341768	chr1	1352909	50M	160	1353069	1352910	1353070	V350256906L2C006R02001341768_chr1_1352909	29	24	gccg	ccat
V350256906L2C006R02100263255	chr1	1324510	50M	180	1324690	1324511	1324691	V350256906L2C006R02100263255_chr1_1324510	61	69	tggg	gcaa
V350256906L2C006R02100314240	chr1	863900	50M	240	864140	863901	864141	V350256906L2C006R02100314240_chr1_863900	46	82	CTGT	CCCC
V350256906L2C006R02100364808	chr1	780581	50M	159	780740	780582	780741	V350256906L2C006R02100364808_chr1_780581	45	63	GGAT	GCAA
V350256906L2C006R02100382566	chr1	1231377	50M	155	1231532	1231378	1231533	V350256906L2C006R02100382566_chr1_1231377	0	4	GACT	TGCA
V350256906L2C006R02100405698	chr1	960018	50M	181	960199	960019	960200	V350256906L2C006R02100405698_chr1_960018	40	79	CTGA	CCAG
V350256906L2C006R02100510699	chr1	1242779	50M	177	1242956	1242780	1242957	V350256906L2C006R02100510699_chr1_1242779	82	70	AGTC	CCTG
V350256906L2C006R02100571427	chr1	41343	50M	167	41510	41344	41511	V350256906L2C006R02100571427_chr1_41343	132	299	TCCA	taaa
V350256906L2C006R02101150253	chr1	818620	50M	158	818778	818621	818779	V350256906L2C006R02101150253_chr1_818620	158	0	ggcc	tgga
V350256906L2C006R02200184237	chr1	1172615	50M	179	1172794	1172616	1172795	V350256906L2C006R02200184237_chr1_1172615	18	18	CCCC	CAGG
V350256906L2C006R02200285673	chr1	1021750	50M	158	1021908	1021751	1021909	V350256906L2C006R02200285673_chr1_1021750	47	81	CCTC	CACC
V350256906L2C006R02201006520	chr1	947272	50M	188	947460	947273	947461	V350256906L2C006R02201006520_chr1_947272	14	1	acac	taaa
V350256906L2C006R02201019326	chr1	775674	50M	183	775857	775675	775858	V350256906L2C006R02201019326_chr1_775674	60	45	cgat	GATT
V350256906L2C006R02201067120	chr1	1040971	50M	164	1041135	1040972	1041136	V350256906L2C006R02201067120_chr1_1040971	8	0	ATAA	ctac
V350256906L2C006R02201224410	chr1	931269	50M	192	931461	931270	931462	V350256906L2C006R02201224410_chr1_931269	62	95	CCAC	CCCC
V350256906L2C006R02300048131	chr1	525810	50M	154	525964	525811	525965	V350256906L2C006R02300048131_chr1_525810	64	63	gggg	cctg
V350256906L2C006R02300435171	chr1	1105927	50M	149	1106076	1105928	1106077	V350256906L2C006R02300435171_chr1_1105927	184	266	cctc	CCCC
V350256906L2C006R02300818795	chr1	724947	33M17S	154	725101	724948	725102	V350256906L2C006R02300818795_chr1_724947	0	131	gtat	attc
V350256906L2C006R02300852997	chr1	1017448	50M	148	1017596	1017449	1017597	V350256906L2C006R02300852997_chr1_1017448	62	3	CCAG	CCCC
V350256906L2C006R02300930263	chr1	836815	50M	167	836982	836816	836983	V350256906L2C006R02300930263_chr1_836815	56	39	ccct	CCCA
V350256906L2C006R02301344729	chr1	790218	50M	154	790372	790219	790373	V350256906L2C006R02301344729_chr1_790218	42	82	CCGA	TGAA
V350256906L2C006R02301353228	chr1	1120861	50M	179	1121040	1120862	1121041	V350256906L2C006R02301353228_chr1_1120861	29	39	CCTG	CCCC
V350256906L2C006R02400200175	chr1	252580	50M	187	252767	252581	252768	V350256906L2C006R02400200175_chr1_252580	214	278	AAAG	aaat
V350256906L2C006R02400636016	chr1	775223	50M	151	775374	775224	775375	V350256906L2C006R02400636016_chr1_775223	0	0	cagc	tgtg
V350256906L2C006R02400714844	chr1	113043	50M	195	113238	113044	113239	V350256906L2C006R02400714844_chr1_113043	33	97	TGGG	CTCA
V350256906L2C006R02400756169	chr1	651719	50M	169	651888	651720	651889	V350256906L2C006R02400756169_chr1_651719	57	62	GAAC	TAAT
V350256906L2C006R02400789348	chr1	557362	50M	175	557537	557363	557538	V350256906L2C006R02400789348_chr1_557362	277	102	CTTT	CCAT
V350256906L2C006R02401321864	chr1	394559	50M	179	394738	394560	394739	V350256906L2C006R02401321864_chr1_394559	22	20	caac	aaat
V350256906L2C006R02500161517	chr1	547488	50M	196	547684	547489	547685	V350256906L2C006R02500161517_chr1_547488	0	177	tgtg	CACG
V350256906L2C006R02500348177	chr1	1245345	50M	161	1245506	1245346	1245507	V350256906L2C006R02500348177_chr1_1245345	65	62	CCTC	GACC
V350256906L2C006R02500448347	chr1	1366095	50M	180	1366275	1366096	1366276	V350256906L2C006R02500448347_chr1_1366095	0	0	CAGG	GCCC
V350256906L2C006R02500461673	chr1	1022260	50M	151	1022411	1022261	1022412	V350256906L2C006R02500461673_chr1_1022260	38	38	CTGA	CTGC
V350256906L2C006R02500509803	chr1	1101629	50M	127	1101756	1101630	1101757	V350256906L2C006R02500509803_chr1_1101629	55	35	GCTG	CCGC
V350256906L2C006R02500590538	chr1	557549	50M	176	557725	557550	557726	V350256906L2C006R02500590538_chr1_557549	90	56	CTAA	CTGA
V350256906L2C006R02500959104	chr1	1027809	50M	170	1027979	1027810	1027980	V350256906L2C006R02500959104_chr1_1027809	14	184	CCTC	CACA
V350256906L2C006R02600118179	chr1	237539	50M	160	237699	237540	237700	V350256906L2C006R02600118179_chr1_237539	71	62	aaaa	ATCT
V350256906L2C006R02601125199	chr1	719144	50M	173	719317	719145	719318	V350256906L2C006R02601125199_chr1_719144	0	136	tata	CAAA
V350256906L2C006R02601151031	chr1	47340	50M	194	47534	47341	47535	V350256906L2C006R02601151031_chr1_47340	23	137	GAAG	GGAA
V350256906L2C006R02700006801	chr1	254713	50M	176	254889	254714	254890	V350256906L2C006R02700006801_chr1_254713	112	12	tctc	ccat
V350256906L2C006R02700522709	chr1	759221	50M	174	759395	759222	759396	V350256906L2C006R02700522709_chr1_759221	30	36	TAGT	GACA
V350256906L2C006R02700721013	chr1	578082	50M	182	578264	578083	578265	V350256906L2C006R02700721013_chr1_578082	261	79	CCCT	CCCC
V350256906L2C006R02700755657	chr1	1217158	50M	171	1217329	1217159	1217330	V350256906L2C006R02700755657_chr1_1217158	55	2	CCGG	AGGT
V350256906L2C006R02701210459	chr1	1356971	50M	170	1357141	1356972	1357142	V350256906L2C006R02701210459_chr1_1356971	47	42	TCCA	TGGT
V350256906L2C006R02701242549	chr1	851042	50M	143	851185	851043	851186	V350256906L2C006R02701242549_chr1_851042	0	13	CCAG	gccc
V350256906L2C006R02800118107	chr1	828129	50M	185	828314	828130	828315	V350256906L2C006R02800118107_chr1_828129	41	42	acaa	AGAG
V350256906L2C006R02800368101	chr1	725918	2S39M9S	153	726071	725919	726072	V350256906L2C006R02800368101_chr1_725918	0	146	aatg	attc
V350256906L2C006R02800806846	chr1	1281581	50M	156	1281737	1281582	1281738	V350256906L2C006R02800806846_chr1_1281581	17	61	AGGA	TGTC
V350256906L2C006R02801120169	chr1	1097907	50M	148	1098055	1097908	1098056	V350256906L2C006R02801120169_chr1_1097907	32	44	GCCC	GCCG
V350256906L2C006R02801317786	chr1	418228	50M	176	418404	418229	418405	V350256906L2C006R02801317786_chr1_418228	37	43	CCCA	ggag
V350256906L2C006R02900353561	chr1	1431703	50M	179	1431882	1431704	1431883	V350256906L2C006R02900353561_chr1_1431703	35	95	CAGA	CTGG
V350256906L2C006R02900484324	chr1	459331	50M	174	459505	459332	459506	V350256906L2C006R02900484324_chr1_459331	149	58	CCCA	AGAA
V350256906L2C006R02900773554	chr1	804750	50M	135	804885	804751	804886	V350256906L2C006R02900773554_chr1_804750	35	57	TGGG	gata
V350256906L2C006R02901067145	chr1	1339971	50M	176	1340147	1339972	1340148	V350256906L2C006R02901067145_chr1_1339971	30	31	ccca	aaca
V350256906L2C006R02901211480	chr1	706817	50M	144	706961	706818	706962	V350256906L2C006R02901211480_chr1_706817	54	74	caac	caag
V350256906L2C006R03000118914	chr1	765475	50M	163	765638	765476	765639	V350256906L2C006R03000118914_chr1_765475	77	39	cata	ctca
V350256906L2C006R03000814712	chr1	137850	50M	159	138009	137851	138010	V350256906L2C006R03000814712_chr1_137850	44	60	CCAA	GGCC
V350256906L2C006R03001107105	chr1	17241	50M	170	17411	17242	17412	V350256906L2C006R03001107105_chr1_17241	12	34	CCAG	CAGC
V350256906L2C006R03100564014	chr1	440249	50M	196	440445	440250	440446	V350256906L2C006R03100564014_chr1_440249	64	54	cctc	CACG
V350256906L2C006R03100670970	chr1	1165751	50M	153	1165904	1165752	1165905	V350256906L2C006R03100670970_chr1_1165751	45	71	CCTG	gcac
V350256906L2C006R03100967631	chr1	1348914	50M	160	1349074	1348915	1349075	V350256906L2C006R03100967631_chr1_1348914	66	48	gctc	ataa
V350256906L2C006R03100985243	chr1	1058925	50M	143	1059068	1058926	1059069	V350256906L2C006R03100985243_chr1_1058925	44	0	ctcc	gtgc
V350256906L2C006R03200183482	chr1	1136013	50M	162	1136175	1136014	1136176	V350256906L2C006R03200183482_chr1_1136013	56	162	TGCT	CCCC
V350256906L2C006R03200774083	chr1	685964	50M	189	686153	685965	686154	V350256906L2C006R03200774083_chr1_685964	26	28	cccc	ataa
V350256906L2C006R03200912426	chr1	669500	50M	170	669670	669501	669671	V350256906L2C006R03200912426_chr1_669500	42	212	ggag	tgcc
V350256906L2C006R03200914145	chr1	433350	50M	186	433536	433351	433537	V350256906L2C006R03200914145_chr1_433350	7	87	CCCT	CTTT
V350256906L2C006R03201106835	chr1	751788	50M	168	751956	751789	751957	V350256906L2C006R03201106835_chr1_751788	29	48	gata	TATT
V350256906L2C006R03300110182	chr1	1166355	50M	165	1166520	1166356	1166521	V350256906L2C006R03300110182_chr1_1166355	0	0	CATA	CTGA
V350256906L2C006R03300135174	chr1	11914	50M	270	12184	11915	12185	V350256906L2C006R03300135174_chr1_11914	0	61	TGTG	TCCA
V350256906L2C006R03300602488	chr1	998360	50M	166	998526	998361	998527	V350256906L2C006R03300602488_chr1_998360	0	0	CTCA	CCCA
V350256906L2C006R03300656739	chr1	1299062	50M	182	1299244	1299063	1299245	V350256906L2C006R03300656739_chr1_1299062	51	54	gctc	tggg
V350256906L2C006R03300715432	chr1	162893	50M	201	163094	162894	163095	V350256906L2C006R03300715432_chr1_162893	48	0	CGCA	CATA
V350256906L2C006R03400155542	chr1	957968	28S22M	116	958084	957969	958085	V350256906L2C006R03400155542_chr1_957968	54	0	TGTG	TGTT
V350256906L2C006R03400293240	chr1	686171	50M	176	686347	686172	686348	V350256906L2C006R03400293240_chr1_686171	10	27	ttta	CCCA
V350256906L2C006R03400700496	chr1	25424	50M	231	25655	25425	25656	V350256906L2C006R03400700496_chr1_25424	213	84	CCTG	AGTG
V350256906L2C006R03400931025	chr1	828613	50M	183	828796	828614	828797	V350256906L2C006R03400931025_chr1_828613	0	0	caaa	ccta
V350256906L2C006R03400937465	chr1	92648	50M	160	92808	92649	92809	V350256906L2C006R03400937465_chr1_92648	11	0	cctc	CACA
V350256906L2C006R03400991863	chr1	1149342	50M	143	1149485	1149343	1149486	V350256906L2C006R03400991863_chr1_1149342	45	44	CGAC	GGGC
V350256906L2C006R03401277106	chr1	1122971	50M	161	1123132	1122972	1123133	V350256906L2C006R03401277106_chr1_1122971	180	19	ctgc	tgta
V350256906L2C006R03500249753	chr1	74202	50M	185	74387	74203	74388	V350256906L2C006R03500249753_chr1_74202	3	188	tcca	ccat
V350256906L2C006R03500471517	chr1	945372	50M	178	945550	945373	945551	V350256906L2C006R03500471517_chr1_945372	93	74	ccag	ggag
V350256906L2C006R03500572486	chr1	910007	50M	143	910150	910008	910151	V350256906L2C006R03500572486_chr1_910007	39	12	CCTG	CCTC
V350256906L2C006R03500607333	chr1	115518	50M	143	115661	115519	115662	V350256906L2C006R03500607333_chr1_115518	1	85	CTTT	acaa
V350256906L2C006R03500679825	chr1	1029888	50M	135	1030023	1029889	1030024	V350256906L2C006R03500679825_chr1_1029888	0	47	ctcc	ggat
V350256906L2C006R03500680941	chr1	254623	50M	138	254761	254624	254762	V350256906L2C006R03500680941_chr1_254623	22	140	cata	cttg
V350256906L2C006R03500870356	chr1	681732	50M	188	681920	681733	681921	V350256906L2C006R03500870356_chr1_681732	15	21	CTCA	ccAc
V350256906L2C006R03501296114	chr1	1017383	50M	145	1017528	1017384	1017529	V350256906L2C006R03501296114_chr1_1017383	0	22	CGTC	ACCC
V350256906L2C006R03600029298	chr1	589892	50M	168	590060	589893	590061	V350256906L2C006R03600029298_chr1_589892	54	69	gaaa	ttat
V350256906L2C006R03600064288	chr1	697395	50M	182	697577	697396	697578	V350256906L2C006R03600064288_chr1_697395	50	57	ttca	ccag
V350256906L2C006R03600253795	chr1	463840	50M	179	464019	463841	464020	V350256906L2C006R03600253795_chr1_463840	101	0	tcac	CAAT
V350256906L2C006R03600254526	chr1	681415	50M	181	681596	681416	681597	V350256906L2C006R03600254526_chr1_681415	64	61	acac	CACC
V350256906L2C006R03600276955	chr1	980553	50M	177	980730	980554	980731	V350256906L2C006R03600276955_chr1_980553	27	50	CCCC	CAGG
V350256906L2C006R03600739838	chr1	153842	50M	201	154043	153843	154044	V350256906L2C006R03600739838_chr1_153842	23	52	ccta	gcaa
V350256906L2C006R03600760673	chr1	344062	50M	120	344182	344063	344183	V350256906L2C006R03600760673_chr1_344062	110	96	TGCA	GGAA
V350256906L2C006R03800711662	chr1	786539	50M	172	786711	786540	786712	V350256906L2C006R03800711662_chr1_786539	165	0	ccca	CCAA
V350256906L2C006R03800777161	chr1	160543	50M	153	160696	160544	160697	V350256906L2C006R03800777161_chr1_160543	214	61	TCCT	TGTA
V350256906L2C006R03800869392	chr1	462319	50M	167	462486	462320	462487	V350256906L2C006R03800869392_chr1_462319	216	184	ggct	CACT
V350256906L2C006R03800938404	chr1	773683	50M	166	773849	773684	773850	V350256906L2C006R03800938404_chr1_773683	0	4	acaa	catc
V350256906L2C006R03801263790	chr1	1430598	50M	177	1430775	1430599	1430776	V350256906L2C006R03801263790_chr1_1430598	39	28	GTGG	CCAG
V350256906L2C006R03900297962	chr1	1188962	50M	159	1189121	1188963	1189122	V350256906L2C006R03900297962_chr1_1188962	0	19	cccg	TCTG
V350256906L2C006R03900320135	chr1	1186344	50M	180	1186524	1186345	1186525	V350256906L2C006R03900320135_chr1_1186344	46	30	TGCC	GGTG
V350256906L2C006R03900423277	chr1	1053376	50M	271	1053647	1053377	1053648	V350256906L2C006R03900423277_chr1_1053376	64	0	gtgc	TGCC
V350256906L2C006R03900423553	chr1	1036422	50M	177	1036599	1036423	1036600	V350256906L2C006R03900423553_chr1_1036422	35	129	tttc	agct
V350256906L2C006R03901000348	chr1	857082	50M	172	857254	857083	857255	V350256906L2C006R03901000348_chr1_857082	49	50	ACAG	CCTG
V350256906L2C006R03901245476	chr1	38065	50M	166	38231	38066	38232	V350256906L2C006R03901245476_chr1_38065	56	71	cgtg	GGGC
V350256906L2C006R03901347341	chr1	740813	50M	145	740958	740814	740959	V350256906L2C006R03901347341_chr1_740813	180	175	AGCA	AAAC
V350256906L2C006R04000585662	chr1	786238	50M	173	786411	786239	786412	V350256906L2C006R04000585662_chr1_786238	25	198	catt	agaa
V350256906L2C006R04000585711	chr1	765242	50M	146	765388	765243	765389	V350256906L2C006R04000585711_chr1_765242	171	164	cctc	ccta
V350256906L2C006R04000929934	chr1	244145	50M	191	244336	244146	244337	V350256906L2C006R04000929934_chr1_244145	63	62	cctt	TCAC
V350256906L2C006R04001083870	chr1	623421	50M	191	623612	623422	623613	V350256906L2C006R04001083870_chr1_623421	296	366	GCTG	GAGG
V350256906L2C006R04001339892	chr1	950628	50M	154	950782	950629	950783	V350256906L2C006R04001339892_chr1_950628	76	50	CACC	TGCA
V350256906L2C006R04100032011	chr1	726825	20S30M	171	726996	726826	726997	V350256906L2C006R04100032011_chr1_726825	0	0	gaat	ccat
V350256906L2C006R04100245459	chr1	678204	50M	181	678385	678205	678386	V350256906L2C006R04100245459_chr1_678204	37	31	aatt	GGTG
V350256906L2C006R04100257785	chr1	258504	50M	168	258672	258505	258673	V350256906L2C006R04100257785_chr1_258504	0	39	ccag	aggg
V350256906L2C006R04100566742	chr1	827968	50M	143	828111	827969	828112	V350256906L2C006R04100566742_chr1_827968	70	23	tctt	taca
V350256906L2C006R04100631795	chr1	1235208	50M	168	1235376	1235209	1235377	V350256906L2C006R04100631795_chr1_1235208	1	30	CACC	ACAT
V350256906L2C006R04100822291	chr1	140109	50M	164	140273	140110	140274	V350256906L2C006R04100822291_chr1_140109	0	157	cagg	GGTG
V350256906L2C006R04100893589	chr1	1351159	50M	177	1351336	1351160	1351337	V350256906L2C006R04100893589_chr1_1351159	91	75	caag	cgct
V350256906L2C006R04100977755	chr1	897333	50M	154	897487	897334	897488	V350256906L2C006R04100977755_chr1_897333	29	4	GCAG	AAGA
V350256906L2C006R04101140075	chr1	1318708	50M	211	1318919	1318709	1318920	V350256906L2C006R04101140075_chr1_1318708	23	7	agac	ggta
V350256906L2C006R04200287127	chr1	535958	50M	167	536125	535959	536126	V350256906L2C006R04200287127_chr1_535958	110	200	CGAT	taca
V350256906L2C006R04200602732	chr1	1292741	50M	189	1292930	1292742	1292931	V350256906L2C006R04200602732_chr1_1292741	0	184	caga	cagg
V350256906L2C006R04201210472	chr1	1360720	50M	155	1360875	1360721	1360876	V350256906L2C006R04201210472_chr1_1360720	91	100	cctg	CCTG
V350256906L2C006R04300030237	chr1	802365	50M	167	802532	802366	802533	V350256906L2C006R04300030237_chr1_802365	69	52	TGAC	GAGA
V350256906L2C006R04300122600	chr1	133263	50M	172	133435	133264	133436	V350256906L2C006R04300122600_chr1_133263	53	66	CACT	CGTG
V350256906L2C006R04300831747	chr1	826608	50M	184	826792	826609	826793	V350256906L2C006R04300831747_chr1_826608	42	33	CAGG	tatt
V350256906L2C006R04300938748	chr1	1425991	50M	173	1426164	1425992	1426165	V350256906L2C006R04300938748_chr1_1425991	0	0	CGCT	CCCT
V350256906L2C006R04301208868	chr1	1031733	50M	161	1031894	1031734	1031895	V350256906L2C006R04301208868_chr1_1031733	18	85	acac	caca
V350256906L2C006R04400387952	chr1	1030972	50M	174	1031146	1030973	1031147	V350256906L2C006R04400387952_chr1_1030972	12	24	ataa	tgag
V350256906L2C006R04400401162	chr1	453210	50M	164	453374	453211	453375	V350256906L2C006R04400401162_chr1_453210	97	43	ccaa	tgta
V350256906L2C006R04400770740	chr1	347118	50M	177	347295	347119	347296	V350256906L2C006R04400770740_chr1_347118	57	61	GGTT	ataa
V350256906L2C006R04401000646	chr1	1120879	50M	162	1121041	1120880	1121042	V350256906L2C006R04401000646_chr1_1120879	11	38	GCCC	GCCC
V350256906L2C006R04401036702	chr1	653202	50M	192	653394	653203	653395	V350256906L2C006R04401036702_chr1_653202	227	35	aatg	GGAA
V350256906L2C006R04401211441	chr1	772322	50M	174	772496	772323	772497	V350256906L2C006R04401211441_chr1_772322	140	8	CGTC	ctga
V350256906L2C006R04401380729	chr1	816153	50M	153	816306	816154	816307	V350256906L2C006R04401380729_chr1_816153	58	52	ccag	aaaa
V350256906L2C006R04500043638	chr1	463737	50M	182	463919	463738	463920	V350256906L2C006R04500043638_chr1_463737	204	22	ctta	ACTC
V350256906L2C006R04500192599	chr1	626309	50M	170	626479	626310	626480	V350256906L2C006R04500192599_chr1_626309	0	0	agat	ATTT
V350256906L2C006R04500335541	chr1	1367370	50M	175	1367545	1367371	1367546	V350256906L2C006R04500335541_chr1_1367370	125	12	CCCC	CCCA
V350256906L2C006R04500342566	chr1	727370	50M	162	727532	727371	727533	V350256906L2C006R04500342566_chr1_727370	37	73	ctaa	GCTA
V350256906L2C006R04500745505	chr1	136933	50M	155	137088	136934	137089	V350256906L2C006R04500745505_chr1_136933	227	72	GGCA	CCCC
V350256906L2C006R04500777013	chr1	717684	50M	179	717863	717685	717864	V350256906L2C006R04500777013_chr1_717684	58	59	CCTG	ctac
V350256906L2C006R04500872064	chr1	734568	50M	163	734731	734569	734732	V350256906L2C006R04500872064_chr1_734568	15	29	GTTT	TAAT
V350256906L2C006R04501216507	chr1	14923	50M	160	15083	14924	15084	V350256906L2C006R04501216507_chr1_14923	251	91	GAAT	TGTG
V350256906L2C006R04501338899	chr1	1159750	50M	182	1159932	1159751	1159933	V350256906L2C006R04501338899_chr1_1159750	96	20	cccg	tcct
V350256906L2C006R04501402121	chr1	1156287	50M	160	1156447	1156288	1156448	V350256906L2C006R04501402121_chr1_1156287	42	23	ACGA	ccca
V350256906L2C006R04600217184	chr1	576893	50M	175	577068	576894	577069	V350256906L2C006R04600217184_chr1_576893	14	6	ACAT	AACA
V350256906L2C006R04600322109	chr1	574629	50M	172	574801	574630	574802	V350256906L2C006R04600322109_chr1_574629	0	20	AAAT	aaga
V350256906L2C006R04600375665	chr1	659465	50M	158	659623	659466	659624	V350256906L2C006R04600375665_chr1_659465	53	36	TGTG	GGAA
V350256906L2C006R04600571386	chr1	55872	50M	174	56046	55873	56047	V350256906L2C006R04600571386_chr1_55872	46	73	CTAA	ATTG
V350256906L2C006R04600602815	chr1	654079	50M	203	654282	654080	654283	V350256906L2C006R04600602815_chr1_654079	13	216	ATGT	caaa
V350256906L2C006R04600629971	chr1	725592	50M	249	725841	725593	725842	V350256906L2C006R04600629971_chr1_725592	76	42	gaat	attc
V350256906L2C006R04600722687	chr1	1324893	50M	199	1325092	1324894	1325093	V350256906L2C006R04600722687_chr1_1324893	67	62	CCTG	ctgg
V350256906L2C006R04601053497	chr1	710058	50M	169	710227	710059	710228	V350256906L2C006R04601053497_chr1_710058	32	23	CTTA	cctg
V350256906L2C006R04700403069	chr1	1354322	50M	169	1354491	1354323	1354492	V350256906L2C006R04700403069_chr1_1354322	64	54	CCAG	CCAC
V350256906L2C006R04700790736	chr1	69271	50M	154	69425	69272	69426	V350256906L2C006R04700790736_chr1_69271	34	43	CTCA	CCAT
V350256906L2C006R04700913416	chr1	1138058	50M	175	1138233	1138059	1138234	V350256906L2C006R04700913416_chr1_1138058	62	81	ccca	CCCG
V350256906L2C006R04701017964	chr1	242638	50M	161	242799	242639	242800	V350256906L2C006R04701017964_chr1_242638	37	9	GCCT	AGAA
V350256906L2C006R04701148471	chr1	1139840	50M	141	1139981	1139841	1139982	V350256906L2C006R04701148471_chr1_1139840	44	49	TACA	TTCT
V350256906L2C006R04701202445	chr1	735822	50M	170	735992	735823	735993	V350256906L2C006R04701202445_chr1_735822	121	5	cacg	catc
V350256906L2C006R04800121912	chr1	1035118	50M	151	1035269	1035119	1035270	V350256906L2C006R04800121912_chr1_1035118	47	10	ttgt	cata
V350256906L2C006R04800156119	chr1	595410	50M	183	595593	595411	595594	V350256906L2C006R04800156119_chr1_595410	246	129	ggag	ggca
V350256906L2C006R04800186372	chr1	1038805	50M	177	1038982	1038806	1038983	V350256906L2C006R04800186372_chr1_1038805	3	43	tgaa	cgct
V350256906L2C006R04800345236	chr1	671096	50M	190	671286	671097	671287	V350256906L2C006R04800345236_chr1_671096	39	115	TGAT	CATC
V350256906L2C006R04800683064	chr1	689710	50M	189	689899	689711	689900	V350256906L2C006R04800683064_chr1_689710	85	78	gtga	ccat
V350256906L2C006R04800864461	chr1	1317814	50M	162	1317976	1317815	1317977	V350256906L2C006R04800864461_chr1_1317814	244	255	ACCC	GGGA
V350256906L2C006R04800952236	chr1	54896	50M	163	55059	54897	55060	V350256906L2C006R04800952236_chr1_54896	273	273	ccca	gtag
V350256906L2C006R04900088326	chr1	457430	50M	142	457572	457431	457573	V350256906L2C006R04900088326_chr1_457430	20	0	tatt	ggtg
V350256906L2C006R04900123451	chr1	46869	50M	183	47052	46870	47053	V350256906L2C006R04900123451_chr1_46869	255	72	CCAA	taaa
V350256906L2C006R04900787466	chr1	987384	50M	191	987575	987385	987576	V350256906L2C006R04900787466_chr1_987384	70	36	ATGA	GGGA
V350256906L2C006R04900993680	chr1	1097285	50M	192	1097477	1097286	1097478	V350256906L2C006R04900993680_chr1_1097285	66	64	GCTG	CCTG
V350256906L2C006R05000212972	chr1	709185	50M	175	709360	709186	709361	V350256906L2C006R05000212972_chr1_709185	50	61	TAAA	ACCA
V350256906L2C006R05000277171	chr1	1146096	50M	161	1146257	1146097	1146258	V350256906L2C006R05000277171_chr1_1146096	63	56	CCTC	CCTG
V350256906L2C006R05000347436	chr1	88204	50M	190	88394	88205	88395	V350256906L2C006R05000347436_chr1_88204	20	18	cgct	cctt
V350256906L2C006R05000403154	chr1	925052	50M	168	925220	925053	925221	V350256906L2C006R05000403154_chr1_925052	41	101	agag	aagc
V350256906L2C006R05000529681	chr1	810463	50M	162	810625	810464	810626	V350256906L2C006R05000529681_chr1_810463	0	13	TAGA	GGGC
V350256906L2C006R05000949751	chr1	716965	22M3D28M	201	717166	716966	717167	V350256906L2C006R05000949751_chr1_716965	72	48	TATT	TCTT
V350256906L2C006R05001136730	chr1	612625	50M	144	612769	612626	612770	V350256906L2C006R05001136730_chr1_612625	60	60	tcca	ctct
V350256906L2C006R05101002694	chr1	1194025	50M	155	1194180	1194026	1194181	V350256906L2C006R05101002694_chr1_1194025	0	30	CAGC	agcc
V350256906L2C006R05101251098	chr1	722234	50M	181	722415	722235	722416	V350256906L2C006R05101251098_chr1_722234	74	48	gctc	tatg
V350256906L2C006R05200483252	chr1	824395	50M	183	824578	824396	824579	V350256906L2C006R05200483252_chr1_824395	0	28	gaca	ggct
V350256906L2C006R05200504271	chr1	838469	50M	188	838657	838470	838658	V350256906L2C006R05200504271_chr1_838469	2	0	cctt	TGtg
V350256906L2C006R05200521772	chr1	1130403	50M	171	1130574	1130404	1130575	V350256906L2C006R05200521772_chr1_1130403	66	84	ctgt	catt
V350256906L2C006R05200526782	chr1	1042021	50M	173	1042194	1042022	1042195	V350256906L2C006R05200526782_chr1_1042021	31	23	ctca	gccc
V350256906L2C006R05200544098	chr1	789347	50M	168	789515	789348	789516	V350256906L2C006R05200544098_chr1_789347	235	124	GGTG	TCTA
V350256906L2C006R05200634133	chr1	62558	50M	174	62732	62559	62733	V350256906L2C006R05200634133_chr1_62558	0	145	TAAA	TAAA
V350256906L2C006R05201065138	chr1	1064415	50M	177	1064592	1064416	1064593	V350256906L2C006R05201065138_chr1_1064415	72	67	GCCG	CCCA
V350256906L2C006R05201160073	chr1	58107	50M	176	58283	58108	58284	V350256906L2C006R05201160073_chr1_58107	0	75	CTTC	CTGG
V350256906L2C006R05201248975	chr1	71791	50M	191	71982	71792	71983	V350256906L2C006R05201248975_chr1_71791	54	59	atag	TACT
V350256906L2C006R05201372264	chr1	833339	50M	143	833482	833340	833483	V350256906L2C006R05201372264_chr1_833339	57	47	ttct	aaag
V350256906L2C006R05300028436	chr1	831551	50M	177	831728	831552	831729	V350256906L2C006R05300028436_chr1_831551	12	116	ctca	atta
V350256906L2C006R05300192450	chr1	765180	50M	175	765355	765181	765356	V350256906L2C006R05300192450_chr1_765180	109	197	gaat	caaa
V350256906L2C006R05400088263	chr1	803398	50M	174	803572	803399	803573	V350256906L2C006R05400088263_chr1_803398	44	35	AGAA	GTTT
V350256906L2C006R05400278110	chr1	802545	50M	145	802690	802546	802691	V350256906L2C006R05400278110_chr1_802545	65	0	CCTG	TGAA
V350256906L2C006R05400291864	chr1	736226	50M	187	736413	736227	736414	V350256906L2C006R05400291864_chr1_736226	32	219	ctat	GCTG
V350256906L2C006R05400626635	chr1	801688	50M	203	801891	801689	801892	V350256906L2C006R05400626635_chr1_801688	4	10	tgtg	CATA
V350256906L2C006R05400940935	chr1	1343988	50M	158	1344146	1343989	1344147	V350256906L2C006R05400940935_chr1_1343988	255	194	tgct	agaA
V350256906L2C006R05400973683	chr1	1205015	50M	168	1205183	1205016	1205184	V350256906L2C006R05400973683_chr1_1205015	12	0	tgta	CCAC
V350256906L2C006R05401174093	chr1	428262	50M	214	428476	428263	428477	V350256906L2C006R05401174093_chr1_428262	0	34	tggg	cctg
V350256906L2C006R05500070728	chr1	1141554	50M	176	1141730	1141555	1141731	V350256906L2C006R05500070728_chr1_1141554	69	60	CCGG	AAGG
V350256906L2C006R05500331289	chr1	1106648	50M	188	1106836	1106649	1106837	V350256906L2C006R05500331289_chr1_1106648	37	38	CAAG	CCTG
V350256906L2C006R05500417558	chr1	992611	50M	152	992763	992612	992764	V350256906L2C006R05500417558_chr1_992611	42	52	cagg	CACA
V350256906L2C006R05500596751	chr1	1308916	50M	177	1309093	1308917	1309094	V350256906L2C006R05500596751_chr1_1308916	50	63	GCAC	CCAT
V350256906L2C006R05500612164	chr1	161727	50M	169	161896	161728	161897	V350256906L2C006R05500612164_chr1_161727	44	125	atct	ATAT
V350256906L2C006R05500631196	chr1	633727	50M	171	633898	633728	633899	V350256906L2C006R05500631196_chr1_633727	161	332	ccag	catg
V350256906L2C006R05500733572	chr1	1160947	50M	166	1161113	1160948	1161114	V350256906L2C006R05500733572_chr1_1160947	64	15	CCAC	cgtg
V350256906L2C006R05500768420	chr1	587657	50M	165	587822	587658	587823	V350256906L2C006R05500768420_chr1_587657	60	42	ccaa	ccag
V350256906L2C006R05500776053	chr1	1148618	50M	178	1148796	1148619	1148797	V350256906L2C006R05500776053_chr1_1148618	99	54	CCCC	CTGG
V350256906L2C006R05501038637	chr1	1404205	50M	230	1404435	1404206	1404436	V350256906L2C006R05501038637_chr1_1404205	47	62	CGTG	cccg
V350256906L2C006R05501081575	chr1	587775	50M	140	587915	587776	587916	V350256906L2C006R05501081575_chr1_587775	0	15	ctaa	cctt
V350256906L2C006R05501083569	chr1	1354227	50M	237	1354464	1354228	1354465	V350256906L2C006R05501083569_chr1_1354227	0	27	ccct	CAGG
V350256906L2C006R05501154862	chr1	74276	50M	176	74452	74277	74453	V350256906L2C006R05501154862_chr1_74276	77	253	tgct	gtaa
V350256906L2C006R05600505901	chr1	1190026	50M	174	1190200	1190027	1190201	V350256906L2C006R05600505901_chr1_1190026	75	43	GTAA	CGGA
V350256906L2C006R05600725700	chr1	1032112	50M	174	1032286	1032113	1032287	V350256906L2C006R05600725700_chr1_1032112	53	76	ccta	caaa
V350256906L2C006R05601108044	chr1	908011	50M	152	908163	908012	908164	V350256906L2C006R05601108044_chr1_908011	20	7	ggcg	CCCC
V350256906L2C006R05700486840	chr1	1251814	50M	202	1252016	1251815	1252017	V350256906L2C006R05700486840_chr1_1251814	100	78	caaa	AATG
V350256906L2C006R05700669400	chr1	1082697	50M	178	1082875	1082698	1082876	V350256906L2C006R05700669400_chr1_1082697	70	65	GGGG	GCTG
V350256906L2C006R05700925278	chr1	255999	50M	196	256195	256000	256196	V350256906L2C006R05700925278_chr1_255999	70	56	CACA	ggca
V350256906L2C006R05701293612	chr1	1067953	50M	169	1068122	1067954	1068123	V350256906L2C006R05701293612_chr1_1067953	55	62	CAAT	ccct
V350256906L2C006R05800164269	chr1	148533	50M	179	148712	148534	148713	V350256906L2C006R05800164269_chr1_148533	33	6	aggc	agta
V350256906L2C006R05800508449	chr1	450899	50M	190	451089	450900	451090	V350256906L2C006R05800508449_chr1_450899	133	42	cggg	acct
V350256906L2C006R05800513473	chr1	14819	50M	177	14996	14820	14997	V350256906L2C006R05800513473_chr1_14819	226	178	CCCA	CAAC
V350256906L2C006R05800561140	chr1	835779	50M	247	836026	835780	836027	V350256906L2C006R05800561140_chr1_835779	240	0	agtg	tttt
V350256906L2C006R05800629991	chr1	376082	50M	185	376267	376083	376268	V350256906L2C006R05800629991_chr1_376082	72	61	tgtt	gaag
V350256906L2C006R05801261278	chr1	808998	50M	201	809199	808999	809200	V350256906L2C006R05801261278_chr1_808998	114	56	ATAG	GGGC
V350256906L2C006R05900020873	chr1	725405	19M31S	190	725595	725406	725596	V350256906L2C006R05900020873_chr1_725405	68	79	tgaa	ttcc
V350256906L2C006R05900814092	chr1	649049	50M	193	649242	649050	649243	V350256906L2C006R05900814092_chr1_649049	156	0	CATG	CTAA
V350256906L2C006R05900843147	chr1	521518	50M	153	521671	521519	521672	V350256906L2C006R05900843147_chr1_521518	285	132	CCTC	GAAA
V350256906L2C006R05900920823	chr1	1083277	50M	180	1083457	1083278	1083458	V350256906L2C006R05900920823_chr1_1083277	63	57	aaca	ctga
V350256906L2C006R06000017159	chr1	1369992	50M	171	1370163	1369993	1370164	V350256906L2C006R06000017159_chr1_1369992	42	53	GCCC	CCCT
V350256906L2C006R06000085527	chr1	134714	50M	180	134894	134715	134895	V350256906L2C006R06000085527_chr1_134714	27	48	CTTT	TTGG
V350256906L2C006R06000136242	chr1	1395677	50M	163	1395840	1395678	1395841	V350256906L2C006R06000136242_chr1_1395677	0	7	tgtt	CCCT
V350256906L2C006R06000795509	chr1	1130576	50M	169	1130745	1130577	1130746	V350256906L2C006R06000795509_chr1_1130576	86	11	ggcc	caac
V350256906L2C006R06000806842	chr1	462149	13M1D37M	206	462355	462150	462356	V350256906L2C006R06000806842_chr1_462149	46	252	CCAA	aacc
V350256906L2C006R06001198013	chr1	1333380	50M	162	1333542	1333381	1333543	V350256906L2C006R06001198013_chr1_1333380	2	0	CCAG	GCTT
V350256906L2C006R06001360931	chr1	99756	50M	198	99954	99757	99955	V350256906L2C006R06001360931_chr1_99756	1	3	ggga	tgat
V350256906L2C006R06001361385	chr1	169156	50M	160	169316	169157	169317	V350256906L2C006R06001361385_chr1_169156	18	119	ggcc	aatt
V350256906L2C006R06100063720	chr1	40706	50M	154	40860	40707	40861	V350256906L2C006R06100063720_chr1_40706	223	69	ggct	gtgg
V350256906L2C006R06100842340	chr1	826655	50M	205	826860	826656	826861	V350256906L2C006R06100842340_chr1_826655	0	0	Taac	taaa
V350256906L2C006R06101392042	chr1	244741	50M	180	244921	244742	244922	V350256906L2C006R06101392042_chr1_244741	151	331	CCTC	GAAC
V350256906L2C006R06200048839	chr1	944799	50M	178	944977	944800	944978	V350256906L2C006R06200048839_chr1_944799	54	61	cgcc	caat
V350256906L2C006R06200199276	chr1	467854	50M	178	468032	467855	468033	V350256906L2C006R06200199276_chr1_467854	173	32	taca	ggat
V350256906L2C006R06200429553	chr1	25094	50M	162	25256	25095	25257	V350256906L2C006R06200429553_chr1_25094	74	45	AATG	TCTT
V350256906L2C006R06201064557	chr1	1109397	50M	194	1109591	1109398	1109592	V350256906L2C006R06201064557_chr1_1109397	19	6	CAGG	CCCA
V350256906L2C006R06300102700	chr1	739689	50M	158	739847	739690	739848	V350256906L2C006R06300102700_chr1_739689	33	15	caga	tcag
V350256906L2C006R06300522609	chr1	344441	50M	177	344618	344442	344619	V350256906L2C006R06300522609_chr1_344441	142	249	catt	tgca
V350256906L2C006R06300683035	chr1	138163	50M	174	138337	138164	138338	V350256906L2C006R06300683035_chr1_138163	19	25	GGCA	CAGC
V350256906L2C006R06301045029	chr1	1131085	50M	207	1131292	1131086	1131293	V350256906L2C006R06301045029_chr1_1131085	10	217	tctc	ccag
V350256906L2C006R06301090019	chr1	89244	50M	182	89426	89245	89427	V350256906L2C006R06301090019_chr1_89244	30	18	TACT	ATGA
V350256906L2C006R06301375254	chr1	1003029	50M	173	1003202	1003030	1003203	V350256906L2C006R06301375254_chr1_1003029	61	52	GGTA	CCCC
V350256906L2C006R06400148917	chr1	22539	50M	156	22695	22540	22696	V350256906L2C006R06400148917_chr1_22539	60	40	ACAT	CTCC
V350256906L2C006R06400298875	chr1	737764	50M	160	737924	737765	737925	V350256906L2C006R06400298875_chr1_737764	0	146	CCAG	actg
V350256906L2C006R06400537051	chr1	368821	50M	161	368982	368822	368983	V350256906L2C006R06400537051_chr1_368821	49	70	agca	gtca
V350256906L2C006R06400645297	chr1	803993	50M	180	804173	803994	804174	V350256906L2C006R06400645297_chr1_803993	52	71	TGCT	TGAT
V350256906L2C006R06400699762	chr1	1101328	50M	154	1101482	1101329	1101483	V350256906L2C006R06400699762_chr1_1101328	24	178	CTGG	CAGA
V350256906L2C006R06400908613	chr1	725849	18S30M2S	154	726003	725850	726004	V350256906L2C006R06400908613_chr1_725849	34	78	atgg	ccat
V350256906L2C006R06401119712	chr1	337123	50M	193	337316	337124	337317	V350256906L2C006R06401119712_chr1_337123	0	0	tttt	tgta
V350256906L2C006R06401126388	chr1	918554	50M	186	918740	918555	918741	V350256906L2C006R06401126388_chr1_918554	69	50	tcct	ctac
V350256906L2C006R06401224871	chr1	131444	50M	193	131637	131445	131638	V350256906L2C006R06401224871_chr1_131444	0	0	CTCA	TCTC
V350256906L2C006R06401287818	chr1	1072826	50M	163	1072989	1072827	1072990	V350256906L2C006R06401287818_chr1_1072826	21	2	CGCG	tgtg
V350256906L2C006R06401374052	chr1	863710	50M	196	863906	863711	863907	V350256906L2C006R06401374052_chr1_863710	102	52	tgca	CAAC
V350256906L2C006R06500473696	chr1	1161420	50M	183	1161603	1161421	1161604	V350256906L2C006R06500473696_chr1_1161420	63	231	ggtg	cgct
V350256906L2C006R06500502166	chr1	1089847	50M	176	1090023	1089848	1090024	V350256906L2C006R06500502166_chr1_1089847	79	92	ccac	ctaa
V350256906L2C006R06500620936	chr1	108742	50M	185	108927	108743	108928	V350256906L2C006R06500620936_chr1_108742	109	65	CAAG	CAGT
V350256906L2C006R06500717667	chr1	673802	50M	148	673950	673803	673951	V350256906L2C006R06500717667_chr1_673802	92	16	actg	gata
V350256906L2C006R06600648938	chr1	14217	50M	168	14385	14218	14386	V350256906L2C006R06600648938_chr1_14217	59	33	CCTC	AAAG
V350256906L2C006R06600674072	chr1	426525	50M	251	426776	426526	426777	V350256906L2C006R06600674072_chr1_426525	22	0	tgtt	GTTG
V350256906L2C006R06700079416	chr1	1413583	50M	183	1413766	1413584	1413767	V350256906L2C006R06700079416_chr1_1413583	49	58	tcca	GGCT
V350256906L2C006R06700305577	chr1	49959	50M	170	50129	49960	50130	V350256906L2C006R06700305577_chr1_49959	43	85	CCAA	CCTA
V350256906L2C006R06700602388	chr1	995991	50M	215	996206	995992	996207	V350256906L2C006R06700602388_chr1_995991	23	0	ggtg	CCAC
V350256906L2C006R06700820927	chr1	43963	50M	182	44145	43964	44146	V350256906L2C006R06700820927_chr1_43963	0	74	ggaa	gaag
V350256906L2C006R06700850356	chr1	943586	50M	169	943755	943587	943756	V350256906L2C006R06700850356_chr1_943586	0	22	TCTG	aaca
V350256906L2C006R06700983570	chr1	126322	50M	182	126504	126323	126505	V350256906L2C006R06700983570_chr1_126322	98	42	cagc	ctga
V350256906L2C006R06701333960	chr1	1202082	50M	169	1202251	1202083	1202252	V350256906L2C006R06701333960_chr1_1202082	1	49	ctgt	TTTA
V350256906L2C006R06800121292	chr1	450388	50M	158	450546	450389	450547	V350256906L2C006R06800121292_chr1_450388	97	153	CGCA	ACGG
V350256906L2C006R06800196246	chr1	1141962	50M	176	1142138	1141963	1142139	V350256906L2C006R06800196246_chr1_1141962	72	4	CAAG	TCCC
V350256906L2C006R06800283200	chr1	1162121	50M	139	1162260	1162122	1162261	V350256906L2C006R06800283200_chr1_1162121	38	37	CTTG	ACAG
V350256906L2C006R06800546305	chr1	141998	50M	185	142183	141999	142184	V350256906L2C006R06800546305_chr1_141998	149	17	ctag	ccca
V350256906L2C006R06800550794	chr1	42279	50M	174	42453	42280	42454	V350256906L2C006R06800550794_chr1_42279	269	95	ggct	ctta
V350256906L2C006R06800581003	chr1	967858	50M	170	968028	967859	968029	V350256906L2C006R06800581003_chr1_967858	162	0	GGCC	CCAC
V350256906L2C006R06900130818	chr1	95317	50M	169	95486	95318	95487	V350256906L2C006R06900130818_chr1_95317	66	74	TGGT	CCTT
V350256906L2C006R06900236263	chr1	572025	50M	210	572235	572026	572236	V350256906L2C006R06900236263_chr1_572025	2	32	catc	GAAG
V350256906L2C006R06900306618	chr1	579832	50M	225	580057	579833	580058	V350256906L2C006R06900306618_chr1_579832	164	18	CCTG	TTGG
V350256906L2C006R06900811906	chr1	974021	50M	178	974199	974022	974200	V350256906L2C006R06900811906_chr1_974021	2	0	CCAA	TCCA
V350256906L2C006R06900966669	chr1	363537	50M	164	363701	363538	363702	V350256906L2C006R06900966669_chr1_363537	14	39	gctg	ggac
V350256906L2C006R06901035989	chr1	348276	50M	174	348450	348277	348451	V350256906L2C006R06901035989_chr1_348276	23	26	GGTC	GGCT
V350256906L2C006R06901069855	chr1	799133	50M	130	799263	799134	799264	V350256906L2C006R06901069855_chr1_799133	20	6	ATGA	AGCT
V350256906L2C006R07000085624	chr1	928467	50M	184	928651	928468	928652	V350256906L2C006R07000085624_chr1_928467	0	0	CGTC	TGAC
V350256906L2C006R07000484266	chr1	1053609	50M	166	1053775	1053610	1053776	V350256906L2C006R07000484266_chr1_1053609	22	19	CTCT	CAGA
V350256906L2C006R07001254934	chr1	1082508	50M	188	1082696	1082509	1082697	V350256906L2C006R07001254934_chr1_1082508	62	69	ggtg	CCTT
V350256906L2C006R07100073879	chr1	1315699	50M	163	1315862	1315700	1315863	V350256906L2C006R07100073879_chr1_1315699	0	21	cgag	CCCT
V350256906L2C006R07100506047	chr1	788660	50M	153	788813	788661	788814	V350256906L2C006R07100506047_chr1_788660	0	64	aatc	catc
V350256906L2C006R07100841031	chr1	1059170	50M	112	1059282	1059171	1059283	V350256906L2C006R07100841031_chr1_1059170	50	26	acat	tgta
V350256906L2C006R07101107442	chr1	702709	50M	178	702887	702710	702888	V350256906L2C006R07101107442_chr1_702709	4	18	CAAG	TTTC
V350256906L2C006R07101221699	chr1	125718	50M	175	125893	125719	125894	V350256906L2C006R07101221699_chr1_125718	237	62	ACAA	GTAT
V350256906L2C006R07101320544	chr1	725767	40M10S	195	725962	725768	725963	V350256906L2C006R07101320544_chr1_725767	116	37	gaat	gagt
V350256906L2C006R07101383262	chr1	433547	50M	217	433764	433548	433765	V350256906L2C006R07101383262_chr1_433547	98	111	TTTG	AAGC
V350256906L2C006R07101390857	chr1	863313	50M	161	863474	863314	863475	V350256906L2C006R07101390857_chr1_863313	44	21	CCCG	GAGG
V350256906L2C006R07200302279	chr1	435464	50M	170	435634	435465	435635	V350256906L2C006R07200302279_chr1_435464	44	66	TGTT	GTTA
V350256906L2C006R07200435831	chr1	124735	50M	193	124928	124736	124929	V350256906L2C006R07200435831_chr1_124735	220	126	actt	CCCC
V350256906L2C006R07201311658	chr1	556020	50M	196	556216	556021	556217	V350256906L2C006R07201311658_chr1_556020	5	29	atct	tgtg
V350256906L3C001R00100048579	chr1	239229	50M	148	239377	239230	239378	V350256906L3C001R00100048579_chr1_239229	58	26	ACAC	TGAG
V350256906L3C001R00100326734	chr1	1204221	50M	165	1204386	1204222	1204387	V350256906L3C001R00100326734_chr1_1204221	43	75	ctaa	TGAG
V350256906L3C001R00100492647	chr1	378430	50M	126	378556	378431	378557	V350256906L3C001R00100492647_chr1_378430	32	59	AAGA	AAGC
V350256906L3C001R00100557428	chr1	605350	50M	166	605516	605351	605517	V350256906L3C001R00100557428_chr1_605350	120	0	ctca	aaga
V350256906L3C001R00100810431	chr1	78791	50M	183	78974	78792	78975	V350256906L3C001R00100810431_chr1_78791	162	0	tact	tctt
V350256906L3C001R00100913991	chr1	951131	50M	163	951294	951132	951295	V350256906L3C001R00100913991_chr1_951131	47	34	CAGT	ggtg
V350256906L3C001R00101000901	chr1	1415302	50M	146	1415448	1415303	1415449	V350256906L3C001R00101000901_chr1_1415302	56	55	ccgg	tgtg
V350256906L3C001R00200601468	chr1	622690	50M	177	622867	622691	622868	V350256906L3C001R00200601468_chr1_622690	192	188	ATAC	CTCA
V350256906L3C001R00200845521	chr1	1085423	50M	202	1085625	1085424	1085626	V350256906L3C001R00200845521_chr1_1085423	81	94	CTGA	GCCC
V350256906L3C001R00200923264	chr1	804355	50M	174	804529	804356	804530	V350256906L3C001R00200923264_chr1_804355	59	60	CAGA	TTAA
V350256906L3C001R00201047280	chr1	1402386	50M	159	1402545	1402387	1402546	V350256906L3C001R00201047280_chr1_1402386	74	52	tgaa	cagc
V350256906L3C001R00201219436	chr1	966827	50M	170	966997	966828	966998	V350256906L3C001R00201219436_chr1_966827	21	33	TGGG	GGCT
V350256906L3C001R00201293657	chr1	932931	50M	163	933094	932932	933095	V350256906L3C001R00201293657_chr1_932931	38	68	CCCC	TGAG
V350256906L3C001R00300048680	chr1	773813	50M	156	773969	773814	773970	V350256906L3C001R00300048680_chr1_773813	40	73	cata	ggca
V350256906L3C001R00300098856	chr1	232898	50M	146	233044	232899	233045	V350256906L3C001R00300098856_chr1_232898	62	61	GTCT	TAGA
V350256906L3C001R00300569783	chr1	235891	50M	141	236032	235892	236033	V350256906L3C001R00300569783_chr1_235891	15	0	tgca	CAGA
V350256906L3C001R00300676213	chr1	1221442	50M	178	1221620	1221443	1221621	V350256906L3C001R00300676213_chr1_1221442	75	54	CCAT	AGCT
V350256906L3C001R00300717124	chr1	1381750	50M	179	1381929	1381751	1381930	V350256906L3C001R00300717124_chr1_1381750	88	34	ggca	cggc
V350256906L3C001R00300908417	chr1	767102	50M	188	767290	767103	767291	V350256906L3C001R00300908417_chr1_767102	47	51	TATC	AAGA
V350256906L3C001R00400116362	chr1	1029140	50M	125	1029265	1029141	1029266	V350256906L3C001R00400116362_chr1_1029140	60	27	cctg	cagc
V350256906L3C001R00400261628	chr1	264938	50M	178	265116	264939	265117	V350256906L3C001R00400261628_chr1_264938	72	52	caga	tgta
V350256906L3C001R00400297830	chr1	1269252	50M	206	1269458	1269253	1269459	V350256906L3C001R00400297830_chr1_1269252	81	65	CCGA	TGTG
V350256906L3C001R00400589664	chr1	1143199	50M	157	1143356	1143200	1143357	V350256906L3C001R00400589664_chr1_1143199	292	160	TAGA	cgcc
V350256906L3C001R00400641409	chr1	1230848	50M	149	1230997	1230849	1230998	V350256906L3C001R00400641409_chr1_1230848	18	0	CCCC	CCTG
V350256906L3C001R00400767052	chr1	146116	50M	176	146292	146117	146293	V350256906L3C001R00400767052_chr1_146116	64	71	catc	caag
V350256906L3C001R00500188653	chr1	47038	50M	195	47233	47039	47234	V350256906L3C001R00500188653_chr1_47038	86	0	ccag	TGTA
V350256906L3C001R00500379323	chr1	781518	50M	195	781713	781519	781714	V350256906L3C001R00500379323_chr1_781518	0	15	gcta	gcct
V350256906L3C001R00500510130	chr1	1073699	50M	178	1073877	1073700	1073878	V350256906L3C001R00500510130_chr1_1073699	58	56	cagc	ccag
V350256906L3C001R00500875156	chr1	128226	50M	176	128402	128227	128403	V350256906L3C001R00500875156_chr1_128226	98	19	CAAC	AGTG
V350256906L3C001R00500879548	chr1	1252469	50M	190	1252659	1252470	1252660	V350256906L3C001R00500879548_chr1_1252469	0	0	aatt	ggga
V350256906L3C001R00600510689	chr1	1098310	50M	167	1098477	1098311	1098478	V350256906L3C001R00600510689_chr1_1098310	0	151	CGAA	CGGA
V350256906L3C001R00600576957	chr1	1043349	50M	206	1043555	1043350	1043556	V350256906L3C001R00600576957_chr1_1043349	58	1	ctgt	GCTG
V350256906L3C001R00600579025	chr1	826945	50M	177	827122	826946	827123	V350256906L3C001R00600579025_chr1_826945	62	21	ctta	tgac
V350256906L3C001R00601107007	chr1	266873	50M	166	267039	266874	267040	V350256906L3C001R00601107007_chr1_266873	13	123	CGGC	CGTA
V350256906L3C001R00601311131	chr1	725056	40M10S	171	725227	725057	725228	V350256906L3C001R00601311131_chr1_725056	86	42	cgaa	catt
V350256906L3C001R00601352010	chr1	1212027	50M	171	1212198	1212028	1212199	V350256906L3C001R00601352010_chr1_1212027	72	5	tttt	cctt
V350256906L3C001R00601371360	chr1	1070380	50M	171	1070551	1070381	1070552	V350256906L3C001R00601371360_chr1_1070380	0	0	CCCC	CCCT
V350256906L3C001R00700037184	chr1	529446	50M	173	529619	529447	529620	V350256906L3C001R00700037184_chr1_529446	69	89	acta	CCAT
V350256906L3C001R00700428602	chr1	738845	50M	193	739038	738846	739039	V350256906L3C001R00700428602_chr1_738845	7	81	CACA	GAGA
V350256906L3C001R00700717250	chr1	671138	50M	151	671289	671139	671290	V350256906L3C001R00700717250_chr1_671138	81	112	AAAG	CCTC
V350256906L3C001R00700827084	chr1	1135524	50M	176	1135700	1135525	1135701	V350256906L3C001R00700827084_chr1_1135524	55	72	CGCT	GGTC
V350256906L3C001R00701291895	chr1	948499	50M	168	948667	948500	948668	V350256906L3C001R00701291895_chr1_948499	0	0	CTTG	CCCC
V350256906L3C001R00701322809	chr1	141110	50M	176	141286	141111	141287	V350256906L3C001R00701322809_chr1_141110	23	38	aatc	ccag
V350256906L3C001R00701352734	chr1	14718	50M	157	14875	14719	14876	V350256906L3C001R00701352734_chr1_14718	125	282	TCCT	CCAG
V350256906L3C001R00701382451	chr1	993714	50M	180	993894	993715	993895	V350256906L3C001R00701382451_chr1_993714	47	42	CCAG	CCTG
V350256906L3C001R00701392456	chr1	357648	50M	162	357810	357649	357811	V350256906L3C001R00701392456_chr1_357648	60	63	gacc	gata
V350256906L3C001R00800329738	chr1	1300854	50M	257	1301111	1300855	1301112	V350256906L3C001R00800329738_chr1_1300854	169	21	aaaa	ctcc
V350256906L3C001R00800598093	chr1	371609	50M	181	371790	371610	371791	V350256906L3C001R00800598093_chr1_371609	53	55	ACAA	CAGG
V350256906L3C001R00800728970	chr1	595869	50M	171	596040	595870	596041	V350256906L3C001R00800728970_chr1_595869	96	267	tgtc	gttg
V350256906L3C001R00800760276	chr1	1271183	50M	165	1271348	1271184	1271349	V350256906L3C001R00800760276_chr1_1271183	22	50	CCCT	TGTC
V350256906L3C001R00801093819	chr1	232895	50M	163	233058	232896	233059	V350256906L3C001R00801093819_chr1_232895	65	75	CTTG	AGAC
V350256906L3C001R00801134091	chr1	1301397	50M	172	1301569	1301398	1301570	V350256906L3C001R00801134091_chr1_1301397	60	73	TGAA	ctct
V350256906L3C001R00900098089	chr1	921037	50M	166	921203	921038	921204	V350256906L3C001R00900098089_chr1_921037	23	33	aagc	gcaa
V350256906L3C001R00900475138	chr1	755063	50M	165	755228	755064	755229	V350256906L3C001R00900475138_chr1_755063	16	16	CCAA	tgaa
V350256906L3C001R00900602992	chr1	408576	50M	203	408779	408577	408780	V350256906L3C001R00900602992_chr1_408576	20	0	gact	caat
V350256906L3C001R00901087749	chr1	969688	50M	194	969882	969689	969883	V350256906L3C001R00901087749_chr1_969688	14	208	TACC	GGTG
V350256906L3C001R00901358202	chr1	570350	50M	153	570503	570351	570504	V350256906L3C001R00901358202_chr1_570350	19	0	CTTT	TAAC
V350256906L3C001R01000098155	chr1	335252	50M	166	335418	335253	335419	V350256906L3C001R01000098155_chr1_335252	1	29	TCTT	caga
V350256906L3C001R01000235256	chr1	691567	50M	165	691732	691568	691733	V350256906L3C001R01000235256_chr1_691567	163	0	CACA	ctag
V350256906L3C001R01000620061	chr1	783555	50M	167	783722	783556	783723	V350256906L3C001R01000620061_chr1_783555	124	48	CTTG	TGTG
V350256906L3C001R01000672774	chr1	1047708	50M	133	1047841	1047709	1047842	V350256906L3C001R01000672774_chr1_1047708	16	149	gaca	GAGG
V350256906L3C001R01000924271	chr1	354571	50M	206	354777	354572	354778	V350256906L3C001R01000924271_chr1_354571	109	55	ccta	ctgt
V350256906L3C001R01000979345	chr1	134707	50M	183	134890	134708	134891	V350256906L3C001R01000979345_chr1_134707	34	44	AGCT	AGTG
V350256906L3C001R01001004702	chr1	405349	50M	173	405522	405350	405523	V350256906L3C001R01001004702_chr1_405349	64	49	ggat	CAGC
V350256906L3C001R01001398260	chr1	329757	50M	168	329925	329758	329926	V350256906L3C001R01001398260_chr1_329757	6	102	CCAC	AGAG
V350256906L3C001R01100222544	chr1	1305824	50M	153	1305977	1305825	1305978	V350256906L3C001R01100222544_chr1_1305824	59	52	gctc	GTTT
V350256906L3C001R01100485139	chr1	154042	50M	167	154209	154043	154210	V350256906L3C001R01100485139_chr1_154042	53	78	cagg	ccat
V350256906L3C001R01100561056	chr1	1361163	50M	164	1361327	1361164	1361328	V350256906L3C001R01100561056_chr1_1361163	56	72	AATG	CCTC
V350256906L3C001R01100709581	chr1	673838	50M	181	674019	673839	674020	V350256906L3C001R01100709581_chr1_673838	63	55	ccca	ggct
V350256906L3C001R01100718976	chr1	318844	50M	188	319032	318845	319033	V350256906L3C001R01100718976_chr1_318844	29	44	tgat	ccca
V350256906L3C001R01100886592	chr1	905782	50M	168	905950	905783	905951	V350256906L3C001R01100886592_chr1_905782	36	52	GCTG	GGAA
V350256906L3C001R01100898910	chr1	80666	50M	176	80842	80667	80843	V350256906L3C001R01100898910_chr1_80666	10	19	CATA	caaa
V350256906L3C001R01101015630	chr1	1031296	50M	168	1031464	1031297	1031465	V350256906L3C001R01101015630_chr1_1031296	81	43	gcat	tacg
V350256906L3C001R01101185396	chr1	1427043	50M	194	1427237	1427044	1427238	V350256906L3C001R01101185396_chr1_1427043	44	63	CTCG	CGGC
V350256906L3C001R01101285807	chr1	1323123	50M	163	1323286	1323124	1323287	V350256906L3C001R01101285807_chr1_1323123	39	79	TATC	CTTC
V350256906L3C001R01200077759	chr1	1313374	50M	175	1313549	1313375	1313550	V350256906L3C001R01200077759_chr1_1313374	0	6	GCCA	CAGA
V350256906L3C001R01200586510	chr1	964949	50M	105	965054	964950	965055	V350256906L3C001R01200586510_chr1_964949	0	57	CAGG	catg
V350256906L3C001R01200604835	chr1	145770	50M	124	145894	145771	145895	V350256906L3C001R01200604835_chr1_145770	30	57	tgct	CCTG
V350256906L3C001R01300449871	chr1	998951	50M	172	999123	998952	999124	V350256906L3C001R01300449871_chr1_998951	27	30	CCCT	CAGG
V350256906L3C001R01301034601	chr1	548015	50M	159	548174	548016	548175	V350256906L3C001R01301034601_chr1_548015	48	74	agga	cctg
V350256906L3C001R01301181613	chr1	1139534	50M	175	1139709	1139535	1139710	V350256906L3C001R01301181613_chr1_1139534	0	0	CTGC	CCCT
V350256906L3C001R01400059659	chr1	56090	50M	252	56342	56091	56343	V350256906L3C001R01400059659_chr1_56090	117	0	ACTC	GCCA
V350256906L3C001R01400446499	chr1	766304	50M	188	766492	766305	766493	V350256906L3C001R01400446499_chr1_766304	13	0	tggc	ccaC
V350256906L3C001R01400582056	chr1	360773	50M	177	360950	360774	360951	V350256906L3C001R01400582056_chr1_360773	38	57	CACA	GGCA
V350256906L3C001R01400872651	chr1	739802	50M	167	739969	739803	739970	V350256906L3C001R01400872651_chr1_739802	60	78	ggta	GGTG
V350256906L3C001R01400905020	chr1	857840	50M	179	858019	857841	858020	V350256906L3C001R01400905020_chr1_857840	65	62	CACA	CCTG
V350256906L3C001R01401293542	chr1	725542	19S31M	118	725660	725543	725661	V350256906L3C001R01401293542_chr1_725542	26	144	gaat	ttaa
V350256906L3C001R01500156918	chr1	1146644	50M	204	1146848	1146645	1146849	V350256906L3C001R01500156918_chr1_1146644	11	0	CCCC	CCCC
V350256906L3C001R01500407519	chr1	117031	50M	186	117217	117032	117218	V350256906L3C001R01500407519_chr1_117031	81	52	tatc	ttcc
V350256906L3C001R01500408477	chr1	1055232	50M	155	1055387	1055233	1055388	V350256906L3C001R01500408477_chr1_1055232	67	53	ggtg	tgtg
V350256906L3C001R01500626064	chr1	39531	50M	151	39682	39532	39683	V350256906L3C001R01500626064_chr1_39531	232	81	ccct	cacc
V350256906L3C001R01500685062	chr1	1359021	50M	160	1359181	1359022	1359182	V350256906L3C001R01500685062_chr1_1359021	80	66	gcta	caaa
V350256906L3C001R01500721938	chr1	752520	50M	168	752688	752521	752689	V350256906L3C001R01500721938_chr1_752520	63	38	agta	GACA
V350256906L3C001R01500806306	chr1	1150348	50M	149	1150497	1150349	1150498	V350256906L3C001R01500806306_chr1_1150348	42	49	agtg	CAGC
V350256906L3C001R01500931891	chr1	781688	50M	165	781853	781689	781854	V350256906L3C001R01500931891_chr1_781688	40	66	ggtg	acct
V350256906L3C001R01500952329	chr1	1087290	50M	161	1087451	1087291	1087452	V350256906L3C001R01500952329_chr1_1087290	37	0	GCAA	acag
V350256906L3C001R01600072684	chr1	677576	50M	197	677773	677577	677774	V350256906L3C001R01600072684_chr1_677576	64	87	ggga	cctg
V350256906L3C001R01600372276	chr1	29345	50M	159	29504	29346	29505	V350256906L3C001R01600372276_chr1_29345	108	0	CCCG	CCCG
V350256906L3C001R01600402294	chr1	62798	50M	176	62974	62799	62975	V350256906L3C001R01600402294_chr1_62798	107	62	CACT	CCAG
V350256906L3C001R01600493810	chr1	57776	50M	134	57910	57777	57911	V350256906L3C001R01600493810_chr1_57776	0	62	TGAA	AACT
V350256906L3C001R01600556909	chr1	318960	50M	161	319121	318961	319122	V350256906L3C001R01600556909_chr1_318960	0	52	tgtg	cttt
V350256906L3C001R01600588830	chr1	1404660	50M	175	1404835	1404661	1404836	V350256906L3C001R01600588830_chr1_1404660	60	66	ccct	ttag
V350256906L3C001R01600592761	chr1	1121578	50M	225	1121803	1121579	1121804	V350256906L3C001R01600592761_chr1_1121578	123	129	cctg	ccat
V350256906L3C001R01600891960	chr1	696046	50M	186	696232	696047	696233	V350256906L3C001R01600891960_chr1_696046	58	32	CCTA	CCCA
V350256906L3C001R01601097515	chr1	86172	50M	177	86349	86173	86350	V350256906L3C001R01601097515_chr1_86172	57	89	tatt	caag
V350256906L3C001R01601190634	chr1	683496	50M	189	683685	683497	683686	V350256906L3C001R01601190634_chr1_683496	0	94	tgag	caaa
V350256906L3C001R01700428451	chr1	13198	50M	123	13321	13199	13322	V350256906L3C001R01700428451_chr1_13198	0	23	CCTT	CAGA
V350256906L3C001R01700435482	chr1	698574	50M	147	698721	698575	698722	V350256906L3C001R01700435482_chr1_698574	94	33	AAGA	GGGG
V350256906L3C001R01700608100	chr1	135079	50M	223	135302	135080	135303	V350256906L3C001R01700608100_chr1_135079	233	21	GACC	CGGC
V350256906L3C001R01700983459	chr1	819237	46M4S	201	819438	819238	819439	V350256906L3C001R01700983459_chr1_819237	90	60	ggat	cagg
V350256906L3C001R01701188915	chr1	871264	50M	192	871456	871265	871457	V350256906L3C001R01701188915_chr1_871264	47	40	CTGC	CTCC
V350256906L3C001R01800140069	chr1	799979	50M	143	800122	799980	800123	V350256906L3C001R01800140069_chr1_799979	20	64	ACAA	CCAA
V350256906L3C001R01800409805	chr1	727959	50M	170	728129	727960	728130	V350256906L3C001R01800409805_chr1_727959	56	18	caat	tgtt
V350256906L3C001R01800590302	chr1	1039141	50M	109	1039250	1039142	1039251	V350256906L3C001R01800590302_chr1_1039141	0	43	ccct	agaa
V350256906L3C001R01800652661	chr1	696938	50M	166	697104	696939	697105	V350256906L3C001R01800652661_chr1_696938	0	11	CAGA	CCTC
V350256906L3C001R01800909894	chr1	166430	50M	158	166588	166431	166589	V350256906L3C001R01800909894_chr1_166430	255	133	cggg	TCAT
V350256906L3C001R01801184576	chr1	909460	50M	153	909613	909461	909614	V350256906L3C001R01801184576_chr1_909460	23	5	CCCG	CATG
V350256906L3C001R01801273572	chr1	573696	50M	163	573859	573697	573860	V350256906L3C001R01801273572_chr1_573696	32	0	ccct	CCTC
V350256906L3C001R01900237772	chr1	864289	50M	151	864440	864290	864441	V350256906L3C001R01900237772_chr1_864289	31	3	CCTA	ATGT
V350256906L3C001R01900299789	chr1	1340876	50M	179	1341055	1340877	1341056	V350256906L3C001R01900299789_chr1_1340876	186	294	ggca	ggct
V350256906L3C001R01900342056	chr1	665550	50M	178	665728	665551	665729	V350256906L3C001R01900342056_chr1_665550	78	256	cgac	TGTT
V350256906L3C001R01900366468	chr1	381750	50M	135	381885	381751	381886	V350256906L3C001R01900366468_chr1_381750	76	0	gata	taaa
V350256906L3C001R01900495350	chr1	1093909	50M	194	1094103	1093910	1094104	V350256906L3C001R01900495350_chr1_1093909	51	62	TCCG	CAAG
V350256906L3C001R01900674213	chr1	1372557	50M	164	1372721	1372558	1372722	V350256906L3C001R01900674213_chr1_1372557	66	51	GGGT	CGCC
V350256906L3C001R01901379420	chr1	642843	50M	168	643011	642844	643012	V350256906L3C001R01901379420_chr1_642843	0	0	acct	caag
V350256906L3C001R02000100079	chr1	95194	50M	203	95397	95195	95398	V350256906L3C001R02000100079_chr1_95194	0	0	CCTT	CCTG
V350256906L3C001R02000162224	chr1	1196097	50M	150	1196247	1196098	1196248	V350256906L3C001R02000162224_chr1_1196097	37	19	CCAT	tcag
V350256906L3C001R02000246089	chr1	1041190	50M	180	1041370	1041191	1041371	V350256906L3C001R02000246089_chr1_1041190	45	42	gctt	TCCG
V350256906L3C001R02000370582	chr1	469787	50M	197	469984	469788	469985	V350256906L3C001R02000370582_chr1_469787	164	275	atct	gagg
V350256906L3C001R02000612622	chr1	1278068	50M	182	1278250	1278069	1278251	V350256906L3C001R02000612622_chr1_1278068	53	43	CCCA	CCAC
V350256906L3C001R02000707524	chr1	1120127	50M	180	1120307	1120128	1120308	V350256906L3C001R02000707524_chr1_1120127	342	162	CCCC	GGAG
V350256906L3C001R02001003364	chr1	1267123	50M	175	1267298	1267124	1267299	V350256906L3C001R02001003364_chr1_1267123	141	0	CTTT	GAAG
V350256906L3C001R02100059727	chr1	779011	50M	166	779177	779012	779178	V350256906L3C001R02100059727_chr1_779011	33	160	AATA	CCTT
V350256906L3C001R02100445179	chr1	857874	50M	164	858038	857875	858039	V350256906L3C001R02100445179_chr1_857874	31	43	GGGA	CAGA
V350256906L3C001R02100460319	chr1	318876	50M	166	319042	318877	319043	V350256906L3C001R02100460319_chr1_318876	61	54	cagc	catc
V350256906L3C001R02100473845	chr1	463580	50M	197	463777	463581	463778	V350256906L3C001R02100473845_chr1_463580	79	164	tgaa	tgtg
V350256906L3C001R02100800805	chr1	255548	50M	165	255713	255549	255714	V350256906L3C001R02100800805_chr1_255548	5	3	GCAA	TCTT
V350256906L3C001R02101162416	chr1	428977	50M	149	429126	428978	429127	V350256906L3C001R02101162416_chr1_428977	22	61	gatg	TACA
V350256906L3C001R02101192286	chr1	33198	50M	162	33360	33199	33361	V350256906L3C001R02101192286_chr1_33198	64	48	ccta	ctat
V350256906L3C001R02200007534	chr1	791218	50M	158	791376	791219	791377	V350256906L3C001R02200007534_chr1_791218	0	0	CCAC	CCCA
V350256906L3C001R02200236683	chr1	237569	50M	158	237727	237570	237728	V350256906L3C001R02200236683_chr1_237569	41	65	AGGG	CATC
V350256906L3C001R02200325448	chr1	1398981	50M	196	1399177	1398982	1399178	V350256906L3C001R02200325448_chr1_1398981	22	42	CTGT	ggca
V350256906L3C001R02200864832	chr1	124454	50M	116	124570	124455	124571	V350256906L3C001R02200864832_chr1_124454	14	55	TATA	ccAG
V350256906L3C001R02201332273	chr1	373917	50M	170	374087	373918	374088	V350256906L3C001R02201332273_chr1_373917	152	0	caaa	tacc
V350256906L3C001R02201371360	chr1	1130356	50M	149	1130505	1130357	1130506	V350256906L3C001R02201371360_chr1_1130356	28	15	tctt	cagc
V350256906L3C001R02300049107	chr1	551377	50M	198	551575	551378	551576	V350256906L3C001R02300049107_chr1_551377	88	88	cctc	gcct
V350256906L3C001R02300831264	chr1	1402654	50M	233	1402887	1402655	1402888	V350256906L3C001R02300831264_chr1_1402654	3	0	GGGT	CGTG
V350256906L3C001R02301037503	chr1	1056183	50M	180	1056363	1056184	1056364	V350256906L3C001R02301037503_chr1_1056183	83	63	ctga	GCTG
V350256906L3C001R02301101999	chr1	235411	50M	177	235588	235412	235589	V350256906L3C001R02301101999_chr1_235411	7	184	GTCT	TATC
V350256906L3C001R02301184237	chr1	71109	50M	160	71269	71110	71270	V350256906L3C001R02301184237_chr1_71109	8	58	TATA	AGAA
V350256906L3C001R02400553015	chr1	462851	50M	183	463034	462852	463035	V350256906L3C001R02400553015_chr1_462851	53	86	ctgg	cctg
V350256906L3C001R02400742363	chr1	1206221	50M	161	1206382	1206222	1206383	V350256906L3C001R02400742363_chr1_1206221	0	145	CCCA	GGCT
V350256906L3C001R02400801860	chr1	139012	50M	197	139209	139013	139210	V350256906L3C001R02400801860_chr1_139012	0	48	TGAG	CACA
V350256906L3C001R02401082593	chr1	725058	5S45M	227	725285	725059	725286	V350256906L3C001R02401082593_chr1_725058	88	0	aaag	ttcc
V350256906L3C001R02500170279	chr1	149095	50M	188	149283	149096	149284	V350256906L3C001R02500170279_chr1_149095	7	4	GCaa	TAAT
V350256906L3C001R02500253813	chr1	1111733	50M	143	1111876	1111734	1111877	V350256906L3C001R02500253813_chr1_1111733	9	42	CGCT	CCCT
V350256906L3C001R02500935566	chr1	1383940	50M	166	1384106	1383941	1384107	V350256906L3C001R02500935566_chr1_1383940	35	67	aggg	ACCC
V350256906L3C001R02500945603	chr1	810925	50M	160	811085	810926	811086	V350256906L3C001R02500945603_chr1_810925	49	34	GTCC	CACC
V350256906L3C001R02501088051	chr1	244019	50M	166	244185	244020	244186	V350256906L3C001R02501088051_chr1_244019	18	23	TGTG	ggat
V350256906L3C001R02501233006	chr1	1328489	50M	173	1328662	1328490	1328663	V350256906L3C001R02501233006_chr1_1328489	42	18	CCCT	GTCC
V350256906L3C001R02600440916	chr1	137273	50M	165	137438	137274	137439	V350256906L3C001R02600440916_chr1_137273	42	24	AGGC	AGGG
V350256906L3C001R02600585934	chr1	450758	50M	145	450903	450759	450904	V350256906L3C001R02600585934_chr1_450758	0	137	cagc	cccg
V350256906L3C001R02600786386	chr1	1156340	50M	169	1156509	1156341	1156510	V350256906L3C001R02600786386_chr1_1156340	62	85	TAAC	CGTT
V350256906L3C001R02600790397	chr1	439744	50M	191	439935	439745	439936	V350256906L3C001R02600790397_chr1_439744	11	13	taat	CTTC
V350256906L3C001R02700019009	chr1	863532	50M	171	863703	863533	863704	V350256906L3C001R02700019009_chr1_863532	79	109	ggga	cctc
V350256906L3C001R02700506125	chr1	1149475	50M	171	1149646	1149476	1149647	V350256906L3C001R02700506125_chr1_1149475	34	38	CCCG	CACA
V350256906L3C001R02700698479	chr1	1372707	50M	145	1372852	1372708	1372853	V350256906L3C001R02700698479_chr1_1372707	37	0	CAAG	CCTC
V350256906L3C001R02700800944	chr1	1156102	50M	178	1156280	1156103	1156281	V350256906L3C001R02700800944_chr1_1156102	82	35	GGCC	CCCC
V350256906L3C001R02701223174	chr1	1369991	50M	205	1370196	1369992	1370197	V350256906L3C001R02701223174_chr1_1369991	43	20	AGCC	CCCC
V350256906L3C001R02701265795	chr1	470422	50M	133	470555	470423	470556	V350256906L3C001R02701265795_chr1_470422	10	61	ctag	ctat
V350256906L3C001R02800006030	chr1	673602	50M	171	673773	673603	673774	V350256906L3C001R02800006030_chr1_673602	81	63	ACAC	ctgg
V350256906L3C001R02800465271	chr1	457026	50M	216	457242	457027	457243	V350256906L3C001R02800465271_chr1_457026	5	9	gatt	actc
V350256906L3C001R02800638762	chr1	582180	50M	173	582353	582181	582354	V350256906L3C001R02800638762_chr1_582180	105	12	AGAT	TGTG
V350256906L3C001R02800707063	chr1	854182	50M	149	854331	854183	854332	V350256906L3C001R02800707063_chr1_854182	0	33	GGAG	TGTA
V350256906L3C001R02800764758	chr1	822085	50M	165	822250	822086	822251	V350256906L3C001R02800764758_chr1_822085	175	236	cctg	ggcc
V350256906L3C001R02800985259	chr1	163180	50M	176	163356	163181	163357	V350256906L3C001R02800985259_chr1_163180	67	76	AGAC	TGTA
V350256906L3C001R02800996985	chr1	101244	50M	189	101433	101245	101434	V350256906L3C001R02800996985_chr1_101244	12	48	agga	catc
V350256906L3C001R02801243968	chr1	727972	50M	174	728146	727973	728147	V350256906L3C001R02801243968_chr1_727972	43	35	tact	acta
V350256906L3C001R02900316279	chr1	556634	50M	159	556793	556635	556794	V350256906L3C001R02900316279_chr1_556634	41	47	aaag	TGTA
V350256906L3C001R02900328841	chr1	436251	50M	152	436403	436252	436404	V350256906L3C001R02900328841_chr1_436251	45	56	TGAT	ccct
V350256906L3C001R02900475197	chr1	821228	50M	199	821427	821229	821428	V350256906L3C001R02900475197_chr1_821228	7	14	tatc	tcac
V350256906L3C001R02900613709	chr1	397140	50M	183	397323	397141	397324	V350256906L3C001R02900613709_chr1_397140	4	10	CCCA	ctag
V350256906L3C001R02900673747	chr1	1412962	50M	166	1413128	1412963	1413129	V350256906L3C001R02900673747_chr1_1412962	44	26	CTGA	ggca
V350256906L3C001R02900844158	chr1	674239	50M	201	674440	674240	674441	V350256906L3C001R02900844158_chr1_674239	11	0	cacg	TGtt
V350256906L3C001R02900856960	chr1	1054245	50M	174	1054419	1054246	1054420	V350256906L3C001R02900856960_chr1_1054245	60	36	GGTG	tgag
V350256906L3C001R02901246882	chr1	1078245	50M	180	1078425	1078246	1078426	V350256906L3C001R02901246882_chr1_1078245	0	12	CCAG	CCAG
V350256906L3C001R03000219497	chr1	1211549	50M	164	1211713	1211550	1211714	V350256906L3C001R03000219497_chr1_1211549	0	29	ccag	cagc
V350256906L3C001R03000228641	chr1	1326890	50M	163	1327053	1326891	1327054	V350256906L3C001R03000228641_chr1_1326890	0	0	CCCA	TGTA
V350256906L3C001R03000900183	chr1	700296	50M	142	700438	700297	700439	V350256906L3C001R03000900183_chr1_700296	24	98	cgtc	cctg
V350256906L3C001R03000927064	chr1	673115	50M	194	673309	673116	673310	V350256906L3C001R03000927064_chr1_673115	18	45	gatc	gccc
V350256906L3C001R03001175184	chr1	393897	50M	199	394096	393898	394097	V350256906L3C001R03001175184_chr1_393897	104	36	ccaa	tggg
V350256906L3C001R03001344123	chr1	42139	50M	205	42344	42140	42345	V350256906L3C001R03001344123_chr1_42139	409	204	tctg	TTTC
V350256906L3C001R03100485323	chr1	241932	50M	209	242141	241933	242142	V350256906L3C001R03100485323_chr1_241932	0	18	CCAT	GGAG
V350256906L3C001R03100516989	chr1	723941	50M	167	724108	723942	724109	V350256906L3C001R03100516989_chr1_723941	7	0	GGAC	ttat
V350256906L3C001R03100656528	chr1	100569	50M	163	100732	100570	100733	V350256906L3C001R03100656528_chr1_100569	51	34	GTTA	CATC
V350256906L3C001R03100787034	chr1	1063006	50M	178	1063184	1063007	1063185	V350256906L3C001R03100787034_chr1_1063006	57	45	CCCG	CTTT
V350256906L3C001R03100800382	chr1	1162634	50M	166	1162800	1162635	1162801	V350256906L3C001R03100800382_chr1_1162634	60	46	CACC	cgcc
V350256906L3C001R03101022967	chr1	388262	50M	141	388403	388263	388404	V350256906L3C001R03101022967_chr1_388262	278	137	catc	actg
V350256906L3C001R03101045969	chr1	1249961	50M	168	1250129	1249962	1250130	V350256906L3C001R03101045969_chr1_1249961	263	186	TGAG	GGCA
V350256906L3C001R03101179240	chr1	626412	50M	159	626571	626413	626572	V350256906L3C001R03101179240_chr1_626412	59	65	ctat	aagt
V350256906L3C001R03200223331	chr1	1141848	50M	174	1142022	1141849	1142023	V350256906L3C001R03200223331_chr1_1141848	0	120	CCGC	CCTC
V350256906L3C001R03200456463	chr1	37853	50M	201	38054	37854	38055	V350256906L3C001R03200456463_chr1_37853	268	67	agag	CTCT
V350256906L3C001R03201225110	chr1	894387	50M	164	894551	894388	894552	V350256906L3C001R03201225110_chr1_894387	19	11	TTTT	CTGT
V350256906L3C001R03301122093	chr1	809516	50M	185	809701	809517	809702	V350256906L3C001R03301122093_chr1_809516	0	6	CCAG	CAAA
V350256906L3C001R03400387687	chr1	942765	50M	138	942903	942766	942904	V350256906L3C001R03400387687_chr1_942765	24	65	tgga	ttac
V350256906L3C001R03400696844	chr1	95379	50M	167	95546	95380	95547	V350256906L3C001R03400696844_chr1_95379	4	134	ACAA	tgtt
V350256906L3C001R03400944062	chr1	551368	50M	147	551515	551369	551516	V350256906L3C001R03400944062_chr1_551368	97	28	tggg	caag
V350256906L3C001R03401280054	chr1	62096	50M	169	62265	62097	62266	V350256906L3C001R03401280054_chr1_62096	86	49	cgtg	TACA
V350256906L3C001R03500159476	chr1	234798	50M	144	234942	234799	234943	V350256906L3C001R03500159476_chr1_234798	2	71	CATC	ccac
V350256906L3C001R03500279208	chr1	1010644	50M	201	1010845	1010645	1010846	V350256906L3C001R03500279208_chr1_1010644	54	20	CCAC	AGCC
V350256906L3C001R03500412129	chr1	1324008	50M	165	1324173	1324009	1324174	V350256906L3C001R03500412129_chr1_1324008	26	123	gagc	tttt
V350256906L3C001R03500569732	chr1	1191157	50M	156	1191313	1191158	1191314	V350256906L3C001R03500569732_chr1_1191157	81	46	CCCA	GCTC
V350256906L3C001R03500657791	chr1	251264	50M	161	251425	251265	251426	V350256906L3C001R03500657791_chr1_251264	5	0	taat	TTGT
V350256906L3C001R03500863654	chr1	592946	50M	179	593125	592947	593126	V350256906L3C001R03500863654_chr1_592946	2	4	CTTC	tgat
V350256906L3C001R03501161814	chr1	1020290	50M	168	1020458	1020291	1020459	V350256906L3C001R03501161814_chr1_1020290	35	53	CCAC	CGAG
V350256906L3C001R03501161841	chr1	791230	50M	170	791400	791231	791401	V350256906L3C001R03501161841_chr1_791230	1	0	AAGG	AGCT
V350256906L3C001R03501324759	chr1	1341749	50M	192	1341941	1341750	1341942	V350256906L3C001R03501324759_chr1_1341749	33	66	GGGG	GCCA
V350256906L3C001R03600406845	chr1	402287	50M	172	402459	402288	402460	V350256906L3C001R03600406845_chr1_402287	49	114	ctta	ccca
V350256906L3C001R03600434426	chr1	151324	50M	161	151485	151325	151486	V350256906L3C001R03600434426_chr1_151324	12	8	cttt	taaa
V350256906L3C001R03600590060	chr1	974456	50M	177	974633	974457	974634	V350256906L3C001R03600590060_chr1_974456	49	54	gctc	CCCC
V350256906L3C001R03600875543	chr1	828826	50M	168	828994	828827	828995	V350256906L3C001R03600875543_chr1_828826	0	0	gaat	gtag
V350256906L3C001R03700162510	chr1	970093	50M	154	970247	970094	970248	V350256906L3C001R03700162510_chr1_970093	101	35	CGCG	CCCA
V350256906L3C001R03700164779	chr1	1205996	50M	194	1206190	1205997	1206191	V350256906L3C001R03700164779_chr1_1205996	49	28	CAGG	CCTC
V350256906L3C001R03700503910	chr1	908143	50M	195	908338	908144	908339	V350256906L3C001R03700503910_chr1_908143	27	14	ccca	GGGA
V350256906L3C001R03700846570	chr1	1156346	50M	163	1156509	1156347	1156510	V350256906L3C001R03700846570_chr1_1156346	56	85	CCAA	CGTT
V350256906L3C001R03700863772	chr1	669451	50M	131	669582	669452	669583	V350256906L3C001R03700863772_chr1_669451	0	124	ggca	cttt
V350256906L3C001R03701236240	chr1	725808	6S26M18S	165	725973	725809	725974	V350256906L3C001R03701236240_chr1_725808	75	48	aatg	ccat
V350256906L3C001R03701346212	chr1	79701	50M	174	79875	79702	79876	V350256906L3C001R03701346212_chr1_79701	63	60	ctac	tcac
V350256906L3C001R03800025314	chr1	1064686	50M	167	1064853	1064687	1064854	V350256906L3C001R03800025314_chr1_1064686	0	31	CCCA	GGAT
V350256906L3C001R03800314868	chr1	693054	50M	164	693218	693055	693219	V350256906L3C001R03800314868_chr1_693054	65	34	ggag	caag
V350256906L3C001R03800384511	chr1	1062231	50M	178	1062409	1062232	1062410	V350256906L3C001R03800384511_chr1_1062231	59	55	GAGG	gcag
V350256906L3C001R03800757920	chr1	544556	50M	167	544723	544557	544724	V350256906L3C001R03800757920_chr1_544556	33	93	CCCT	CCCC
V350256906L3C001R03800848723	chr1	1302811	50M	174	1302985	1302812	1302986	V350256906L3C001R03800848723_chr1_1302811	121	20	ggat	aaca
V350256906L3C001R03800914854	chr1	1386232	50M	106	1386338	1386233	1386339	V350256906L3C001R03800914854_chr1_1386232	121	15	GTGT	CCTC
V350256906L3C001R03801293290	chr1	395435	50M	147	395582	395436	395583	V350256906L3C001R03801293290_chr1_395435	57	46	ctcc	gctt
V350256906L3C001R03801388399	chr1	167619	50M	182	167801	167620	167802	V350256906L3C001R03801388399_chr1_167619	7	23	acaa	TCAT
V350256906L3C001R03900161272	chr1	726825	22S20M5S	147	726972	726826	726973	V350256906L3C001R03900161272_chr1_726825	0	23	gaat	tcca
V350256906L3C001R03900187270	chr1	1424931	50M	162	1425093	1424932	1425094	V350256906L3C001R03900187270_chr1_1424931	33	9	CGGT	CCGT
V350256906L3C001R03901143133	chr1	700424	50M	170	700594	700425	700595	V350256906L3C001R03901143133_chr1_700424	84	134	ttct	CCCA
V350256906L3C001R03901268631	chr1	412583	50M	176	412759	412584	412760	V350256906L3C001R03901268631_chr1_412583	290	466	AATC	CCCT
V350256906L3C001R04000602945	chr1	648093	50M	190	648283	648094	648284	V350256906L3C001R04000602945_chr1_648093	11	24	ACCA	CAAG
V350256906L3C001R04001123194	chr1	61483	50M	171	61654	61484	61655	V350256906L3C001R04001123194_chr1_61483	30	43	TACC	TTTG
V350256906L3C001R04001257580	chr1	114945	50M	131	115076	114946	115077	V350256906L3C001R04001257580_chr1_114945	98	1	CCCA	agct
V350256906L3C001R04001319451	chr1	984759	50M	169	984928	984760	984929	V350256906L3C001R04001319451_chr1_984759	87	115	CCAG	CCGG
V350256906L3C001R04100003000	chr1	918773	50M	165	918938	918774	918939	V350256906L3C001R04100003000_chr1_918773	69	50	gaac	cctg
V350256906L3C001R04100147185	chr1	434897	50M	178	435075	434898	435076	V350256906L3C001R04100147185_chr1_434897	43	47	CATC	CCAT
V350256906L3C001R04100514051	chr1	257238	50M	155	257393	257239	257394	V350256906L3C001R04100514051_chr1_257238	13	7	taaa	GGTG
V350256906L3C001R04101207447	chr1	967496	50M	161	967657	967497	967658	V350256906L3C001R04101207447_chr1_967496	49	86	GGAG	CCTC
V350256906L3C001R04101267940	chr1	995760	50M	171	995931	995761	995932	V350256906L3C001R04101267940_chr1_995760	53	63	ggca	cttt
V350256906L3C001R04200198081	chr1	1212106	50M	170	1212276	1212107	1212277	V350256906L3C001R04200198081_chr1_1212106	64	44	cctt	ctgg
V350256906L3C001R04200370301	chr1	467759	50M	177	467936	467760	467937	V350256906L3C001R04200370301_chr1_467759	78	128	ccac	agga
V350256906L3C001R04200375047	chr1	875989	50M	175	876164	875990	876165	V350256906L3C001R04200375047_chr1_875989	53	57	GGCG	CCAG
V350256906L3C001R04200584289	chr1	1060863	50M	164	1061027	1060864	1061028	V350256906L3C001R04200584289_chr1_1060863	0	159	CGAC	CCTG
V350256906L3C001R04200884087	chr1	677706	50M	204	677910	677707	677911	V350256906L3C001R04200884087_chr1_677706	42	28	cgta	ctgg
V350256906L3C001R04200959255	chr1	1069803	50M	158	1069961	1069804	1069962	V350256906L3C001R04200959255_chr1_1069803	0	6	GGCA	GGGC
V350256906L3C001R04201031679	chr1	107400	50M	199	107599	107401	107600	V350256906L3C001R04201031679_chr1_107400	52	68	TGAG	ccag
V350256906L3C001R04201328234	chr1	343337	50M	175	343512	343338	343513	V350256906L3C001R04201328234_chr1_343337	303	284	AACA	cagg
V350256906L3C001R04201361552	chr1	14694	50M	119	14813	14695	14814	V350256906L3C001R04201361552_chr1_14694	101	220	CCCT	CCTG
V350256906L3C001R04300031134	chr1	1207685	50M	180	1207865	1207686	1207866	V350256906L3C001R04300031134_chr1_1207685	36	12	GGAA	CCTG
V350256906L3C001R04300089631	chr1	984187	50M	165	984352	984188	984353	V350256906L3C001R04300089631_chr1_984187	75	39	GGAT	CCAG
V350256906L3C001R04300444812	chr1	938493	50M	166	938659	938494	938660	V350256906L3C001R04300444812_chr1_938493	0	50	CCCT	ACCA
V350256906L3C001R04300809473	chr1	1402627	50M	200	1402827	1402628	1402828	V350256906L3C001R04300809473_chr1_1402627	30	29	TGGG	CACT
V350256906L3C001R04301308678	chr1	338777	50M	155	338932	338778	338933	V350256906L3C001R04301308678_chr1_338777	41	77	gccA	AATT
V350256906L3C001R04400029368	chr1	705981	50M	183	706164	705982	706165	V350256906L3C001R04400029368_chr1_705981	18	53	CAGG	CCAC
V350256906L3C001R04400300557	chr1	1124345	50M	166	1124511	1124346	1124512	V350256906L3C001R04400300557_chr1_1124345	0	12	agtg	gcat
V350256906L3C001R04400323699	chr1	417298	50M	173	417471	417299	417472	V350256906L3C001R04400323699_chr1_417298	203	30	tgac	GTTT
V350256906L3C001R04400692230	chr1	726910	50M	156	727066	726911	727067	V350256906L3C001R04400692230_chr1_726910	66	31	gaat	CTGT
V350256906L3C001R04400745005	chr1	630151	50M	164	630315	630152	630316	V350256906L3C001R04400745005_chr1_630151	61	57	ctca	GAAT
V350256906L3C001R04400745967	chr1	849143	50M	181	849324	849144	849325	V350256906L3C001R04400745967_chr1_849143	59	64	ACCT	CTCA
V350256906L3C001R04401150602	chr1	1063651	50M	170	1063821	1063652	1063822	V350256906L3C001R04401150602_chr1_1063651	51	63	TCCC	AGAA
V350256906L3C001R04401274176	chr1	386298	50M	176	386474	386299	386475	V350256906L3C001R04401274176_chr1_386298	386	328	gatg	ggac
V350256906L3C001R04500006483	chr1	1246386	50M	191	1246577	1246387	1246578	V350256906L3C001R04500006483_chr1_1246386	25	23	AGCA	CCCT
V350256906L3C001R04500028289	chr1	1423310	50M	180	1423490	1423311	1423491	V350256906L3C001R04500028289_chr1_1423310	0	14	CCTC	ggtg
V350256906L3C001R04500275079	chr1	1292595	50M	136	1292731	1292596	1292732	V350256906L3C001R04500275079_chr1_1292595	29	0	CCCG	ctcg
V350256906L3C001R04500757360	chr1	1258612	50M	150	1258762	1258613	1258763	V350256906L3C001R04500757360_chr1_1258612	46	69	CCTC	GGAA
V350256906L3C001R04501362265	chr1	124387	50M	144	124531	124388	124532	V350256906L3C001R04501362265_chr1_124387	32	16	ggtt	GAAG
V350256906L3C001R04501379114	chr1	236805	50M	169	236974	236806	236975	V350256906L3C001R04501379114_chr1_236805	32	34	cagg	GCAG
V350256906L3C001R04600399099	chr1	941812	50M	152	941964	941813	941965	V350256906L3C001R04600399099_chr1_941812	159	231	TGGT	ACCC
V350256906L3C001R04600436531	chr1	437909	50M	173	438082	437910	438083	V350256906L3C001R04600436531_chr1_437909	215	42	CCTC	GGTT
V350256906L3C001R04600671533	chr1	1142397	50M	169	1142566	1142398	1142567	V350256906L3C001R04600671533_chr1_1142397	222	53	GGAC	CACC
V350256906L3C001R04600717932	chr1	257152	50M	175	257327	257153	257328	V350256906L3C001R04600717932_chr1_257152	0	34	ctag	aagg
V350256906L3C001R04600763311	chr1	907481	50M	170	907651	907482	907652	V350256906L3C001R04600763311_chr1_907481	69	47	CATC	TGAG
V350256906L3C001R04700264454	chr1	985960	50M	174	986134	985961	986135	V350256906L3C001R04700264454_chr1_985960	0	7	AGCG	GGCT
V350256906L3C001R04700537266	chr1	1185066	50M	172	1185238	1185067	1185239	V350256906L3C001R04700537266_chr1_1185066	0	0	GGtg	cagc
V350256906L3C001R04700763093	chr1	984195	50M	197	984392	984196	984393	V350256906L3C001R04700763093_chr1_984195	74	49	GTGG	CCCC
V350256906L3C001R04701003746	chr1	661804	50M	162	661966	661805	661967	V350256906L3C001R04701003746_chr1_661804	142	304	GCTG	GGTC
V350256906L3C001R04701162213	chr1	1424447	50M	185	1424632	1424448	1424633	V350256906L3C001R04701162213_chr1_1424447	17	9	CAGG	GTAC
V350256906L3C001R04701204180	chr1	1222714	50M	174	1222888	1222715	1222889	V350256906L3C001R04701204180_chr1_1222714	0	19	CCAC	CTGG
V350256906L3C001R04701332647	chr1	1031277	50M	179	1031456	1031278	1031457	V350256906L3C001R04701332647_chr1_1031277	65	35	gttt	tatt
V350256906L3C001R04800325880	chr1	1017637	50M	254	1017891	1017638	1017892	V350256906L3C001R04800325880_chr1_1017637	44	53	CTTA	CCAG
V350256906L3C001R04800659008	chr1	358709	50M	203	358912	358710	358913	V350256906L3C001R04800659008_chr1_358709	128	13	TAGA	TTAT
V350256906L3C001R04800727247	chr1	992044	5M2I43M	175	992219	992045	992220	V350256906L3C001R04800727247_chr1_992044	25	62	tgta	CCAG
V350256906L3C001R04801319424	chr1	136852	50M	161	137013	136853	137014	V350256906L3C001R04801319424_chr1_136852	308	147	GACC	CGCG
V350256906L3C001R04900148005	chr1	141495	50M	162	141657	141496	141658	V350256906L3C001R04900148005_chr1_141495	0	75	cacc	tatt
V350256906L3C001R04900352896	chr1	1245737	50M	113	1245850	1245738	1245851	V350256906L3C001R04900352896_chr1_1245737	16	67	GTGA	CCAT
V350256906L3C001R04900845462	chr1	134099	50M	196	134295	134100	134296	V350256906L3C001R04900845462_chr1_134099	0	71	ccga	aatc
V350256906L3C001R04901142847	chr1	231869	50M	185	232054	231870	232055	V350256906L3C001R04901142847_chr1_231869	145	23	cctt	attt
V350256906L3C001R04901183779	chr1	703389	50M	166	703555	703390	703556	V350256906L3C001R04901183779_chr1_703389	12	31	ggtc	tctc
V350256906L3C001R04901274903	chr1	931343	50M	167	931510	931344	931511	V350256906L3C001R04901274903_chr1_931343	0	46	GACA	GAAT
V350256906L3C001R04901322096	chr1	738195	50M	175	738370	738196	738371	V350256906L3C001R04901322096_chr1_738195	44	41	CACA	AGTA
V350256906L3C001R05000139196	chr1	1262204	50M	172	1262376	1262205	1262377	V350256906L3C001R05000139196_chr1_1262204	0	0	CTCC	GCAA
V350256906L3C001R05000467695	chr1	62173	50M	174	62347	62174	62348	V350256906L3C001R05000467695_chr1_62173	9	34	tcct	CAGT
V350256906L3C001R05000817035	chr1	251048	50M	214	251262	251049	251263	V350256906L3C001R05000817035_chr1_251048	4	3	caac	cttt
V350256906L3C001R05000897274	chr1	883942	50M	143	884085	883943	884086	V350256906L3C001R05000897274_chr1_883942	65	47	CATG	GGTG
V350256906L3C001R05001062487	chr1	1124019	50M	222	1124241	1124020	1124242	V350256906L3C001R05001062487_chr1_1124019	128	59	aggc	tgct
V350256906L3C001R05100336555	chr1	376456	50M	174	376630	376457	376631	V350256906L3C001R05100336555_chr1_376456	106	280	aatt	aaaa
V350256906L3C001R05100701368	chr1	348115	50M	160	348275	348116	348276	V350256906L3C001R05100701368_chr1_348115	184	24	CAAT	Cttc
V350256906L3C001R05100783567	chr1	250582	50M	131	250713	250583	250714	V350256906L3C001R05100783567_chr1_250582	56	43	AACA	ccta
V350256906L3C001R05101141643	chr1	1423805	50M	164	1423969	1423806	1423970	V350256906L3C001R05101141643_chr1_1423805	82	52	ccac	cggg
V350256906L3C001R05101403817	chr1	100590	50M	167	100757	100591	100758	V350256906L3C001R05101403817_chr1_100590	72	9	ATTC	AAGG
V350256906L3C001R05200306541	chr1	1159700	50M	189	1159889	1159701	1159890	V350256906L3C001R05200306541_chr1_1159700	146	0	ccca	cagg
V350256906L3C001R05200334480	chr1	558299	50M	163	558462	558300	558463	V350256906L3C001R05200334480_chr1_558299	54	35	GACT	catt
V350256906L3C001R05200583674	chr1	1311498	50M	254	1311752	1311499	1311753	V350256906L3C001R05200583674_chr1_1311498	64	89	CACC	CTTT
V350256906L3C001R05200801834	chr1	93636	50M	170	93806	93637	93807	V350256906L3C001R05200801834_chr1_93636	24	54	CCTA	gctg
V350256906L3C001R05200958453	chr1	850764	50M	198	850962	850765	850963	V350256906L3C001R05200958453_chr1_850764	62	56	cctc	CCTT
V350256906L3C001R05201170985	chr1	688111	50M	176	688287	688112	688288	V350256906L3C001R05201170985_chr1_688111	6	55	tgcc	ccag
V350256906L3C001R05300037058	chr1	833623	50M	175	833798	833624	833799	V350256906L3C001R05300037058_chr1_833623	0	0	agag	cttc
V350256906L3C001R05300144087	chr1	262608	50M	147	262755	262609	262756	V350256906L3C001R05300144087_chr1_262608	0	8	AACA	ctga
V350256906L3C001R05300338553	chr1	623853	50M	197	624050	623854	624051	V350256906L3C001R05300338553_chr1_623853	125	28	TAta	ACTA
V350256906L3C001R05300835805	chr1	1160486	50M	148	1160634	1160487	1160635	V350256906L3C001R05300835805_chr1_1160486	168	20	CCCA	cgca
V350256906L3C001R05300991252	chr1	421181	50M	173	421354	421182	421355	V350256906L3C001R05300991252_chr1_421181	55	71	TGAT	TGAT
V350256906L3C001R05301160830	chr1	1056609	50M	170	1056779	1056610	1056780	V350256906L3C001R05301160830_chr1_1056609	19	18	GCTC	CCCT
V350256906L3C001R05301187838	chr1	949549	50M	156	949705	949550	949706	V350256906L3C001R05301187838_chr1_949549	8	0	GGGC	TCCA
V350256906L3C001R05400014401	chr1	892585	50M	136	892721	892586	892722	V350256906L3C001R05400014401_chr1_892585	20	51	AACT	CTGT
V350256906L3C001R05400101600	chr1	776136	50M	160	776296	776137	776297	V350256906L3C001R05400101600_chr1_776136	10	94	TATC	GTAC
V350256906L3C001R05400255425	chr1	725207	47M3S	129	725336	725208	725337	V350256906L3C001R05400255425_chr1_725207	62	0	gact	attc
V350256906L3C001R05400596470	chr1	888945	50M	197	889142	888946	889143	V350256906L3C001R05400596470_chr1_888945	21	20	CACG	CCTG
V350256906L3C001R05400904178	chr1	319102	50M	170	319272	319103	319273	V350256906L3C001R05400904178_chr1_319102	71	37	caga	ttat
V350256906L3C001R05401108962	chr1	243455	50M	181	243636	243456	243637	V350256906L3C001R05401108962_chr1_243455	53	42	CCCT	CTGG
V350256906L3C001R05401249059	chr1	1042997	50M	176	1043173	1042998	1043174	V350256906L3C001R05401249059_chr1_1042997	36	20	acca	ttta
V350256906L3C001R05500138739	chr1	576894	50M	243	577137	576895	577138	V350256906L3C001R05500138739_chr1_576894	15	75	CATT	gctg
V350256906L3C001R05500188988	chr1	1213941	50M	196	1214137	1213942	1214138	V350256906L3C001R05500188988_chr1_1213941	43	47	cagc	cttt
V350256906L3C001R05500335840	chr1	1085425	50M	161	1085586	1085426	1085587	V350256906L3C001R05500335840_chr1_1085425	79	55	GAGC	CACC
V350256906L3C001R05500485390	chr1	1197739	50M	180	1197919	1197740	1197920	V350256906L3C001R05500485390_chr1_1197739	0	0	CCCT	GAAG
V350256906L3C001R05500721288	chr1	1184567	50M	160	1184727	1184568	1184728	V350256906L3C001R05500721288_chr1_1184567	281	301	CCCA	CGTG
V350256906L3C001R05600069737	chr1	705425	50M	176	705601	705426	705602	V350256906L3C001R05600069737_chr1_705425	7	19	cagt	CCTT
V350256906L3C001R05600214089	chr1	169633	50M	200	169833	169634	169834	V350256906L3C001R05600214089_chr1_169633	78	13	ggtg	GCCC
V350256906L3C001R05600296613	chr1	326650	50M	182	326832	326651	326833	V350256906L3C001R05600296613_chr1_326650	69	19	CTAG	CAGA
V350256906L3C001R05600677261	chr1	726348	10S24M16S	158	726506	726349	726507	V350256906L3C001R05600677261_chr1_726348	57	29	ggaa	catt
V350256906L3C001R05700040804	chr1	132326	50M	181	132507	132327	132508	V350256906L3C001R05700040804_chr1_132326	0	46	CCAG	CCAA
V350256906L3C001R05700127321	chr1	466565	50M	168	466733	466566	466734	V350256906L3C001R05700127321_chr1_466565	0	159	CCAT	CTGG
V350256906L3C001R05700179368	chr1	664112	50M	170	664282	664113	664283	V350256906L3C001R05700179368_chr1_664112	5	100	CATG	CCAG
V350256906L3C001R05700523923	chr1	69953	50M	167	70120	69954	70121	V350256906L3C001R05700523923_chr1_69953	216	49	AGAC	TAAA
V350256906L3C001R05700583714	chr1	364246	50M	191	364437	364247	364438	V350256906L3C001R05700583714_chr1_364246	52	55	CCCC	AAGG
V350256906L3C001R05700973991	chr1	453078	50M	179	453257	453079	453258	V350256906L3C001R05700973991_chr1_453078	229	50	ctga	ttga
V350256906L3C001R05701158398	chr1	718438	50M	168	718606	718439	718607	V350256906L3C001R05701158398_chr1_718438	42	210	ctaa	CAAT
V350256906L3C001R05701361773	chr1	115478	50M	112	115590	115479	115591	V350256906L3C001R05701361773_chr1_115478	8	73	CCTA	tggc
V350256906L3C001R05800243641	chr1	569127	50M	256	569383	569128	569384	V350256906L3C001R05800243641_chr1_569127	12	12	CCCG	CTAG
V350256906L3C001R05800581755	chr1	952515	50M	168	952683	952516	952684	V350256906L3C001R05800581755_chr1_952515	21	6	ctcg	ctcc
V350256906L3C001R05801297510	chr1	1332069	50M	244	1332313	1332070	1332314	V350256906L3C001R05801297510_chr1_1332069	63	0	cctg	ctaa
V350256906L3C001R05900001457	chr1	1132997	50M	196	1133193	1132998	1133194	V350256906L3C001R05900001457_chr1_1132997	14	59	CCAC	CCTT
V350256906L3C001R05900006299	chr1	133071	50M	172	133243	133072	133244	V350256906L3C001R05900006299_chr1_133071	19	33	CCAA	CTGG
V350256906L3C001R05900403477	chr1	805532	50M	152	805684	805533	805685	V350256906L3C001R05900403477_chr1_805532	58	39	CCCC	AGAA
V350256906L3C001R05900847953	chr1	259564	50M	151	259715	259565	259716	V350256906L3C001R05900847953_chr1_259564	35	74	TGAC	TTAA
V350256906L3C001R05901188470	chr1	152778	50M	153	152931	152779	152932	V350256906L3C001R05901188470_chr1_152778	740	587	ccga	agga
V350256906L3C001R06000140662	chr1	1052129	50M	148	1052277	1052130	1052278	V350256906L3C001R06000140662_chr1_1052129	0	127	CTCG	GCTG
V350256906L3C001R06000215026	chr1	573178	50M	206	573384	573179	573385	V350256906L3C001R06000215026_chr1_573178	68	54	caag	tgta
V350256906L3C001R06000342966	chr1	32965	50M	155	33120	32966	33121	V350256906L3C001R06000342966_chr1_32965	43	85	tgtc	tcct
V350256906L3C001R06100165591	chr1	171672	50M	153	171825	171673	171826	V350256906L3C001R06100165591_chr1_171672	11	0	CCTT	CAAG
V350256906L3C001R06100228104	chr1	1370343	50M	119	1370462	1370344	1370463	V350256906L3C001R06100228104_chr1_1370343	51	30	GAGT	CACC
V350256906L3C001R06100797699	chr1	103801	50M	156	103957	103802	103958	V350256906L3C001R06100797699_chr1_103801	4	0	gacg	tgtt
V350256906L3C001R06100959483	chr1	733587	50M	175	733762	733588	733763	V350256906L3C001R06100959483_chr1_733587	1	11	CGGC	CCTT
V350256906L3C001R06101192080	chr1	46862	50M	174	47036	46863	47037	V350256906L3C001R06101192080_chr1_46862	262	88	TCCT	ccca
V350256906L3C001R06200432246	chr1	113226	50M	230	113456	113227	113457	V350256906L3C001R06200432246_chr1_113226	85	31	CAAA	CCAC
V350256906L3C001R06201089172	chr1	760802	50M	194	760996	760803	760997	V350256906L3C001R06201089172_chr1_760802	82	70	CAAC	AGGA
V350256906L3C001R06300229325	chr1	633774	50M	167	633941	633775	633942	V350256906L3C001R06300229325_chr1_633774	208	363	acgt	gcca
V350256906L3C001R06300366419	chr1	638272	50M	122	638394	638273	638395	V350256906L3C001R06300366419_chr1_638272	82	144	gctg	CTCT
V350256906L3C001R06300427662	chr1	165359	50M	185	165544	165360	165545	V350256906L3C001R06300427662_chr1_165359	0	184	CTGC	GGAC
V350256906L3C001R06300798935	chr1	782418	50M	163	782581	782419	782582	V350256906L3C001R06300798935_chr1_782418	63	55	gcaa	ACCA
V350256906L3C001R06301049102	chr1	85789	50M	161	85950	85790	85951	V350256906L3C001R06301049102_chr1_85789	15	69	ctga	ctaa
V350256906L3C001R06301346251	chr1	963044	50M	153	963197	963045	963198	V350256906L3C001R06301346251_chr1_963044	94	35	CCTG	CAGG
V350256906L3C001R06400590362	chr1	726735	20M30S	223	726958	726736	726959	V350256906L3C001R06400590362_chr1_726735	78	37	gaat	ttcc
V350256906L3C001R06400727724	chr1	1380723	50M	173	1380896	1380724	1380897	V350256906L3C001R06400727724_chr1_1380723	61	92	tttc	gtgc
V350256906L3C001R06400769854	chr1	1348251	50M	187	1348438	1348252	1348439	V350256906L3C001R06400769854_chr1_1348251	232	45	tatc	agtt
V350256906L3C001R06400797715	chr1	421057	50M	178	421235	421058	421236	V350256906L3C001R06400797715_chr1_421057	0	1	TGAG	TTCT
V350256906L3C001R06400885610	chr1	1089952	50M	190	1090142	1089953	1090143	V350256906L3C001R06400885610_chr1_1089952	163	0	tgag	ggct
V350256906L3C001R06400999283	chr1	47351	50M	172	47523	47352	47524	V350256906L3C001R06400999283_chr1_47351	12	126	GAAT	CCAT
V350256906L3C001R06401036311	chr1	231936	50M	166	232102	231937	232103	V350256906L3C001R06401036311_chr1_231936	78	71	cact	actt
V350256906L3C001R06401228361	chr1	110087	50M	164	110251	110088	110252	V350256906L3C001R06401228361_chr1_110087	58	62	aaag	tatc
V350256906L3C001R06401277874	chr1	1010453	50M	159	1010612	1010454	1010613	V350256906L3C001R06401277874_chr1_1010453	37	50	GGAG	CACT
V350256906L3C001R06500030420	chr1	1387210	50M	184	1387394	1387211	1387395	V350256906L3C001R06500030420_chr1_1387210	24	0	GCCG	TTTA
V350256906L3C001R06500394565	chr1	1121134	50M	221	1121355	1121135	1121356	V350256906L3C001R06500394565_chr1_1121134	0	66	ACTG	gctg
V350256906L3C001R06500665088	chr1	872340	50M	158	872498	872341	872499	V350256906L3C001R06500665088_chr1_872340	11	169	TGTC	CACG
V350256906L3C001R06500686325	chr1	359205	50M	182	359387	359206	359388	V350256906L3C001R06500686325_chr1_359205	41	45	GACT	TGTA
V350256906L3C001R06500915993	chr1	963097	50M	123	963220	963098	963221	V350256906L3C001R06500915993_chr1_963097	41	58	CCAC	CCAA
V350256906L3C001R06501064322	chr1	621728	50M	176	621904	621729	621905	V350256906L3C001R06501064322_chr1_621728	0	0	AGAA	CATT
V350256906L3C001R06501263192	chr1	1081524	50M	184	1081708	1081525	1081709	V350256906L3C001R06501263192_chr1_1081524	1	10	GGGG	GGGA
V350256906L3C001R06501320347	chr1	700998	50M	167	701165	700999	701166	V350256906L3C001R06501320347_chr1_700998	45	76	tgta	CCCT
V350256906L3C001R06600702125	chr1	78660	50M	211	78871	78661	78872	V350256906L3C001R06600702125_chr1_78660	179	82	aaac	tctg
V350256906L3C001R06600727217	chr1	458570	50M	133	458703	458571	458704	V350256906L3C001R06600727217_chr1_458570	122	0	ccca	ctac
V350256906L3C001R06600947219	chr1	693611	50M	190	693801	693612	693802	V350256906L3C001R06600947219_chr1_693611	52	66	AAaa	ACTA
V350256906L3C001R06600982291	chr1	954158	50M	168	954326	954159	954327	V350256906L3C001R06600982291_chr1_954158	0	133	gaag	cttg
V350256906L3C001R06600993663	chr1	138944	50M	144	139088	138945	139089	V350256906L3C001R06600993663_chr1_138944	64	27	CAAC	AGCT
V350256906L3C001R06601236846	chr1	663520	50M	169	663689	663521	663690	V350256906L3C001R06601236846_chr1_663520	60	58	AGCC	CCTG
V350256906L3C001R06700006765	chr1	936231	50M	158	936389	936232	936390	V350256906L3C001R06700006765_chr1_936231	44	58	TGCG	CCCT
V350256906L3C001R06700284017	chr1	801753	50M	173	801926	801754	801927	V350256906L3C001R06700284017_chr1_801753	69	0	gagg	CTGG
V350256906L3C001R06700435725	chr1	1204688	50M	169	1204857	1204689	1204858	V350256906L3C001R06700435725_chr1_1204688	203	37	CCGA	aaaa
V350256906L3C001R06700468419	chr1	1274111	50M	165	1274276	1274112	1274277	V350256906L3C001R06700468419_chr1_1274111	35	29	CCTC	GTTT
V350256906L3C001R06700489428	chr1	620284	50M	223	620507	620285	620508	V350256906L3C001R06700489428_chr1_620284	17	61	caga	tatt
V350256906L3C001R06700525811	chr1	147248	50M	146	147394	147249	147395	V350256906L3C001R06700525811_chr1_147248	13	60	agcc	ggtc
V350256906L3C001R06701220113	chr1	708637	50M	177	708814	708638	708815	V350256906L3C001R06701220113_chr1_708637	65	72	ctac	ACCA
V350256906L3C001R06800259622	chr1	732373	50M	198	732571	732374	732572	V350256906L3C001R06800259622_chr1_732373	46	89	aaac	CCCA
V350256906L3C001R06800667545	chr1	931802	50M	143	931945	931803	931946	V350256906L3C001R06800667545_chr1_931802	114	196	CCCA	CCAG
V350256906L3C001R06801029206	chr1	959936	50M	165	960101	959937	960102	V350256906L3C001R06801029206_chr1_959936	122	0	CCCC	GGCA
V350256906L3C001R06900139144	chr1	1325609	50M	187	1325796	1325610	1325797	V350256906L3C001R06900139144_chr1_1325609	51	66	CCCA	CCAG
V350256906L3C001R06900363670	chr1	411357	50M	198	411555	411358	411556	V350256906L3C001R06900363670_chr1_411357	0	45	AAAA	CCAT
V350256906L3C001R06900434864	chr1	17681	50M	169	17850	17682	17851	V350256906L3C001R06900434864_chr1_17681	18	7	TCTG	CCAC
V350256906L3C001R06900875068	chr1	1326971	50M	216	1327187	1326972	1327188	V350256906L3C001R06900875068_chr1_1326971	56	13	CATA	GGTC
V350256906L3C001R06901140304	chr1	111149	50M	189	111338	111150	111339	V350256906L3C001R06901140304_chr1_111149	82	69	ggtc	ggct
V350256906L3C001R07000106698	chr1	1423766	50M	135	1423901	1423767	1423902	V350256906L3C001R07000106698_chr1_1423766	43	0	cggc	ccaa
V350256906L3C001R07000114676	chr1	147759	50M	176	147935	147760	147936	V350256906L3C001R07000114676_chr1_147759	96	52	agcc	ccac
V350256906L3C001R07000448603	chr1	317930	50M	167	318097	317931	318098	V350256906L3C001R07000448603_chr1_317930	94	241	tgag	GTCT
V350256906L3C001R07000453237	chr1	1147062	50M	164	1147226	1147063	1147227	V350256906L3C001R07000453237_chr1_1147062	29	193	GGCA	CCCC
V350256906L3C001R07000526723	chr1	644468	50M	162	644630	644469	644631	V350256906L3C001R07000526723_chr1_644468	0	0	agtg	cctt
V350256906L3C001R07000686108	chr1	467572	50M	120	467692	467573	467693	V350256906L3C001R07000686108_chr1_467572	58	11	cccc	tgga
V350256906L3C001R07001217716	chr1	88896	50M	194	89090	88897	89091	V350256906L3C001R07001217716_chr1_88896	203	9	AGAG	ggtg
V350256906L3C001R07001360463	chr1	696146	50M	190	696336	696147	696337	V350256906L3C001R07001360463_chr1_696146	11	33	CCAA	TGTT
V350256906L3C001R07100186559	chr1	260628	50M	175	260803	260629	260804	V350256906L3C001R07100186559_chr1_260628	26	11	gaga	caga
V350256906L3C001R07100194361	chr1	39821	50M	192	40013	39822	40014	V350256906L3C001R07100194361_chr1_39821	42	70	gctt	cctc
V350256906L3C001R07100344347	chr1	469502	50M	173	469675	469503	469676	V350256906L3C001R07100344347_chr1_469502	57	52	CCCC	cagc
V350256906L3C001R07100514074	chr1	1345021	50M	158	1345179	1345022	1345180	V350256906L3C001R07100514074_chr1_1345021	88	9	ccca	cccc
V350256906L3C001R07100639167	chr1	375414	50M	182	375596	375415	375597	V350256906L3C001R07100639167_chr1_375414	4	6	ggtg	aaag
V350256906L3C001R07100932323	chr1	233250	50M	160	233410	233251	233411	V350256906L3C001R07100932323_chr1_233250	68	37	TGAG	gctt
V350256906L3C001R07101399212	chr1	930825	50M	166	930991	930826	930992	V350256906L3C001R07101399212_chr1_930825	51	17	tgta	TCAC
V350256906L3C001R07200214420	chr1	685495	50M	131	685626	685496	685627	V350256906L3C001R07200214420_chr1_685495	59	0	GGAT	acat
V350256906L3C001R07200301452	chr1	965882	50M	234	966116	965883	966117	V350256906L3C001R07200301452_chr1_965882	19	0	TGTG	caca
V350256906L3C001R07200464889	chr1	463448	50M	177	463625	463449	463626	V350256906L3C001R07200464889_chr1_463448	11	124	ggac	tgta
V350256906L3C001R07200532333	chr1	1125912	50M	132	1126044	1125913	1126045	V350256906L3C001R07200532333_chr1_1125912	37	0	attc	gaaa
V350256906L3C001R07200875302	chr1	1302769	2S48M	164	1302933	1302770	1302934	V350256906L3C001R07200875302_chr1_1302769	138	0	tgag	cacc
V350256906L3C001R07201234344	chr1	1211749	50M	179	1211928	1211750	1211929	V350256906L3C001R07201234344_chr1_1211749	0	0	cctc	gaga
V350256906L3C001R07201253306	chr1	88380	50M	179	88559	88381	88560	V350256906L3C001R07201253306_chr1_88380	32	30	cacc	ttag
V350256906L3C002R00100362029	chr1	1360006	50M	168	1360174	1360007	1360175	V350256906L3C002R00100362029_chr1_1360006	0	0	gcag	CGTC
V350256906L3C002R00100832657	chr1	831568	50M	157	831725	831569	831726	V350256906L3C002R00100832657_chr1_831568	0	119	taaa	aaga
V350256906L3C002R00200030166	chr1	1306562	50M	165	1306727	1306563	1306728	V350256906L3C002R00200030166_chr1_1306562	36	50	GCTC	CCTG
V350256906L3C002R00200089029	chr1	248014	50M	167	248181	248015	248182	V350256906L3C002R00200089029_chr1_248014	113	226	TGGG	ccca
V350256906L3C002R00200648328	chr1	227704	50M	168	227872	227705	227873	V350256906L3C002R00200648328_chr1_227704	57	27	GGCT	cata
V350256906L3C002R00200779615	chr1	1006481	50M	177	1006658	1006482	1006659	V350256906L3C002R00200779615_chr1_1006481	42	27	CCCC	aaaa
V350256906L3C002R00200997529	chr1	985664	50M	169	985833	985665	985834	V350256906L3C002R00200997529_chr1_985664	60	125	CCCA	ACAC
V350256906L3C002R00201132198	chr1	1201690	50M	143	1201833	1201691	1201834	V350256906L3C002R00201132198_chr1_1201690	0	34	ggcc	cctg
V350256906L3C002R00201404663	chr1	639350	50M	182	639532	639351	639533	V350256906L3C002R00201404663_chr1_639350	48	7	CTGA	CCTG
V350256906L3C002R00300116936	chr1	1166245	50M	189	1166434	1166246	1166435	V350256906L3C002R00300116936_chr1_1166245	68	48	AGAC	gacg
V350256906L3C002R00300411132	chr1	1102237	50M	121	1102358	1102238	1102359	V350256906L3C002R00300411132_chr1_1102237	138	259	GAGG	CGCC
V350256906L3C002R00300791485	chr1	1084647	50M	186	1084833	1084648	1084834	V350256906L3C002R00300791485_chr1_1084647	40	65	GAAG	CTGA
V350256906L3C002R00300834404	chr1	1114943	50M	167	1115110	1114944	1115111	V350256906L3C002R00300834404_chr1_1114943	63	57	CCCC	CAGT
V350256906L3C002R00300868704	chr1	436789	50M	174	436963	436790	436964	V350256906L3C002R00300868704_chr1_436789	52	0	CACA	gaga
V350256906L3C002R00301020618	chr1	342994	50M	157	343151	342995	343152	V350256906L3C002R00301020618_chr1_342994	0	117	CTCT	TGAA
V350256906L3C002R00301099849	chr1	1082805	50M	175	1082980	1082806	1082981	V350256906L3C002R00301099849_chr1_1082805	0	0	GGGG	GTCC
V350256906L3C002R00400105625	chr1	579091	50M	173	579264	579092	579265	V350256906L3C002R00400105625_chr1_579091	27	135	CTTA	AAAA
V350256906L3C002R00400430334	chr1	842239	50M	162	842401	842240	842402	V350256906L3C002R00400430334_chr1_842239	59	41	GCCA	TGCA
V350256906L3C002R00400553142	chr1	336945	50M	174	337119	336946	337120	V350256906L3C002R00400553142_chr1_336945	15	0	gcta	acaa
V350256906L3C002R00400890413	chr1	1192027	50M	183	1192210	1192028	1192211	V350256906L3C002R00400890413_chr1_1192027	30	28	ccca	ctgc
V350256906L3C002R00401374846	chr1	105024	50M	159	105183	105025	105184	V350256906L3C002R00401374846_chr1_105024	77	49	ccag	TGAG
V350256906L3C002R00500193563	chr1	700042	50M	160	700202	700043	700203	V350256906L3C002R00500193563_chr1_700042	0	0	TGAC	gccA
V350256906L3C002R00500319172	chr1	901143	50M	199	901342	901144	901343	V350256906L3C002R00500319172_chr1_901143	59	25	TGGG	CCAG
V350256906L3C002R00501286494	chr1	877583	50M	140	877723	877584	877724	V350256906L3C002R00501286494_chr1_877583	230	90	CTCA	CCTA
V350256906L3C002R00600207341	chr1	1370586	50M	156	1370742	1370587	1370743	V350256906L3C002R00600207341_chr1_1370586	9	50	TGTT	CCCC
V350256906L3C002R00600663306	chr1	776419	50M	174	776593	776420	776594	V350256906L3C002R00600663306_chr1_776419	9	33	GCTG	ACTG
V350256906L3C002R00601060918	chr1	924562	50M	174	924736	924563	924737	V350256906L3C002R00601060918_chr1_924562	50	18	GGTT	CCAA
V350256906L3C002R00601138420	chr1	1016650	50M	166	1016816	1016651	1016817	V350256906L3C002R00601138420_chr1_1016650	0	0	GGTG	CTGA
V350256906L3C002R00700286366	chr1	1137602	50M	189	1137791	1137603	1137792	V350256906L3C002R00700286366_chr1_1137602	78	83	ccca	actg
V350256906L3C002R00700367166	chr1	1222928	50M	188	1223116	1222929	1223117	V350256906L3C002R00700367166_chr1_1222928	0	0	TACA	CGGC
V350256906L3C002R00700558860	chr1	1388965	50M	157	1389122	1388966	1389123	V350256906L3C002R00700558860_chr1_1388965	63	56	tctt	cttg
V350256906L3C002R00700820506	chr1	568644	50M	172	568816	568645	568817	V350256906L3C002R00700820506_chr1_568644	28	17	TTAA	TAGG
V350256906L3C002R00701131578	chr1	1179935	50M	140	1180075	1179936	1180076	V350256906L3C002R00701131578_chr1_1179935	137	0	CCCA	CCAC
V350256906L3C002R00800450199	chr1	1241886	50M	183	1242069	1241887	1242070	V350256906L3C002R00800450199_chr1_1241886	100	37	CCTC	tgat
V350256906L3C002R00800452338	chr1	1041603	50M	179	1041782	1041604	1041783	V350256906L3C002R00800452338_chr1_1041603	61	66	ccta	caag
V350256906L3C002R00800666441	chr1	643344	50M	143	643487	643345	643488	V350256906L3C002R00800666441_chr1_643344	88	0	tctt	tcct
V350256906L3C002R00800895623	chr1	837530	50M	191	837721	837531	837722	V350256906L3C002R00800895623_chr1_837530	5	4	AGAG	AGCG
V350256906L3C002R00900976389	chr1	1233682	50M	158	1233840	1233683	1233841	V350256906L3C002R00900976389_chr1_1233682	202	44	CCAG	GGCC
V350256906L3C002R00901018634	chr1	1020858	50M	188	1021046	1020859	1021047	V350256906L3C002R00901018634_chr1_1020858	9	2	GCCA	CCAA
V350256906L3C002R00901020172	chr1	240525	50M	142	240667	240526	240668	V350256906L3C002R00901020172_chr1_240525	143	1	catg	gaga
V350256906L3C002R00901313042	chr1	1085013	50M	158	1085171	1085014	1085172	V350256906L3C002R00901313042_chr1_1085013	66	54	ccgt	CCTG
V350256906L3C002R00901397043	chr1	646615	50M	160	646775	646616	646776	V350256906L3C002R00901397043_chr1_646615	0	106	CGAA	ATTC
V350256906L3C002R01000146123	chr1	145673	50M	151	145824	145674	145825	V350256906L3C002R01000146123_chr1_145673	22	0	ctcc	gtca
V350256906L3C002R01000874266	chr1	972469	50M	162	972631	972470	972632	V350256906L3C002R01000874266_chr1_972469	61	61	GGCC	CCCA
V350256906L3C002R01000909789	chr1	260168	50M	174	260342	260169	260343	V350256906L3C002R01000909789_chr1_260168	9	36	tact	ccat
V350256906L3C002R01001158177	chr1	77288	50M	169	77457	77289	77458	V350256906L3C002R01001158177_chr1_77288	182	13	ccaa	TGCC
V350256906L3C002R01001219689	chr1	1314996	50M	168	1315164	1314997	1315165	V350256906L3C002R01001219689_chr1_1314996	10	0	ggcg	agct
V350256906L3C002R01100201784	chr1	1067952	50M	151	1068103	1067953	1068104	V350256906L3C002R01100201784_chr1_1067952	56	52	ACAA	cccc
V350256906L3C002R01100950414	chr1	237821	50M	163	237984	237822	237985	V350256906L3C002R01100950414_chr1_237821	7	47	TCCT	ggct
V350256906L3C002R01101160877	chr1	236061	50M	168	236229	236062	236230	V350256906L3C002R01101160877_chr1_236061	21	0	GTCT	TGGA
V350256906L3C002R01200303894	chr1	576773	50M	171	576944	576774	576945	V350256906L3C002R01200303894_chr1_576773	66	65	CTCC	CCTG
V350256906L3C002R01200617685	chr1	21444	50M	188	21632	21445	21633	V350256906L3C002R01200617685_chr1_21444	7	50	CCCA	CCTT
V350256906L3C002R01200634233	chr1	887118	50M	166	887284	887119	887285	V350256906L3C002R01200634233_chr1_887118	121	60	CCCA	GCCT
V350256906L3C002R01200929680	chr1	1304848	9M2D41M	177	1305025	1304849	1305026	V350256906L3C002R01200929680_chr1_1304848	109	28	AAAG	taaa
V350256906L3C002R01201028925	chr1	1031773	50M	165	1031938	1031774	1031939	V350256906L3C002R01201028925_chr1_1031773	0	41	cctg	acat
V350256906L3C002R01201178716	chr1	910843	50M	122	910965	910844	910966	V350256906L3C002R01201178716_chr1_910843	43	45	CACC	AGGC
V350256906L3C002R01300249355	chr1	1068770	50M	142	1068912	1068771	1068913	V350256906L3C002R01300249355_chr1_1068770	17	62	CAAT	CCTG
V350256906L3C002R01300323812	chr1	961306	50M	176	961482	961307	961483	V350256906L3C002R01300323812_chr1_961306	79	62	CTGC	CCAC
V350256906L3C002R01300563451	chr1	797882	50M	175	798057	797883	798058	V350256906L3C002R01300563451_chr1_797882	47	62	CCCT	CCAG
V350256906L3C002R01301302027	chr1	1112379	50M	168	1112547	1112380	1112548	V350256906L3C002R01301302027_chr1_1112379	5	61	tgtg	caca
V350256906L3C002R01301311027	chr1	123884	50M	163	124047	123885	124048	V350256906L3C002R01301311027_chr1_123884	145	0	taga	tata
V350256906L3C002R01400233027	chr1	327901	50M	188	328089	327902	328090	V350256906L3C002R01400233027_chr1_327901	157	2	GGCC	GCCA
V350256906L3C002R01400406481	chr1	400738	50M	192	400930	400739	400931	V350256906L3C002R01400406481_chr1_400738	136	0	ctgt	ttta
V350256906L3C002R01400524357	chr1	830040	50M	133	830173	830041	830174	V350256906L3C002R01400524357_chr1_830040	41	0	CTGT	TGAA
V350256906L3C002R01401254871	chr1	591066	50M	174	591240	591067	591241	V350256906L3C002R01401254871_chr1_591066	81	110	caat	gtac
V350256906L3C002R01401316708	chr1	898136	50M	165	898301	898137	898302	V350256906L3C002R01401316708_chr1_898136	34	11	ACGT	TACC
V350256906L3C002R01600046395	chr1	106590	50M	178	106768	106591	106769	V350256906L3C002R01600046395_chr1_106590	0	12	CATT	TGGA
V350256906L3C002R01600135357	chr1	1378279	50M	131	1378410	1378280	1378411	V350256906L3C002R01600135357_chr1_1378279	66	12	CAAT	cgga
V350256906L3C002R01600192704	chr1	790584	50M	170	790754	790585	790755	V350256906L3C002R01600192704_chr1_790584	71	37	CCAA	GACA
V350256906L3C002R01600260161	chr1	395048	50M	159	395207	395049	395208	V350256906L3C002R01600260161_chr1_395048	57	77	ccaa	CTGA
V350256906L3C002R01600600729	chr1	1398021	50M	165	1398186	1398022	1398187	V350256906L3C002R01600600729_chr1_1398021	0	17	TAGA	CCCA
V350256906L3C002R01601284323	chr1	535414	50M	148	535562	535415	535563	V350256906L3C002R01601284323_chr1_535414	65	31	gggt	agtc
V350256906L3C002R01700336068	chr1	683212	50M	167	683379	683213	683380	V350256906L3C002R01700336068_chr1_683212	269	102	ccct	caag
V350256906L3C002R01700738306	chr1	328616	50M	182	328798	328617	328799	V350256906L3C002R01700738306_chr1_328616	52	234	CAGG	CAGG
V350256906L3C002R01700832106	chr1	610743	50M	190	610933	610744	610934	V350256906L3C002R01700832106_chr1_610743	25	86	AATT	AGAA
V350256906L3C002R01701186377	chr1	953241	50M	159	953400	953242	953401	V350256906L3C002R01701186377_chr1_953241	0	0	acaa	aata
V350256906L3C002R01800344661	chr1	1032818	50M	178	1032996	1032819	1032997	V350256906L3C002R01800344661_chr1_1032818	0	168	ggtc	cccc
V350256906L3C002R01800365245	chr1	884409	18M9I23M	157	884566	884410	884567	V350256906L3C002R01800365245_chr1_884409	31	18	CCAG	GGCT
V350256906L3C002R01800448778	chr1	42835	50M	181	43016	42836	43017	V350256906L3C002R01800448778_chr1_42835	94	54	AAGA	TATA
V350256906L3C002R01800760184	chr1	1106734	50M	171	1106905	1106735	1106906	V350256906L3C002R01800760184_chr1_1106734	12	10	CCCA	GGTT
V350256906L3C002R01801181669	chr1	152558	50M	158	152716	152559	152717	V350256906L3C002R01801181669_chr1_152558	711	802	gaaa	tgaa
V350256906L3C002R01900230511	chr1	642289	50M	159	642448	642290	642449	V350256906L3C002R01900230511_chr1_642289	0	9	tgca	CAAT
V350256906L3C002R01900427159	chr1	725307	46M4S	224	725531	725308	725532	V350256906L3C002R01900427159_chr1_725307	0	15	gaat	attc
V350256906L3C002R01900630284	chr1	153796	50M	161	153957	153797	153958	V350256906L3C002R01900630284_chr1_153796	0	27	tggg	ccgc
V350256906L3C002R01900671447	chr1	863959	50M	181	864140	863960	864141	V350256906L3C002R01900671447_chr1_863959	59	82	CATA	CCCC
V350256906L3C002R01900994507	chr1	116857	50M	142	116999	116858	117000	V350256906L3C002R01900994507_chr1_116857	3	113	cttc	gtat
V350256906L3C002R01901070433	chr1	69612	50M	171	69783	69613	69784	V350256906L3C002R01901070433_chr1_69612	53	85	TCCT	GACA
V350256906L3C002R02000116363	chr1	666655	50M	175	666830	666656	666831	V350256906L3C002R02000116363_chr1_666655	176	1	ctaa	CCAA
V350256906L3C002R02000357807	chr1	670318	50M	164	670482	670319	670483	V350256906L3C002R02000357807_chr1_670318	15	179	GCTA	ctag
V350256906L3C002R02000560293	chr1	418103	50M	215	418318	418104	418319	V350256906L3C002R02000560293_chr1_418103	0	14	AGCG	TATT
V350256906L3C002R02000648228	chr1	724981	4S38M8S	141	725122	724982	725123	V350256906L3C002R02000648228_chr1_724981	11	147	agaa	catt
V350256906L3C002R02000820058	chr1	919736	50M	152	919888	919737	919889	V350256906L3C002R02000820058_chr1_919736	73	43	CAGC	CCCC
V350256906L3C002R02001323799	chr1	54896	50M	196	55092	54897	55093	V350256906L3C002R02001323799_chr1_54896	273	240	ccca	caaa
V350256906L3C002R02001352950	chr1	767940	50M	165	768105	767941	768106	V350256906L3C002R02001352950_chr1_767940	11	134	ctca	GAAA
V350256906L3C002R02200028164	chr1	1127757	50M	152	1127909	1127758	1127910	V350256906L3C002R02200028164_chr1_1127757	54	21	tcca	CAAC
V350256906L3C002R02200711285	chr1	84425	50M	156	84581	84426	84582	V350256906L3C002R02200711285_chr1_84425	34	38	tgtt	ctta
V350256906L3C002R02201246682	chr1	655800	50M	190	655990	655801	655991	V350256906L3C002R02201246682_chr1_655800	73	76	gagt	cgag
V350256906L3C002R02201341655	chr1	1047676	50M	165	1047841	1047677	1047842	V350256906L3C002R02201341655_chr1_1047676	0	149	tgta	GAGG
V350256906L3C002R02201395976	chr1	347560	50M	240	347800	347561	347801	V350256906L3C002R02201395976_chr1_347560	59	0	ATTA	CTTT
V350256906L3C002R02300112798	chr1	152928	50M	198	153126	152929	153127	V350256906L3C002R02300112798_chr1_152928	590	392	cctg	ggtt
V350256906L3C002R02300809125	chr1	53734	50M	166	53900	53735	53901	V350256906L3C002R02300809125_chr1_53734	194	28	GTGA	GAAA
V350256906L3C002R02300810636	chr1	768843	50M	150	768993	768844	768994	V350256906L3C002R02300810636_chr1_768843	23	68	GAAG	ctat
V350256906L3C002R02300830533	chr1	116097	50M	134	116231	116098	116232	V350256906L3C002R02300830533_chr1_116097	0	105	aaat	ACAC
V350256906L3C002R02300916035	chr1	1373078	50M	216	1373294	1373079	1373295	V350256906L3C002R02300916035_chr1_1373078	36	65	TGAG	GGTG
V350256906L3C002R02300984757	chr1	696536	50M	233	696769	696537	696770	V350256906L3C002R02300984757_chr1_696536	68	149	TACA	CTTT
V350256906L3C002R02301032186	chr1	109454	50M	180	109634	109455	109635	V350256906L3C002R02301032186_chr1_109454	268	94	GAAG	CCCT
V350256906L3C002R02301055032	chr1	154584	50M	179	154763	154585	154764	V350256906L3C002R02301055032_chr1_154584	60	26	cggc	tgaa
V350256906L3C002R02301093942	chr1	983847	50M	172	984019	983848	984020	V350256906L3C002R02301093942_chr1_983847	25	56	GCCC	acca
V350256906L3C002R02301095509	chr1	235878	50M	160	236038	235879	236039	V350256906L3C002R02301095509_chr1_235878	2	0	tact	TTAC
V350256906L3C002R02301133427	chr1	723686	50M	131	723817	723687	723818	V350256906L3C002R02301133427_chr1_723686	23	72	gcag	ttct
V350256906L3C002R02301190631	chr1	701878	50M	171	702049	701879	702050	V350256906L3C002R02301190631_chr1_701878	0	43	CAgg	cgct
V350256906L3C002R02301312135	chr1	112057	50M	185	112242	112058	112243	V350256906L3C002R02301312135_chr1_112057	19	29	CTTT	ggga
V350256906L3C002R02400027576	chr1	533445	50M	191	533636	533446	533637	V350256906L3C002R02400027576_chr1_533445	58	10	CAGC	CTGA
V350256906L3C002R02400358497	chr1	399614	50M	187	399801	399615	399802	V350256906L3C002R02400358497_chr1_399614	39	57	ctga	ccat
V350256906L3C002R02500123924	chr1	320065	50M	202	320267	320066	320268	V350256906L3C002R02500123924_chr1_320065	55	100	ccca	gcct
V350256906L3C002R02500231577	chr1	920253	50M	154	920407	920254	920408	V350256906L3C002R02500231577_chr1_920253	65	54	taac	cctg
V350256906L3C002R02500264519	chr1	755590	50M	168	755758	755591	755759	V350256906L3C002R02500264519_chr1_755590	42	2	CCCT	GCTG
V350256906L3C002R02500843396	chr1	967613	50M	157	967770	967614	967771	V350256906L3C002R02500843396_chr1_967613	42	199	GTTT	CCAC
V350256906L3C002R02501011842	chr1	683224	50M	190	683414	683225	683415	V350256906L3C002R02501011842_chr1_683224	257	67	aCTG	ccat
V350256906L3C002R02501244258	chr1	1041654	50M	191	1041845	1041655	1041846	V350256906L3C002R02501244258_chr1_1041654	10	7	atta	ttta
V350256906L3C002R02600314684	chr1	112705	50M	146	112851	112706	112852	V350256906L3C002R02600314684_chr1_112705	181	35	CCTG	TGTT
V350256906L3C002R02600479701	chr1	1043294	50M	155	1043449	1043295	1043450	V350256906L3C002R02600479701_chr1_1043294	51	19	ccaa	GCTG
V350256906L3C002R02600503849	chr1	159353	50M	140	159493	159354	159494	V350256906L3C002R02600503849_chr1_159353	185	184	TAAc	aact
V350256906L3C002R02600689400	chr1	910242	50M	150	910392	910243	910393	V350256906L3C002R02600689400_chr1_910242	32	59	CCAG	CCCT
V350256906L3C002R02600709982	chr1	1220886	50M	157	1221043	1220887	1221044	V350256906L3C002R02600709982_chr1_1220886	76	16	CTTC	GGCC
V350256906L3C002R02600868646	chr1	253080	50M	166	253246	253081	253247	V350256906L3C002R02600868646_chr1_253080	0	0	CCAG	AGTT
V350256906L3C002R02700055389	chr1	1432071	50M	134	1432205	1432072	1432206	V350256906L3C002R02700055389_chr1_1432071	70	3	CCAC	CCTT
V350256906L3C002R02700106258	chr1	427025	50M	173	427198	427026	427199	V350256906L3C002R02700106258_chr1_427025	67	89	ATGT	GCAC
V350256906L3C002R02700541696	chr1	320440	50M	153	320593	320441	320594	V350256906L3C002R02700541696_chr1_320440	209	56	CTGG	CATC
V350256906L3C002R02700848492	chr1	1066959	50M	163	1067122	1066960	1067123	V350256906L3C002R02700848492_chr1_1066959	99	38	gcta	ATGC
V350256906L3C002R02701333463	chr1	594453	50M	166	594619	594454	594620	V350256906L3C002R02701333463_chr1_594453	86	29	gCCT	taat
V350256906L3C002R02800485735	chr1	1068326	50M	171	1068497	1068327	1068498	V350256906L3C002R02800485735_chr1_1068326	28	93	tact	CACA
V350256906L3C002R02800769490	chr1	726108	8S35M7S	230	726338	726109	726339	V350256906L3C002R02800769490_chr1_726108	141	47	GAAT	attc
V350256906L3C002R02900448033	chr1	613367	50M	189	613556	613368	613557	V350256906L3C002R02900448033_chr1_613367	2	81	ccca	ctca
V350256906L3C002R02900507573	chr1	819984	50M	172	820156	819985	820157	V350256906L3C002R02900507573_chr1_819984	66	52	gcat	ggca
V350256906L3C002R02900551676	chr1	739261	50M	139	739400	739262	739401	V350256906L3C002R02900551676_chr1_739261	111	0	CCAC	CCAC
V350256906L3C002R02900765469	chr1	706773	50M	161	706934	706774	706935	V350256906L3C002R02900765469_chr1_706773	15	47	ctgt	accc
V350256906L3C002R02900982024	chr1	726178	6S44M	194	726372	726179	726373	V350256906L3C002R02900982024_chr1_726178	71	39	aaat	tttc
V350256906L3C002R03000029416	chr1	1046788	50M	156	1046944	1046789	1046945	V350256906L3C002R03000029416_chr1_1046788	45	42	actt	TCTT
V350256906L3C002R03000638162	chr1	234922	50M	159	235081	234923	235082	V350256906L3C002R03000638162_chr1_234922	51	210	ATGC	acat
V350256906L3C002R03000808494	chr1	319493	50M	170	319663	319494	319664	V350256906L3C002R03000808494_chr1_319493	63	61	aaca	tcat
V350256906L3C002R03000810355	chr1	164648	45M5S	189	164837	164649	164838	V350256906L3C002R03000810355_chr1_164648	45	26	ggcg	CATA
V350256906L3C002R03000897326	chr1	819254	50M	175	819429	819255	819430	V350256906L3C002R03000897326_chr1_819254	73	68	caga	ggca
V350256906L3C002R03000958436	chr1	993418	50M	191	993609	993419	993610	V350256906L3C002R03000958436_chr1_993418	12	12	cgat	GCCT
V350256906L3C002R03000990277	chr1	1054632	50M	192	1054824	1054633	1054825	V350256906L3C002R03000990277_chr1_1054632	60	67	AGGG	TGGC
V350256906L3C002R03001038407	chr1	172646	50M	164	172810	172647	172811	V350256906L3C002R03001038407_chr1_172646	58	59	CAGA	GCAG
V350256906L3C002R03100363493	chr1	691012	50M	172	691184	691013	691185	V350256906L3C002R03100363493_chr1_691012	33	42	aatg	GGGA
V350256906L3C002R03100394759	chr1	964465	50M	183	964648	964466	964649	V350256906L3C002R03100394759_chr1_964465	174	29	GCCA	GTTC
V350256906L3C002R03100706519	chr1	128322	50M	160	128482	128323	128483	V350256906L3C002R03100706519_chr1_128322	99	42	TATA	AAAG
V350256906L3C002R03100888253	chr1	177203	50M	190	177393	177204	177394	V350256906L3C002R03100888253_chr1_177203	260	450	ATTG	CCTT
V350256906L3C002R03200035267	chr1	364625	50M	186	364811	364626	364812	V350256906L3C002R03200035267_chr1_364625	38	40	TGTA	TAAC
V350256906L3C002R03200570023	chr1	1269445	50M	191	1269636	1269446	1269637	V350256906L3C002R03200570023_chr1_1269445	52	65	GCAC	TGGC
V350256906L3C002R03200665312	chr1	244991	50M	252	245243	244992	245244	V350256906L3C002R03200665312_chr1_244991	343	91	TAAA	TAAA
V350256906L3C002R03200855562	chr1	15849	50M	158	16007	15850	16008	V350256906L3C002R03200855562_chr1_15849	373	215	CGCA	CCCC
V350256906L3C002R03201267482	chr1	239941	50M	184	240125	239942	240126	V350256906L3C002R03201267482_chr1_239941	66	96	TCTT	gcac
V350256906L3C002R03201363674	chr1	734362	50M	166	734528	734363	734529	V350256906L3C002R03201363674_chr1_734362	46	55	ctcc	CTCT
V350256906L3C002R03300776875	chr1	1212054	50M	179	1212233	1212055	1212234	V350256906L3C002R03300776875_chr1_1212054	99	40	cacc	ccac
V350256906L3C002R03301218584	chr1	1252946	50M	158	1253104	1252947	1253105	V350256906L3C002R03301218584_chr1_1252946	39	69	ccct	GGGT
V350256906L3C002R03400024963	chr1	1053338	50M	196	1053534	1053339	1053535	V350256906L3C002R03400024963_chr1_1053338	26	59	cctg	CCCA
V350256906L3C002R03400649920	chr1	52823	50M	160	52983	52824	52984	V350256906L3C002R03400649920_chr1_52823	0	63	CCCC	AGGA
V350256906L3C002R03400655881	chr1	110086	50M	172	110258	110087	110259	V350256906L3C002R03400655881_chr1_110086	59	55	taaa	gaga
V350256906L3C002R03400735698	chr1	709375	50M	169	709544	709376	709545	V350256906L3C002R03400735698_chr1_709375	46	92	TTAA	CTCA
V350256906L3C002R03401348134	chr1	955970	50M	171	956141	955971	956142	V350256906L3C002R03401348134_chr1_955970	92	56	CCTC	CCCG
V350256906L3C002R03500737041	chr1	922985	50M	132	923117	922986	923118	V350256906L3C002R03500737041_chr1_922985	156	24	gcat	agtg
V350256906L3C002R03501202134	chr1	1083169	50M	148	1083317	1083170	1083318	V350256906L3C002R03501202134_chr1_1083169	0	23	acct	agct
V350256906L3C002R03600223042	chr1	540429	50M	187	540616	540430	540617	V350256906L3C002R03600223042_chr1_540429	58	28	gaac	cccg
V350256906L3C002R03600435254	chr1	1309615	50M	162	1309777	1309616	1309778	V350256906L3C002R03600435254_chr1_1309615	41	73	TCCA	CGGG
V350256906L3C002R03600813872	chr1	1419152	50M	147	1419299	1419153	1419300	V350256906L3C002R03600813872_chr1_1419152	2	11	gcct	CCTG
V350256906L3C002R03601328067	chr1	1401576	50M	181	1401757	1401577	1401758	V350256906L3C002R03601328067_chr1_1401576	33	109	cctg	gttt
V350256906L3C002R03601358313	chr1	829764	50M	130	829894	829765	829895	V350256906L3C002R03601358313_chr1_829764	4	65	gaga	TGTT
V350256906L3C002R03700002260	chr1	1104927	50M	179	1105106	1104928	1105107	V350256906L3C002R03700002260_chr1_1104927	0	9	GGCC	CGTG
V350256906L3C002R03700377427	chr1	114780	50M	168	114948	114781	114949	V350256906L3C002R03700377427_chr1_114780	42	101	CCCG	GGGA
V350256906L3C002R03700492749	chr1	1039567	50M	154	1039721	1039568	1039722	V350256906L3C002R03700492749_chr1_1039567	74	35	gcat	tccc
V350256906L3C002R03700647416	chr1	847706	50M	191	847897	847707	847898	V350256906L3C002R03700647416_chr1_847706	52	29	tgaa	gctg
V350256906L3C002R03701334789	chr1	727770	50M	158	727928	727771	727929	V350256906L3C002R03701334789_chr1_727770	72	62	ttta	acat
V350256906L3C002R03800600721	chr1	1184642	50M	161	1184803	1184643	1184804	V350256906L3C002R03800600721_chr1_1184642	356	225	CCCT	CAGG
V350256906L3C002R03800775811	chr1	242046	50M	182	242228	242047	242229	V350256906L3C002R03800775811_chr1_242046	20	105	AGCG	GGTC
V350256906L3C002R03800809092	chr1	1185118	50M	174	1185292	1185119	1185293	V350256906L3C002R03800809092_chr1_1185118	25	39	gatg	tgga
V350256906L3C002R03801174296	chr1	28535	50M	158	28693	28536	28694	V350256906L3C002R03801174296_chr1_28535	4	0	TGTT	GAAA
V350256906L3C002R03801295567	chr1	1135290	50M	183	1135473	1135291	1135474	V350256906L3C002R03801295567_chr1_1135290	69	32	AAAC	CTGT
V350256906L3C002R03801381891	chr1	413810	50M	189	413999	413811	414000	V350256906L3C002R03801381891_chr1_413810	6	122	TTTG	tttt
V350256906L3C002R03900215430	chr1	1396334	50M	163	1396497	1396335	1396498	V350256906L3C002R03900215430_chr1_1396334	46	85	CCTC	TGAG
V350256906L3C002R03900221769	chr1	468341	50M	137	468478	468342	468479	V350256906L3C002R03900221769_chr1_468341	36	47	cttc	attg
V350256906L3C002R03900320057	chr1	1046401	50M	158	1046559	1046402	1046560	V350256906L3C002R03900320057_chr1_1046401	39	90	tgtc	TAAA
V350256906L3C002R03900735723	chr1	674372	50M	168	674540	674373	674541	V350256906L3C002R03900735723_chr1_674372	64	66	ctac	CCAG
V350256906L3C002R03900852076	chr1	1174199	50M	152	1174351	1174200	1174352	V350256906L3C002R03900852076_chr1_1174199	46	69	CCCC	TGCA
V350256906L3C002R03901260810	chr1	813784	50M	160	813944	813785	813945	V350256906L3C002R03901260810_chr1_813784	221	61	CATC	GGTA
V350256906L3C002R04000315970	chr1	418073	50M	180	418253	418074	418254	V350256906L3C002R04000315970_chr1_418073	25	12	CATC	AGCC
V350256906L3C002R04000888096	chr1	1070086	50M	142	1070228	1070087	1070229	V350256906L3C002R04000888096_chr1_1070086	73	22	CTCC	GCCA
V350256906L3C002R04001189226	chr1	651156	50M	190	651346	651157	651347	V350256906L3C002R04001189226_chr1_651156	38	69	gagc	CAAG
V350256906L3C002R04001308975	chr1	11959	50M	216	12175	11960	12176	V350256906L3C002R04001308975_chr1_11959	42	52	CCGG	TCCC
V350256906L3C002R04100084421	chr1	1386877	50M	170	1387047	1386878	1387048	V350256906L3C002R04100084421_chr1_1386877	21	122	ccac	AGCT
V350256906L3C002R04100314354	chr1	1067702	50M	162	1067864	1067703	1067865	V350256906L3C002R04100314354_chr1_1067702	34	14	CCAG	CAAG
V350256906L3C002R04100397401	chr1	529540	50M	186	529726	529541	529727	V350256906L3C002R04100397401_chr1_529540	163	0	TGGA	CACA
V350256906L3C002R04100721269	chr1	164667	50M	183	164850	164668	164851	V350256906L3C002R04100721269_chr1_164667	26	13	ccat	TTAT
V350256906L3C002R04100985528	chr1	1208542	50M	177	1208719	1208543	1208720	V350256906L3C002R04100985528_chr1_1208542	14	15	GTTC	GCTG
V350256906L3C002R04101373590	chr1	1409533	50M	159	1409692	1409534	1409693	V350256906L3C002R04101373590_chr1_1409533	46	39	ggga	ggct
V350256906L3C002R04200191008	chr1	650925	50M	193	651118	650926	651119	V350256906L3C002R04200191008_chr1_650925	38	76	AAGA	acct
V350256906L3C002R04200230844	chr1	819497	50M	174	819671	819498	819672	V350256906L3C002R04200230844_chr1_819497	1	14	cttt	gagc
V350256906L3C002R04200375316	chr1	1334500	50M	223	1334723	1334501	1334724	V350256906L3C002R04200375316_chr1_1334500	55	41	GCGT	TGAG
V350256906L3C002R04200568398	chr1	29566	50M	163	29729	29567	29730	V350256906L3C002R04200568398_chr1_29566	12	21	CCCA	CCCC
V350256906L3C002R04201071535	chr1	432193	50M	170	432363	432194	432364	V350256906L3C002R04201071535_chr1_432193	179	9	GGCT	agcc
V350256906L3C002R04300380897	chr1	1019667	50M	226	1019893	1019668	1019894	V350256906L3C002R04300380897_chr1_1019667	77	42	ACAG	CCAC
V350256906L3C002R04300429446	chr1	1287588	50M	191	1287779	1287589	1287780	V350256906L3C002R04300429446_chr1_1287588	44	29	CCCA	CAGC
V350256906L3C002R04300439698	chr1	127097	50M	176	127273	127098	127274	V350256906L3C002R04300439698_chr1_127097	0	10	ACCT	CATA
V350256906L3C002R04300521194	chr1	948190	50M	178	948368	948191	948369	V350256906L3C002R04300521194_chr1_948190	10	38	tgag	gcac
V350256906L3C002R04300745363	chr1	794075	50M	174	794249	794076	794250	V350256906L3C002R04300745363_chr1_794075	48	86	CAGG	CTCT
V350256906L3C002R04300977762	chr1	613861	50M	197	614058	613862	614059	V350256906L3C002R04300977762_chr1_613861	43	39	cacg	ggat
V350256906L3C002R04300988383	chr1	1237635	50M	140	1237775	1237636	1237776	V350256906L3C002R04300988383_chr1_1237635	31	171	TGTC	CCCG
V350256906L3C002R04301141970	chr1	1134720	50M	218	1134938	1134721	1134939	V350256906L3C002R04301141970_chr1_1134720	66	64	GGAG	GGCA
V350256906L3C002R04400609924	chr1	660188	50M	186	660374	660189	660375	V350256906L3C002R04400609924_chr1_660188	189	3	GCCT	ATAA
V350256906L3C002R04401171340	chr1	1190789	50M	132	1190921	1190790	1190922	V350256906L3C002R04401171340_chr1_1190789	52	39	CTGG	CCTG
V350256906L3C002R04401278081	chr1	917524	50M	202	917726	917525	917727	V350256906L3C002R04401278081_chr1_917524	36	18	CCTC	GGAA
V350256906L3C002R04401359229	chr1	237573	50M	160	237733	237574	237734	V350256906L3C002R04401359229_chr1_237573	37	59	GGTT	AAAC
V350256906L3C002R04500130100	chr1	724005	50M	176	724181	724006	724182	V350256906L3C002R04500130100_chr1_724005	71	59	CCCA	attc
V350256906L3C002R04500727344	chr1	783165	50M	181	783346	783166	783347	V350256906L3C002R04500727344_chr1_783165	17	10	CATG	CTGG
V350256906L3C002R04500750667	chr1	326793	50M	159	326952	326794	326953	V350256906L3C002R04500750667_chr1_326793	0	0	CCCT	GGCT
V350256906L3C002R04500906442	chr1	136813	50M	179	136992	136814	136993	V350256906L3C002R04500906442_chr1_136813	331	168	AGCG	GCCC
V350256906L3C002R04500913376	chr1	778443	50M	197	778640	778444	778641	V350256906L3C002R04500913376_chr1_778443	91	73	CGAG	CTTC
V350256906L3C002R04501253205	chr1	616825	50M	176	617001	616826	617002	V350256906L3C002R04501253205_chr1_616825	73	235	atcc	catt
V350256906L3C002R04600082869	chr1	436074	50M	162	436236	436075	436237	V350256906L3C002R04600082869_chr1_436074	57	60	tgtg	TGAG
V350256906L3C002R04600090860	chr1	243678	50M	178	243856	243679	243857	V350256906L3C002R04600090860_chr1_243678	0	6	GCCA	CACT
V350256906L3C002R04600150990	chr1	1179830	50M	160	1179990	1179831	1179991	V350256906L3C002R04600150990_chr1_1179830	128	82	CCAT	CCTG
V350256906L3C002R04600223770	chr1	534033	50M	149	534182	534034	534183	V350256906L3C002R04600223770_chr1_534033	110	11	CGAC	ccag
V350256906L3C002R04600389653	chr1	351375	50M	169	351544	351376	351545	V350256906L3C002R04600389653_chr1_351375	131	0	Tatt	CATA
V350256906L3C002R04600395630	chr1	1302943	41M1I8M	198	1303141	1302944	1303142	V350256906L3C002R04600395630_chr1_1302943	0	0	ggat	gggg
V350256906L3C002R04600493050	chr1	1264832	50M	164	1264996	1264833	1264997	V350256906L3C002R04600493050_chr1_1264832	64	61	CCCT	TGCA
V350256906L3C002R04600591715	chr1	110829	50M	193	111022	110830	111023	V350256906L3C002R04600591715_chr1_110829	3	17	attg	catc
V350256906L3C002R04600675708	chr1	1345333	50M	162	1345495	1345334	1345496	V350256906L3C002R04600675708_chr1_1345333	0	139	ctct	ccct
V350256906L3C002R04600798243	chr1	1083502	50M	153	1083655	1083503	1083656	V350256906L3C002R04600798243_chr1_1083502	36	63	cctg	CAGG
V350256906L3C002R04700074576	chr1	1150256	50M	224	1150480	1150257	1150481	V350256906L3C002R04700074576_chr1_1150256	27	66	AGCC	CGCA
V350256906L3C002R04700316270	chr1	1039893	50M	168	1040061	1039894	1040062	V350256906L3C002R04700316270_chr1_1039893	8	0	tact	tgat
V350256906L3C002R04700472770	chr1	1317706	48M2S	155	1317861	1317707	1317862	V350256906L3C002R04700472770_chr1_1317706	136	291	CAAC	GGAA
V350256906L3C002R04700609516	chr1	725401	50M	162	725563	725402	725564	V350256906L3C002R04700609516_chr1_725401	64	47	cgaa	cgag
V350256906L3C002R04700841038	chr1	838917	50M	151	839068	838918	839069	V350256906L3C002R04700841038_chr1_838917	45	22	gagc	ctgt
V350256906L3C002R04701233226	chr1	1230867	50M	158	1231025	1230868	1231026	V350256906L3C002R04701233226_chr1_1230867	37	20	GAAG	CCTC
V350256906L3C002R04800240288	chr1	981727	50M	254	981981	981728	981982	V350256906L3C002R04800240288_chr1_981727	72	0	ACCT	GCAC
V350256906L3C002R04800385102	chr1	737755	50M	194	737949	737756	737950	V350256906L3C002R04800385102_chr1_737755	1	171	CTAC	ccag
V350256906L3C002R04800619389	chr1	1170233	50M	164	1170397	1170234	1170398	V350256906L3C002R04800619389_chr1_1170233	0	0	ccac	CTTA
V350256906L3C002R04801068371	chr1	905961	50M	186	906147	905962	906148	V350256906L3C002R04801068371_chr1_905961	41	77	TCGG	CCAA
V350256906L3C002R04801345480	chr1	936140	50M	243	936383	936141	936384	V350256906L3C002R04801345480_chr1_936140	7	52	GAGT	TTTT
V350256906L3C002R04900051675	chr1	1083060	50M	182	1083242	1083061	1083243	V350256906L3C002R04900051675_chr1_1083060	59	60	CTCA	ccag
V350256906L3C002R04900093368	chr1	540328	50M	126	540454	540329	540455	V350256906L3C002R04900093368_chr1_540328	0	83	ctca	ccct
V350256906L3C002R04900317298	chr1	629623	50M	169	629792	629624	629793	V350256906L3C002R04900317298_chr1_629623	18	38	CCTT	TTTA
V350256906L3C002R04900403689	chr1	34679	50M	117	34796	34680	34797	V350256906L3C002R04900403689_chr1_34679	37	154	cagg	ccct
V350256906L3C002R04900772079	chr1	1317532	50M	212	1317744	1317533	1317745	V350256906L3C002R04900772079_chr1_1317532	0	174	ccct	GAAG
V350256906L3C002R05000117396	chr1	650537	50M	175	650712	650538	650713	V350256906L3C002R05000117396_chr1_650537	98	0	cttt	tgaa
V350256906L3C002R05000375824	chr1	1116350	50M	184	1116534	1116351	1116535	V350256906L3C002R05000375824_chr1_1116350	45	67	gccc	CGAG
V350256906L3C002R05000457005	chr1	808796	50M	176	808972	808797	808973	V350256906L3C002R05000457005_chr1_808796	54	88	GCTG	TGAG
V350256906L3C002R05000498495	chr1	1245548	50M	137	1245685	1245549	1245686	V350256906L3C002R05000498495_chr1_1245548	33	68	CCAG	CCCC
V350256906L3C002R05000558791	chr1	599916	50M	174	600090	599917	600091	V350256906L3C002R05000558791_chr1_599916	35	58	ccct	ccag
V350256906L3C002R05000881268	chr1	618932	50M	176	619108	618933	619109	V350256906L3C002R05000881268_chr1_618932	0	19	acaa	tgac
V350256906L3C002R05000916622	chr1	808175	50M	177	808352	808176	808353	V350256906L3C002R05000916622_chr1_808175	75	60	ACTT	CGCT
V350256906L3C002R05001265678	chr1	1299028	50M	184	1299212	1299029	1299213	V350256906L3C002R05001265678_chr1_1299028	17	22	tgga	ggag
V350256906L3C002R05001319305	chr1	913693	50M	175	913868	913694	913869	V350256906L3C002R05001319305_chr1_913693	117	292	GGAC	CCCA
V350256906L3C002R05100004140	chr1	774155	50M	174	774329	774156	774330	V350256906L3C002R05100004140_chr1_774155	53	79	agaa	aaat
V350256906L3C002R05100020648	chr1	1053186	50M	180	1053366	1053187	1053367	V350256906L3C002R05100020648_chr1_1053186	24	54	cact	ccag
V350256906L3C002R05100175168	chr1	1394142	50M	163	1394305	1394143	1394306	V350256906L3C002R05100175168_chr1_1394142	0	14	gccc	acat
V350256906L3C002R05100230615	chr1	372539	50M	167	372706	372540	372707	V350256906L3C002R05100230615_chr1_372539	66	233	tgag	caat
V350256906L3C002R05100366641	chr1	1235586	50M	175	1235761	1235587	1235762	V350256906L3C002R05100366641_chr1_1235586	31	39	CCAG	CCAG
V350256906L3C002R05100428366	chr1	852544	50M	212	852756	852545	852757	V350256906L3C002R05100428366_chr1_852544	4	120	CACC	GGCA
V350256906L3C002R05100523206	chr1	737119	50M	235	737354	737120	737355	V350256906L3C002R05100523206_chr1_737119	144	142	CTGG	CCAG
V350256906L3C002R05100554466	chr1	879523	50M	194	879717	879524	879718	V350256906L3C002R05100554466_chr1_879523	109	60	CTCT	GGCT
V350256906L3C002R05101253444	chr1	441054	50M	143	441197	441055	441198	V350256906L3C002R05101253444_chr1_441054	32	19	CTGC	CAGC
V350256906L3C002R05101255708	chr1	241106	50M	159	241265	241107	241266	V350256906L3C002R05101255708_chr1_241106	58	59	ccca	cgtg
V350256906L3C002R05200061704	chr1	393234	50M	183	393417	393235	393418	V350256906L3C002R05200061704_chr1_393234	75	69	AAGG	tgat
V350256906L3C002R05200579893	chr1	619624	50M	179	619803	619625	619804	V350256906L3C002R05200579893_chr1_619624	17	13	tatg	cctt
V350256906L3C002R05200653426	chr1	1014900	50M	184	1015084	1014901	1015085	V350256906L3C002R05200653426_chr1_1014900	54	53	CCCT	GGGG
V350256906L3C002R05200773335	chr1	241507	50M	242	241749	241508	241750	V350256906L3C002R05200773335_chr1_241507	8	15	GAAT	GGTT
V350256906L3C002R05201275383	chr1	574524	50M	205	574729	574525	574730	V350256906L3C002R05201275383_chr1_574524	31	57	CTCA	catt
V350256906L3C002R05300675501	chr1	1344977	50M	167	1345144	1344978	1345145	V350256906L3C002R05300675501_chr1_1344977	44	7	gcca	CCAA
V350256906L3C002R05300739807	chr1	1189861	50M	189	1190050	1189862	1190051	V350256906L3C002R05300739807_chr1_1189861	46	51	AGGG	CTCA
V350256906L3C002R05300791902	chr1	56327	50M	175	56502	56328	56503	V350256906L3C002R05300791902_chr1_56327	8	6	ACTT	CTAC
V350256906L3C002R05301014285	chr1	904814	50M	161	904975	904815	904976	V350256906L3C002R05301014285_chr1_904814	64	52	tatt	taca
V350256906L3C002R05301229912	chr1	71996	50M	174	72170	71997	72171	V350256906L3C002R05301229912_chr1_71996	61	25	CCTG	AGAT
V350256906L3C002R05301381983	chr1	1087783	50M	162	1087945	1087784	1087946	V350256906L3C002R05301381983_chr1_1087783	1	11	CTCC	CCTG
V350256906L3C002R05400022223	chr1	747002	50M	167	747169	747003	747170	V350256906L3C002R05400022223_chr1_747002	170	6	ACCG	CCCA
V350256906L3C002R05500078864	chr1	685142	50M	162	685304	685143	685305	V350256906L3C002R05500078864_chr1_685142	50	72	agat	cctt
V350256906L3C002R05500534140	chr1	1126379	50M	172	1126551	1126380	1126552	V350256906L3C002R05500534140_chr1_1126379	116	1	ttgt	gcaa
V350256906L3C002R05500644893	chr1	254633	50M	168	254801	254634	254802	V350256906L3C002R05500644893_chr1_254633	32	100	gaaa	gcct
V350256906L3C002R05500763601	chr1	234396	50M	227	234623	234397	234624	V350256906L3C002R05500763601_chr1_234396	47	0	TAAG	ggtc
V350256906L3C002R05500830348	chr1	1393521	50M	146	1393667	1393522	1393668	V350256906L3C002R05500830348_chr1_1393521	74	128	gata	CTGT
V350256906L3C002R05500864062	chr1	1186990	50M	177	1187167	1186991	1187168	V350256906L3C002R05500864062_chr1_1186990	34	38	ccca	caaa
V350256906L3C002R05501051983	chr1	14749	50M	157	14906	14750	14907	V350256906L3C002R05501051983_chr1_14749	156	268	GCAG	CCTG
V350256906L3C002R05501218401	chr1	23449	50M	158	23607	23450	23608	V350256906L3C002R05501218401_chr1_23449	144	192	CCCA	TGCC
V350256906L3C002R05501256559	chr1	1282637	50M	142	1282779	1282638	1282780	V350256906L3C002R05501256559_chr1_1282637	6	25	CCAA	AGCA
V350256906L3C002R05600130115	chr1	698902	50M	153	699055	698903	699056	V350256906L3C002R05600130115_chr1_698902	34	18	TAAG	TGAG
V350256906L3C002R05600167457	chr1	1323926	50M	174	1324100	1323927	1324101	V350256906L3C002R05600167457_chr1_1323926	5	50	CCAA	ggat
V350256906L3C002R05600542000	chr1	1152317	50M	152	1152469	1152318	1152470	V350256906L3C002R05600542000_chr1_1152317	82	33	TAAA	ATTA
V350256906L3C002R05600817680	chr1	1351276	50M	164	1351440	1351277	1351441	V350256906L3C002R05600817680_chr1_1351276	135	0	tggg	cccc
V350256906L3C002R05600869550	chr1	1178091	50M	167	1178258	1178092	1178259	V350256906L3C002R05600869550_chr1_1178091	40	59	CCCA	CAGG
V350256906L3C002R05600996023	chr1	1177122	50M	167	1177289	1177123	1177290	V350256906L3C002R05600996023_chr1_1177122	41	69	GGTG	GCAG
V350256906L3C002R05601355498	chr1	604014	50M	171	604185	604015	604186	V350256906L3C002R05601355498_chr1_604014	271	100	tcag	ccac
V350256906L3C002R05700003782	chr1	388202	50M	185	388387	388203	388388	V350256906L3C002R05700003782_chr1_388202	286	153	ccca	gtag
V350256906L3C002R05700429248	chr1	1174361	50M	170	1174531	1174362	1174532	V350256906L3C002R05700429248_chr1_1174361	61	58	CACA	GGTG
V350256906L3C002R05800119896	chr1	1009067	50M	185	1009252	1009068	1009253	V350256906L3C002R05800119896_chr1_1009067	70	59	CAGT	GGGG
V350256906L3C002R05800191132	chr1	124952	50M	144	125096	124953	125097	V350256906L3C002R05800191132_chr1_124952	102	0	CCAC	GGTC
V350256906L3C002R05800539336	chr1	824699	50M	205	824904	824700	824905	V350256906L3C002R05800539336_chr1_824699	62	126	ctgt	GGCA
V350256906L3C002R05800585835	chr1	812845	50M	180	813025	812846	813026	V350256906L3C002R05800585835_chr1_812845	0	28	GCAG	ACTG
V350256906L3C002R05900261926	chr1	1146516	50M	259	1146775	1146517	1146776	V350256906L3C002R05900261926_chr1_1146516	114	50	CCCT	TGCC
V350256906L3C002R05900759911	chr1	141939	50M	170	142109	141940	142110	V350256906L3C002R05900759911_chr1_141939	166	38	agac	tcct
V350256906L3C002R05901359136	chr1	728331	50M	195	728526	728332	728527	V350256906L3C002R05901359136_chr1_728331	38	233	cacc	ggaa
V350256906L3C002R06000078334	chr1	703501	50M	153	703654	703502	703655	V350256906L3C002R06000078334_chr1_703501	68	22	gctg	TGCA
V350256906L3C002R06000292383	chr1	1317814	50M	221	1318035	1317815	1318036	V350256906L3C002R06000292383_chr1_1317814	244	196	ACCC	CTGG
V350256906L3C002R06000394607	chr1	47131	50M	104	47235	47132	47236	V350256906L3C002R06000394607_chr1_47131	0	0	CAAC	GTTG
V350256906L3C002R06000849245	chr1	692881	50M	192	693073	692882	693074	V350256906L3C002R06000849245_chr1_692881	80	72	ggct	cagg
V350256906L3C002R06001079455	chr1	729183	50M	169	729352	729184	729353	V350256906L3C002R06001079455_chr1_729183	0	50	agtg	tgga
V350256906L3C002R06001139414	chr1	831580	50M	162	831742	831581	831743	V350256906L3C002R06001139414_chr1_831580	0	102	cttt	ctcc
V350256906L3C002R06001152203	chr1	249469	50M	140	249609	249470	249610	V350256906L3C002R06001152203_chr1_249469	60	46	ggct	aaac
V350256906L3C002R06001335652	chr1	930622	50M	183	930805	930623	930806	V350256906L3C002R06001335652_chr1_930622	65	31	ctcg	aatc
V350256906L3C002R06100178246	chr1	1233221	50M	154	1233375	1233222	1233376	V350256906L3C002R06100178246_chr1_1233221	49	42	GGGC	GGGT
V350256906L3C002R06100284756	chr1	20520	50M	137	20657	20521	20658	V350256906L3C002R06100284756_chr1_20520	8	58	ACTG	gttt
V350256906L3C002R06100297843	chr1	802753	50M	169	802922	802754	802923	V350256906L3C002R06100297843_chr1_802753	62	31	TGGG	GTGA
V350256906L3C002R06100399829	chr1	698718	50M	163	698881	698719	698882	V350256906L3C002R06100399829_chr1_698718	30	13	CCCA	TGAG
V350256906L3C002R06100609574	chr1	902549	50M	177	902726	902550	902727	V350256906L3C002R06100609574_chr1_902549	33	20	CGAG	CGGA
V350256906L3C002R06101234675	chr1	1351275	50M	165	1351440	1351276	1351441	V350256906L3C002R06101234675_chr1_1351275	136	0	ttgg	cccc
V350256906L3C002R06101284989	chr1	949573	50M	170	949743	949574	949744	V350256906L3C002R06101284989_chr1_949573	32	30	CCTG	CCTC
V350256906L3C002R06200259836	chr1	529302	50M	194	529496	529303	529497	V350256906L3C002R06200259836_chr1_529302	5	119	Tatc	CACA
V350256906L3C002R06200844253	chr1	883172	50M	174	883346	883173	883347	V350256906L3C002R06200844253_chr1_883172	37	41	GGGG	GGGG
V350256906L3C002R06201094916	chr1	463037	50M	175	463212	463038	463213	V350256906L3C002R06201094916_chr1_463037	89	247	actg	gcac
V350256906L3C002R06201199032	chr1	1390982	50M	200	1391182	1390983	1391183	V350256906L3C002R06201199032_chr1_1390982	36	23	TGGT	TCCA
V350256906L3C002R06201338462	chr1	673145	50M	163	673308	673146	673309	V350256906L3C002R06201338462_chr1_673145	0	44	ACCA	ccca
V350256906L3C002R06300003084	chr1	42827	50M	197	43024	42828	43025	V350256906L3C002R06300003084_chr1_42827	102	60	ATTT	GCCA
V350256906L3C002R06300020492	chr1	725308	39M11S	233	725541	725309	725542	V350256906L3C002R06300020492_chr1_725308	0	25	aatg	attc
V350256906L3C002R06300099893	chr1	1231218	50M	181	1231399	1231219	1231400	V350256906L3C002R06300099893_chr1_1231218	37	14	CCCT	CCCG
V350256906L3C002R06300931558	chr1	96806	50M	164	96970	96807	96971	V350256906L3C002R06300931558_chr1_96806	0	39	CGGG	CTTT
V350256906L3C002R06400016259	chr1	805770	50M	137	805907	805771	805908	V350256906L3C002R06400016259_chr1_805770	6	43	CCCA	CCAA
V350256906L3C002R06400070630	chr1	1353624	50M	168	1353792	1353625	1353793	V350256906L3C002R06400070630_chr1_1353624	32	57	cgct	ctga
V350256906L3C002R06400255087	chr1	344974	50M	171	345145	344975	345146	V350256906L3C002R06400255087_chr1_344974	77	56	tgta	aaaa
V350256906L3C002R06400282670	chr1	661816	50M	179	661995	661817	661996	V350256906L3C002R06400282670_chr1_661816	154	333	GGCC	ATGA
V350256906L3C002R06400458852	chr1	978436	50M	182	978618	978437	978619	V350256906L3C002R06400458852_chr1_978436	48	79	CTCG	TGGG
V350256906L3C002R06400605215	chr1	652463	50M	172	652635	652464	652636	V350256906L3C002R06400605215_chr1_652463	30	67	aatg	ctct
V350256906L3C002R06400817148	chr1	1269073	50M	182	1269255	1269074	1269256	V350256906L3C002R06400817148_chr1_1269073	59	82	CCCA	CGGC
V350256906L3C002R06500248563	chr1	232130	50M	160	232290	232131	232291	V350256906L3C002R06500248563_chr1_232130	55	47	tgac	tatt
V350256906L3C002R06600198785	chr1	621446	50M	169	621615	621447	621616	V350256906L3C002R06600198785_chr1_621446	62	54	ACTG	TGCC
V350256906L3C002R06600527833	chr1	804016	50M	187	804203	804017	804204	V350256906L3C002R06600527833_chr1_804016	29	44	TGGA	TATT
V350256906L3C002R06600706694	chr1	1321827	50M	171	1321998	1321828	1321999	V350256906L3C002R06600706694_chr1_1321827	41	5	CACA	TCTG
V350256906L3C002R06600896821	chr1	84383	50M	162	84545	84384	84546	V350256906L3C002R06600896821_chr1_84383	76	40	tgaa	gcct
V350256906L3C002R06601058927	chr1	1426851	50M	180	1427031	1426852	1427032	V350256906L3C002R06601058927_chr1_1426851	46	56	caat	CACA
V350256906L3C002R06601131342	chr1	689227	50M	170	689397	689228	689398	V350256906L3C002R06601131342_chr1_689227	122	0	cccc	ggcc
V350256906L3C002R06601157918	chr1	1372953	50M	205	1373158	1372954	1373159	V350256906L3C002R06601157918_chr1_1372953	54	36	CCCA	CCCG
V350256906L3C002R06700415430	chr1	979459	50M	106	979565	979460	979566	V350256906L3C002R06700415430_chr1_979459	87	127	CCTG	CCAC
V350256906L3C002R06700429523	chr1	337857	50M	176	338033	337858	338034	V350256906L3C002R06700429523_chr1_337857	39	28	ACAG	GGAA
V350256906L3C002R06700940183	chr1	1317646	50M	159	1317805	1317647	1317806	V350256906L3C002R06700940183_chr1_1317646	76	235	tcca	TGGA
V350256906L3C002R06701218928	chr1	125813	50M	177	125990	125814	125991	V350256906L3C002R06701218928_chr1_125813	142	0	TATG	AACA
V350256906L3C002R06701220511	chr1	1185825	50M	142	1185967	1185826	1185968	V350256906L3C002R06701220511_chr1_1185825	37	44	gctc	ataa
V350256906L3C002R06800018202	chr1	464404	50M	142	464546	464405	464547	V350256906L3C002R06800018202_chr1_464404	175	33	tggt	actg
V350256906L3C002R06800695244	chr1	1035186	50M	152	1035338	1035187	1035339	V350256906L3C002R06800695244_chr1_1035186	38	78	acta	TTAA
V350256906L3C002R06801125007	chr1	252310	50M	168	252478	252311	252479	V350256906L3C002R06801125007_chr1_252310	0	112	AAAA	TTTA
V350256906L3C002R06801141516	chr1	100637	50M	143	100780	100638	100781	V350256906L3C002R06801141516_chr1_100637	119	0	ACTG	CTTT
V350256906L3C002R06900211900	chr1	723324	50M	175	723499	723325	723500	V350256906L3C002R06900211900_chr1_723324	29	41	CCAA	ctgg
V350256906L3C002R06900250627	chr1	350558	50M	167	350725	350559	350726	V350256906L3C002R06900250627_chr1_350558	19	26	ccaa	CTCA
V350256906L3C002R06900424813	chr1	661011	50M	154	661165	661012	661166	V350256906L3C002R06900424813_chr1_661011	149	0	CCTG	GGCA
V350256906L3C002R06900736779	chr1	235939	50M	163	236102	235940	236103	V350256906L3C002R06900736779_chr1_235939	63	62	ggct	AAGC
V350256906L3C002R06901056658	chr1	604264	50M	187	604451	604265	604452	V350256906L3C002R06901056658_chr1_604264	21	0	catg	gaga
V350256906L3C002R06901404421	chr1	1427006	50M	179	1427185	1427007	1427186	V350256906L3C002R06901404421_chr1_1427006	68	55	CTCT	ggac
V350256906L3C002R07000046129	chr1	1246426	50M	188	1246614	1246427	1246615	V350256906L3C002R07000046129_chr1_1246426	65	60	CAAG	CCCA
V350256906L3C002R07000204119	chr1	556328	50M	165	556493	556329	556494	V350256906L3C002R07000204119_chr1_556328	13	34	ccag	TTGA
V350256906L3C002R07000363315	chr1	795835	50M	189	796024	795836	796025	V350256906L3C002R07000363315_chr1_795835	58	107	ccca	ATAG
V350256906L3C002R07000456058	chr1	1226428	50M	146	1226574	1226429	1226575	V350256906L3C002R07000456058_chr1_1226428	37	0	CCTC	GCCA
V350256906L3C002R07000712717	chr1	76874	50M	189	77063	76875	77064	V350256906L3C002R07000712717_chr1_76874	60	76	tcat	gctg
V350256906L3C002R07000831056	chr1	1052156	50M	169	1052325	1052157	1052326	V350256906L3C002R07000831056_chr1_1052156	6	102	CAGG	CCTT
V350256906L3C002R07001204589	chr1	1174980	50M	170	1175150	1174981	1175151	V350256906L3C002R07001204589_chr1_1174980	0	18	CCTG	CAGC
V350256906L3C002R07001390205	chr1	1106086	50M	178	1106264	1106087	1106265	V350256906L3C002R07001390205_chr1_1106086	256	78	CCCT	CCAC
V350256906L3C002R07100206106	chr1	926116	50M	161	926277	926117	926278	V350256906L3C002R07100206106_chr1_926116	30	0	caag	ccca
V350256906L3C002R07100338177	chr1	579560	50M	167	579727	579561	579728	V350256906L3C002R07100338177_chr1_579560	10	130	ccca	TGCA
V350256906L3C002R07100371681	chr1	649941	50M	147	650088	649942	650089	V350256906L3C002R07100371681_chr1_649941	43	0	TCAG	caat
V350256906L3C002R07100396737	chr1	701899	50M	170	702069	701900	702070	V350256906L3C002R07100396737_chr1_701899	1	63	cacc	cctg
V350256906L3C002R07100874940	chr1	593540	50M	178	593718	593541	593719	V350256906L3C002R07100874940_chr1_593540	4	11	ATAA	CACA
V350256906L3C002R07100967883	chr1	609364	50M	189	609553	609365	609554	V350256906L3C002R07100967883_chr1_609364	84	69	ggac	tctt
V350256906L3C002R07101317230	chr1	258267	50M	175	258442	258268	258443	V350256906L3C002R07101317230_chr1_258267	18	45	gaat	cctt
V350256906L3C002R07200241325	chr1	546877	50M	149	547026	546878	547027	V350256906L3C002R07200241325_chr1_546877	58	207	gttc	ctca
V350256906L3C002R07200372271	chr1	931806	50M	140	931946	931807	931947	V350256906L3C002R07200372271_chr1_931806	118	195	CGTC	CCCA
V350256906L3C002R07200776675	chr1	969246	50M	169	969415	969247	969416	V350256906L3C002R07200776675_chr1_969246	60	57	CTTT	CCCT
V350256906L3C002R07201241153	chr1	1262240	50M	128	1262368	1262241	1262369	V350256906L3C002R07201241153_chr1_1262240	12	0	CCCC	TCTT
V350256906L3C002R07201250133	chr1	1085231	50M	171	1085402	1085232	1085403	V350256906L3C002R07201250133_chr1_1085231	63	81	CCCT	CCTG
V350256906L3C002R07201324737	chr1	372887	50M	173	373060	372888	373061	V350256906L3C002R07201324737_chr1_372887	223	50	ggat	taca
V350256906L3C003R00100501916	chr1	1006980	50M	164	1007144	1006981	1007145	V350256906L3C003R00100501916_chr1_1006980	16	42	TGTC	CCCC
V350256906L3C003R00100716575	chr1	173730	50M	153	173883	173731	173884	V350256906L3C003R00100716575_chr1_173730	63	37	CATG	ACCA
V350256906L3C003R00100750600	chr1	326081	50M	190	326271	326082	326272	V350256906L3C003R00100750600_chr1_326081	40	46	GGCC	AGAG
V350256906L3C003R00100831341	chr1	1359201	50M	154	1359355	1359202	1359356	V350256906L3C003R00100831341_chr1_1359201	64	66	gccc	tctt
V350256906L3C003R00101310686	chr1	322332	50M	171	322503	322333	322504	V350256906L3C003R00101310686_chr1_322332	0	3	ACAT	ccaa
V350256906L3C003R00101361910	chr1	957508	50M	165	957673	957509	957674	V350256906L3C003R00101361910_chr1_957508	33	189	AACA	CCAA
V350256906L3C003R00200514832	chr1	1306357	50M	142	1306499	1306358	1306500	V350256906L3C003R00200514832_chr1_1306357	44	18	CCCC	ACCT
V350256906L3C003R00200548033	chr1	1062326	50M	172	1062498	1062327	1062499	V350256906L3C003R00200548033_chr1_1062326	0	5	Cttt	gggc
V350256906L3C003R00200601636	chr1	1298083	50M	164	1298247	1298084	1298248	V350256906L3C003R00200601636_chr1_1298083	86	86	cccg	tgtg
V350256906L3C003R00200870666	chr1	725988	16S32M2S	190	726178	725989	726179	V350256906L3C003R00200870666_chr1_725988	63	71	aatg	gagt
V350256906L3C003R00201302718	chr1	725316	12S30M8S	108	725424	725317	725425	V350256906L3C003R00201302718_chr1_725316	0	64	ggaa	tcca
V350256906L3C003R00201303401	chr1	369430	50M	161	369591	369431	369592	V350256906L3C003R00201303401_chr1_369430	0	43	tata	CCAG
V350256906L3C003R00300073119	chr1	1146522	50M	248	1146770	1146523	1146771	V350256906L3C003R00300073119_chr1_1146522	120	55	CCAG	TGCA
V350256906L3C003R00300093877	chr1	32520	50M	160	32680	32521	32681	V350256906L3C003R00300093877_chr1_32520	11	165	TGAG	GGAT
V350256906L3C003R00300200703	chr1	1141760	50M	197	1141957	1141761	1141958	V350256906L3C003R00300200703_chr1_1141760	30	67	CTTA	CGAG
V350256906L3C003R00300251460	chr1	228477	50M	165	228642	228478	228643	V350256906L3C003R00300251460_chr1_228477	0	0	CCAC	TCAG
V350256906L3C003R00300421158	chr1	371852	50M	160	372012	371853	372013	V350256906L3C003R00300421158_chr1_371852	43	59	GTTC	cccc
V350256906L3C003R00300776417	chr1	1115318	50M	190	1115508	1115319	1115509	V350256906L3C003R00300776417_chr1_1115318	60	55	TTGG	CCAC
V350256906L3C003R00300830199	chr1	684645	50M	187	684832	684646	684833	V350256906L3C003R00300830199_chr1_684645	14	0	ccca	ctat
V350256906L3C003R00300857278	chr1	1337170	50M	167	1337337	1337171	1337338	V350256906L3C003R00300857278_chr1_1337170	52	61	GCCC	CACA
V350256906L3C003R00301034327	chr1	261254	50M	169	261423	261255	261424	V350256906L3C003R00301034327_chr1_261254	37	22	TGAG	ggaa
V350256906L3C003R00301038467	chr1	62633	50M	184	62817	62634	62818	V350256906L3C003R00301038467_chr1_62633	46	88	TTAC	GATT
V350256906L3C003R00301133420	chr1	1397713	50M	147	1397860	1397714	1397861	V350256906L3C003R00301133420_chr1_1397713	34	0	CGGC	CTAC
V350256906L3C003R00301166784	chr1	655832	50M	191	656023	655833	656024	V350256906L3C003R00301166784_chr1_655832	49	43	cctc	ccaa
V350256906L3C003R00301300518	chr1	941706	50M	221	941927	941707	941928	V350256906L3C003R00301300518_chr1_941706	53	268	GGGG	CCTT
V350256906L3C003R00400029793	chr1	57422	50M	153	57575	57423	57576	V350256906L3C003R00400029793_chr1_57422	0	150	GGGG	CAAA
V350256906L3C003R00400336967	chr1	454163	50M	168	454331	454164	454332	V350256906L3C003R00400336967_chr1_454163	32	43	CCAT	tccc
V350256906L3C003R00401137616	chr1	774252	50M	179	774431	774253	774432	V350256906L3C003R00401137616_chr1_774252	2	181	gtta	gctg
V350256906L3C003R00401364734	chr1	767350	50M	165	767515	767351	767516	V350256906L3C003R00401364734_chr1_767350	43	54	TCAG	GAAG
V350256906L3C003R00500656865	chr1	791445	50M	176	791621	791446	791622	V350256906L3C003R00500656865_chr1_791445	30	35	GCCA	GACA
V350256906L3C003R00500775209	chr1	852613	50M	183	852796	852614	852797	V350256906L3C003R00500775209_chr1_852613	73	80	CCCT	GCAC
V350256906L3C003R00500819561	chr1	1082018	50M	172	1082190	1082019	1082191	V350256906L3C003R00500819561_chr1_1082018	37	23	GGCT	GGCT
V350256906L3C003R00500884167	chr1	92559	50M	147	92706	92560	92707	V350256906L3C003R00500884167_chr1_92559	7	69	agag	tgct
V350256906L3C003R00501108112	chr1	733290	50M	173	733463	733291	733464	V350256906L3C003R00501108112_chr1_733290	257	84	CAAG	CCAA
V350256906L3C003R00600156864	chr1	570762	50M	201	570963	570763	570964	V350256906L3C003R00600156864_chr1_570762	30	28	GAGT	tgat
V350256906L3C003R00600248915	chr1	1082510	50M	164	1082674	1082511	1082675	V350256906L3C003R00600248915_chr1_1082510	64	47	tggg	ACCG
V350256906L3C003R00600472163	chr1	819148	50M	137	819285	819149	819286	V350256906L3C003R00600472163_chr1_819148	8	42	cttt	tggg
V350256906L3C003R00600745431	chr1	1041407	50M	160	1041567	1041408	1041568	V350256906L3C003R00600745431_chr1_1041407	59	55	acat	gttc
V350256906L3C003R00600752159	chr1	1297410	50M	175	1297585	1297411	1297586	V350256906L3C003R00600752159_chr1_1297410	0	0	AGCC	CCTC
V350256906L3C003R00601282834	chr1	1318495	50M	162	1318657	1318496	1318658	V350256906L3C003R00601282834_chr1_1318495	60	74	ggat	cttc
V350256906L3C003R00700053315	chr1	662433	50M	143	662576	662434	662577	V350256906L3C003R00700053315_chr1_662433	35	47	GCAG	CCCT
V350256906L3C003R00700135703	chr1	919874	50M	162	920036	919875	920037	V350256906L3C003R00700135703_chr1_919874	29	21	TGAG	ataa
V350256906L3C003R00700187419	chr1	1217732	50M	185	1217917	1217733	1217918	V350256906L3C003R00700187419_chr1_1217732	9	0	CTGC	CAGG
V350256906L3C003R00700346741	chr1	91976	50M	174	92150	91977	92151	V350256906L3C003R00700346741_chr1_91976	62	236	cccc	cacg
V350256906L3C003R00700608574	chr1	1277311	50M	170	1277481	1277312	1277482	V350256906L3C003R00700608574_chr1_1277311	74	57	CCTG	TGGT
V350256906L3C003R00700613060	chr1	807241	50M	149	807390	807242	807391	V350256906L3C003R00700613060_chr1_807241	29	5	TGGG	TCCT
V350256906L3C003R00700906142	chr1	170119	50M	142	170261	170120	170262	V350256906L3C003R00700906142_chr1_170119	91	233	gcta	ACTG
V350256906L3C003R00701111774	chr1	931818	50M	178	931996	931819	931997	V350256906L3C003R00701111774_chr1_931818	130	145	CAGG	CCCC
V350256906L3C003R00701200442	chr1	1096170	50M	171	1096341	1096171	1096342	V350256906L3C003R00701200442_chr1_1096170	54	30	CTGG	GGGA
V350256906L3C003R00701405246	chr1	543687	50M	165	543852	543688	543853	V350256906L3C003R00701405246_chr1_543687	70	71	ACAG	CAGC
V350256906L3C003R00701406802	chr1	950050	50M	176	950226	950051	950227	V350256906L3C003R00701406802_chr1_950050	21	26	GGGA	AAGC
V350256906L3C003R00800719552	chr1	1044702	50M	151	1044853	1044703	1044854	V350256906L3C003R00800719552_chr1_1044702	73	52	tgtc	aaat
V350256906L3C003R00800957290	chr1	725316	21S29M	235	725551	725317	725552	V350256906L3C003R00800957290_chr1_725316	0	35	ggaa	attc
V350256906L3C003R00900141893	chr1	1392740	50M	181	1392921	1392741	1392922	V350256906L3C003R00900141893_chr1_1392740	78	70	cgag	cact
V350256906L3C003R00900142053	chr1	125572	50M	159	125731	125573	125732	V350256906L3C003R00900142053_chr1_125572	307	224	TATT	TATG
V350256906L3C003R00900197257	chr1	669974	50M	182	670156	669975	670157	V350256906L3C003R00900197257_chr1_669974	59	39	ataa	AGTA
V350256906L3C003R00900604889	chr1	624747	50M	180	624927	624748	624928	V350256906L3C003R00900604889_chr1_624747	0	0	CAGG	GGAG
V350256906L3C003R00900610029	chr1	1306186	50M	138	1306324	1306187	1306325	V350256906L3C003R00900610029_chr1_1306186	66	11	CCCT	CAGA
V350256906L3C003R00901376256	chr1	852305	50M	202	852507	852306	852508	V350256906L3C003R00901376256_chr1_852305	10	3	CTAA	GCAG
V350256906L3C003R01000705810	chr1	871852	50M	175	872027	871853	872028	V350256906L3C003R01000705810_chr1_871852	66	109	CGGG	CTGC
V350256906L3C003R01000841143	chr1	264203	50M	143	264346	264204	264347	V350256906L3C003R01000841143_chr1_264203	0	32	caat	taca
V350256906L3C003R01100254798	chr1	147216	50M	163	147379	147217	147380	V350256906L3C003R01100254798_chr1_147216	45	45	ggca	ccac
V350256906L3C003R01200159826	chr1	981799	50M	172	981971	981800	981972	V350256906L3C003R01200159826_chr1_981799	0	0	CCCG	CACG
V350256906L3C003R01200233777	chr1	808048	50M	167	808215	808049	808216	V350256906L3C003R01200233777_chr1_808048	9	35	CGTC	AGAG
V350256906L3C003R01200262301	chr1	748624	50M	204	748828	748625	748829	V350256906L3C003R01200262301_chr1_748624	57	32	CCCA	GTTC
V350256906L3C003R01200438290	chr1	579094	50M	155	579249	579095	579250	V350256906L3C003R01200438290_chr1_579094	24	120	AAAA	ATTT
V350256906L3C003R01200757133	chr1	338234	50M	169	338403	338235	338404	V350256906L3C003R01200757133_chr1_338234	20	77	TATT	CCCA
V350256906L3C003R01200765121	chr1	16590	50M	216	16806	16591	16807	V350256906L3C003R01200765121_chr1_16590	83	63	CAAA	CACA
V350256906L3C003R01200988220	chr1	753331	50M	194	753525	753332	753526	V350256906L3C003R01200988220_chr1_753331	18	75	AGCC	aaag
V350256906L3C003R01201115885	chr1	40582	50M	176	40758	40583	40759	V350256906L3C003R01201115885_chr1_40582	169	171	ccca	tatt
V350256906L3C003R01201205922	chr1	124585	50M	186	124771	124586	124772	V350256906L3C003R01201205922_chr1_124585	70	256	tatg	agac
V350256906L3C003R01300001747	chr1	943108	39M11S	209	943317	943109	943318	V350256906L3C003R01300001747_chr1_943108	55	116	GCCA	caaa
V350256906L3C003R01300064065	chr1	1347430	50M	156	1347586	1347431	1347587	V350256906L3C003R01300064065_chr1_1347430	168	12	ccca	GGGA
V350256906L3C003R01300327437	chr1	931608	50M	202	931810	931609	931811	V350256906L3C003R01300327437_chr1_931608	0	122	GGAG	GACG
V350256906L3C003R01300398472	chr1	858218	50M	167	858385	858219	858386	V350256906L3C003R01300398472_chr1_858218	42	51	CGAA	GCCT
V350256906L3C003R01300409534	chr1	317918	50M	149	318067	317919	318068	V350256906L3C003R01300409534_chr1_317918	82	231	ggaa	CACC
V350256906L3C003R01300696482	chr1	997687	50M	110	997797	997688	997798	V350256906L3C003R01300696482_chr1_997687	53	20	TAAG	TGCC
V350256906L3C003R01300788490	chr1	376655	50M	185	376840	376656	376841	V350256906L3C003R01300788490_chr1_376655	305	239	tctt	ggaa
V350256906L3C003R01301011296	chr1	1019921	50M	167	1020088	1019922	1020089	V350256906L3C003R01301011296_chr1_1019921	14	41	CCAG	GGCA
V350256906L3C003R01301341233	chr1	1275848	50M	170	1276018	1275849	1276019	V350256906L3C003R01301341233_chr1_1275848	68	26	CTGG	GGAC
V350256906L3C003R01400523376	chr1	703736	50M	164	703900	703737	703901	V350256906L3C003R01400523376_chr1_703736	42	62	CCTC	TCTT
V350256906L3C003R01400544075	chr1	1198971	50M	163	1199134	1198972	1199135	V350256906L3C003R01400544075_chr1_1198971	76	59	GGAT	ccaa
V350256906L3C003R01400714687	chr1	1293279	50M	188	1293467	1293280	1293468	V350256906L3C003R01400714687_chr1_1293279	27	27	CTGG	AGGC
V350256906L3C003R01400898901	chr1	164096	50M	169	164265	164097	164266	V350256906L3C003R01400898901_chr1_164096	73	70	cctc	AGGT
V350256906L3C003R01400908480	chr1	331889	50M	194	332083	331890	332084	V350256906L3C003R01400908480_chr1_331889	163	0	TCCA	CACT
V350256906L3C003R01401012131	chr1	1140022	50M	183	1140205	1140023	1140206	V350256906L3C003R01401012131_chr1_1140022	53	56	AGGA	CACT
V350256906L3C003R01401091036	chr1	174229	50M	148	174377	174230	174378	V350256906L3C003R01401091036_chr1_174229	53	53	ACAA	TATT
V350256906L3C003R01401157320	chr1	535224	50M	160	535384	535225	535385	V350256906L3C003R01401157320_chr1_535224	43	83	gcca	acaa
V350256906L3C003R01401343471	chr1	248602	50M	142	248744	248603	248745	V350256906L3C003R01401343471_chr1_248602	0	34	GAAG	GGGG
V350256906L3C003R01500080927	chr1	266021	50M	184	266205	266022	266206	V350256906L3C003R01500080927_chr1_266021	76	34	agag	ccca
V350256906L3C003R01500174430	chr1	852896	50M	202	853098	852897	853099	V350256906L3C003R01500174430_chr1_852896	0	4	CTTA	CCTG
V350256906L3C003R01500317862	chr1	1048669	50M	263	1048932	1048670	1048933	V350256906L3C003R01500317862_chr1_1048669	117	0	gctg	GGAC
V350256906L3C003R01500500906	chr1	650836	50M	160	650996	650837	650997	V350256906L3C003R01500500906_chr1_650836	16	109	AGTT	agta
V350256906L3C003R01500638703	chr1	1366254	50M	196	1366450	1366255	1366451	V350256906L3C003R01500638703_chr1_1366254	7	132	CCTG	TCTT
V350256906L3C003R01501002303	chr1	663278	50M	208	663486	663279	663487	V350256906L3C003R01501002303_chr1_663278	32	45	GCTT	TCCC
V350256906L3C003R01600113846	chr1	783892	50M	194	784086	783893	784087	V350256906L3C003R01600113846_chr1_783892	72	59	CCTC	ATCC
V350256906L3C003R01600189344	chr1	777790	50M	179	777969	777791	777970	V350256906L3C003R01600189344_chr1_777790	55	60	TGAC	CAAG
V350256906L3C003R01600227539	chr1	1127035	50M	171	1127206	1127036	1127207	V350256906L3C003R01600227539_chr1_1127035	41	40	caca	ccct
V350256906L3C003R01600312199	chr1	1025433	50M	178	1025611	1025434	1025612	V350256906L3C003R01600312199_chr1_1025433	35	37	TGAG	GATG
V350256906L3C003R01600886868	chr1	351255	50M	162	351417	351256	351418	V350256906L3C003R01600886868_chr1_351255	82	89	tgag	cctg
V350256906L3C003R01600962790	chr1	1158381	50M	181	1158562	1158382	1158563	V350256906L3C003R01600962790_chr1_1158381	33	19	caca	gtgt
V350256906L3C003R01601016043	chr1	32688	50M	211	32899	32689	32900	V350256906L3C003R01601016043_chr1_32688	157	38	CCTG	agcc
V350256906L3C003R01601189555	chr1	1084077	50M	173	1084250	1084078	1084251	V350256906L3C003R01601189555_chr1_1084077	51	56	CGAG	CGAG
V350256906L3C003R01700292698	chr1	163148	50M	188	163336	163149	163337	V350256906L3C003R01700292698_chr1_163148	35	56	GGAA	TAAA
V350256906L3C003R01700367182	chr1	1370206	50M	158	1370364	1370207	1370365	V350256906L3C003R01700367182_chr1_1370206	10	30	TGGG	CCCA
V350256906L3C003R01700368027	chr1	911569	50M	133	911702	911570	911703	V350256906L3C003R01700368027_chr1_911569	38	0	GGCT	ACGG
V350256906L3C003R01700598969	chr1	767874	50M	177	768051	767875	768052	V350256906L3C003R01700598969_chr1_767874	62	80	CCAG	CGCC
V350256906L3C003R01700947154	chr1	133492	50M	155	133647	133493	133648	V350256906L3C003R01700947154_chr1_133492	75	24	GGAG	CCTC
V350256906L3C003R01701016583	chr1	248295	50M	165	248460	248296	248461	V350256906L3C003R01701016583_chr1_248295	112	11	ctgt	ttct
V350256906L3C003R01701031891	chr1	1304487	50M	211	1304698	1304488	1304699	V350256906L3C003R01701031891_chr1_1304487	57	132	GGAC	gcca
V350256906L3C003R01701154485	chr1	825766	50M	158	825924	825767	825925	V350256906L3C003R01701154485_chr1_825766	49	207	Tcaa	CAAT
V350256906L3C003R01701332820	chr1	244059	50M	217	244276	244060	244277	V350256906L3C003R01701332820_chr1_244059	0	4	GCAT	CTCA
V350256906L3C003R01701377504	chr1	1247064	50M	162	1247226	1247065	1247227	V350256906L3C003R01701377504_chr1_1247064	8	0	TTTG	CCCA
V350256906L3C003R01701398795	chr1	1409704	50M	163	1409867	1409705	1409868	V350256906L3C003R01701398795_chr1_1409704	27	24	ggga	cggg
V350256906L3C003R01800422848	chr1	123426	50M	148	123574	123427	123575	V350256906L3C003R01800422848_chr1_123426	23	52	TGTA	AGCA
V350256906L3C003R01800551081	chr1	463358	50M	153	463511	463359	463512	V350256906L3C003R01800551081_chr1_463358	101	10	gaaa	gaca
V350256906L3C003R01800552249	chr1	1038239	50M	178	1038417	1038240	1038418	V350256906L3C003R01800552249_chr1_1038239	0	139	tgtc	accc
V350256906L3C003R01800561598	chr1	982618	50M	162	982780	982619	982781	V350256906L3C003R01800561598_chr1_982618	226	64	CCCT	ATCT
V350256906L3C003R01801024834	chr1	726825	24S22M4S	147	726972	726826	726973	V350256906L3C003R01801024834_chr1_726825	0	23	gaat	tcca
V350256906L3C003R01900420631	chr1	725787	13S37M	180	725967	725788	725968	V350256906L3C003R01900420631_chr1_725787	96	42	gact	catt
V350256906L3C003R01900456213	chr1	398998	50M	169	399167	398999	399168	V350256906L3C003R01900456213_chr1_398998	101	32	aagt	gcaa
V350256906L3C003R01901151370	chr1	321298	50M	168	321466	321299	321467	V350256906L3C003R01901151370_chr1_321298	39	12	tgat	ATTT
V350256906L3C003R01901196375	chr1	27951	50M	164	28115	27952	28116	V350256906L3C003R01901196375_chr1_27951	0	19	gccc	TAAT
V350256906L3C003R02000354499	chr1	680760	50M	131	680891	680761	680892	V350256906L3C003R02000354499_chr1_680760	14	12	ccaa	ccca
V350256906L3C003R02000441393	chr1	138781	50M	172	138953	138782	138954	V350256906L3C003R02000441393_chr1_138781	49	55	CGCC	CTCA
V350256906L3C003R02000562413	chr1	20545	50M	147	20692	20546	20693	V350256906L3C003R02000562413_chr1_20545	0	23	caag	GCTT
V350256906L3C003R02000868747	chr1	1131629	50M	173	1131802	1131630	1131803	V350256906L3C003R02000868747_chr1_1131629	0	20	aacc	caac
V350256906L3C003R02001083417	chr1	894451	50M	154	894605	894452	894606	V350256906L3C003R02001083417_chr1_894451	56	65	CCGC	GCCG
V350256906L3C003R02001196587	chr1	464430	50M	176	464606	464431	464607	V350256906L3C003R02001196587_chr1_464430	149	0	gtgg	ccaa
V350256906L3C003R02001232664	chr1	824904	50M	154	825058	824905	825059	V350256906L3C003R02001232664_chr1_824904	126	0	GACT	gaca
V350256906L3C003R02001267203	chr1	587463	50M	168	587631	587464	587632	V350256906L3C003R02001267203_chr1_587463	64	86	ccaa	catt
V350256906L3C003R02101336357	chr1	65933	50M	132	66065	65934	66066	V350256906L3C003R02101336357_chr1_65933	129	0	CCAG	aaat
V350256906L3C003R02101387861	chr1	814464	50M	164	814628	814465	814629	V350256906L3C003R02101387861_chr1_814464	19	1	ggtg	agtg
V350256906L3C003R02200402117	chr1	985050	50M	152	985202	985051	985203	V350256906L3C003R02200402117_chr1_985050	0	8	CCCG	CCCA
V350256906L3C003R02200930214	chr1	996874	50M	165	997039	996875	997040	V350256906L3C003R02200930214_chr1_996874	58	74	GAGG	gcct
V350256906L3C003R02200940876	chr1	761018	50M	159	761177	761019	761178	V350256906L3C003R02200940876_chr1_761018	92	251	CAAC	GCTT
V350256906L3C003R02201095305	chr1	1155768	50M	204	1155972	1155769	1155973	V350256906L3C003R02201095305_chr1_1155768	9	9	GCCC	ACCC
V350256906L3C003R02201165059	chr1	252823	50M	183	253006	252824	253007	V350256906L3C003R02201165059_chr1_252823	222	39	atat	GTGT
V350256906L3C003R02201200016	chr1	686686	50M	162	686848	686687	686849	V350256906L3C003R02201200016_chr1_686686	46	0	agag	ggag
V350256906L3C003R02300851250	chr1	1428696	50M	171	1428867	1428697	1428868	V350256906L3C003R02300851250_chr1_1428696	71	60	tctt	CTGG
V350256906L3C003R02300888708	chr1	586930	50M	164	587094	586931	587095	V350256906L3C003R02300888708_chr1_586930	70	58	gagg	gatc
V350256906L3C003R02301337386	chr1	726325	1S28M5I16M	176	726501	726326	726502	V350256906L3C003R02301337386_chr1_726325	34	24	aatg	catt
V350256906L3C003R02400413988	chr1	792036	50M	256	792292	792037	792293	V350256906L3C003R02400413988_chr1_792036	54	0	CCTA	CCAG
V350256906L3C003R02400712405	chr1	1394193	50M	161	1394354	1394194	1394355	V350256906L3C003R02400712405_chr1_1394193	27	14	ccca	tgag
V350256906L3C003R02400821887	chr1	843098	50M	170	843268	843099	843269	V350256906L3C003R02400821887_chr1_843098	0	18	TCTG	CCCA
V350256906L3C003R02400971982	chr1	744619	50M	150	744769	744620	744770	V350256906L3C003R02400971982_chr1_744619	16	40	tgca	cttg
V350256906L3C003R02401179194	chr1	20519	50M	160	20679	20520	20680	V350256906L3C003R02401179194_chr1_20519	9	36	GACT	actg
V350256906L3C003R02401184845	chr1	737268	50M	179	737447	737269	737448	V350256906L3C003R02401184845_chr1_737268	228	49	CATC	TAAA
V350256906L3C003R02401188375	chr1	1112041	50M	161	1112202	1112042	1112203	V350256906L3C003R02401188375_chr1_1112041	171	10	CCCA	CAAG
V350256906L3C003R02401202461	chr1	1292924	50M	175	1293099	1292925	1293100	V350256906L3C003R02401202461_chr1_1292924	178	33	cgcc	cttg
V350256906L3C003R02401225734	chr1	264406	50M	169	264575	264407	264576	V350256906L3C003R02401225734_chr1_264406	0	0	gcag	gttt
V350256906L3C003R02500089362	chr1	791852	50M	178	792030	791853	792031	V350256906L3C003R02500089362_chr1_791852	42	60	AGCC	AGAG
V350256906L3C003R02500444653	chr1	1161331	50M	199	1161530	1161332	1161531	V350256906L3C003R02500444653_chr1_1161331	0	173	CGCA	ccag
V350256906L3C003R02500863002	chr1	825869	50M	197	826066	825870	826067	V350256906L3C003R02500863002_chr1_825869	152	201	AAAG	ccca
V350256906L3C003R02501159280	chr1	1145373	50M	122	1145495	1145374	1145496	V350256906L3C003R02501159280_chr1_1145373	115	126	ctac	tttt
V350256906L3C003R02501262363	chr1	355079	50M	158	355237	355080	355238	V350256906L3C003R02501262363_chr1_355079	133	291	gagg	agca
V350256906L3C003R02600174626	chr1	559675	50M	170	559845	559676	559846	V350256906L3C003R02600174626_chr1_559675	105	27	gcca	cctc
V350256906L3C003R02600373517	chr1	267090	50M	158	267248	267091	267249	V350256906L3C003R02600373517_chr1_267090	72	29	CCAT	CATA
V350256906L3C003R02600468943	chr1	1206162	50M	125	1206287	1206163	1206288	V350256906L3C003R02600468943_chr1_1206162	56	50	CTCT	CCTG
V350256906L3C003R02600853335	chr1	337424	50M	255	337679	337425	337680	V350256906L3C003R02600853335_chr1_337424	68	171	ATTT	AAAG
V350256906L3C003R02601299134	chr1	1199780	50M	146	1199926	1199781	1199927	V350256906L3C003R02601299134_chr1_1199780	150	34	CTTC	ccca
V350256906L3C003R02601360843	chr1	149224	50M	171	149395	149225	149396	V350256906L3C003R02601360843_chr1_149224	59	74	AATA	CCAT
V350256906L3C003R02601393981	chr1	246833	50M	179	247012	246834	247013	V350256906L3C003R02601393981_chr1_246833	6	19	TACT	TGCT
V350256906L3C003R02700630445	chr1	1141420	50M	152	1141572	1141421	1141573	V350256906L3C003R02700630445_chr1_1141420	4	51	CCTC	GCCA
V350256906L3C003R02700690177	chr1	372761	50M	191	372952	372762	372953	V350256906L3C003R02700690177_chr1_372761	288	158	ctgc	aaag
V350256906L3C003R02701091826	chr1	1304637	50M	119	1304756	1304638	1304757	V350256906L3C003R02701091826_chr1_1304637	71	190	cgcc	cgag
V350256906L3C003R02701198624	chr1	1024068	50M	191	1024259	1024069	1024260	V350256906L3C003R02701198624_chr1_1024068	39	72	CTTG	CCAT
V350256906L3C003R02800550738	chr1	1384803	50M	206	1385009	1384804	1385010	V350256906L3C003R02800550738_chr1_1384803	28	0	tcta	ggaa
V350256906L3C003R02800620908	chr1	1228358	50M	175	1228533	1228359	1228534	V350256906L3C003R02800620908_chr1_1228358	26	35	CGTG	CCCC
V350256906L3C003R02800778620	chr1	32619	50M	165	32784	32620	32785	V350256906L3C003R02800778620_chr1_32619	110	61	CCAG	GGTG
V350256906L3C003R02800850850	chr1	1274802	50M	187	1274989	1274803	1274990	V350256906L3C003R02800850850_chr1_1274802	52	59	TGGG	CCCG
V350256906L3C003R02800895631	chr1	246955	50M	180	247135	246956	247136	V350256906L3C003R02800895631_chr1_246955	7	0	TGCA	TGTG
V350256906L3C003R02800951201	chr1	677719	50M	160	677879	677720	677880	V350256906L3C003R02800951201_chr1_677719	55	0	agca	cctg
V350256906L3C003R02800977276	chr1	135459	50M	177	135636	135460	135637	V350256906L3C003R02800977276_chr1_135459	0	164	CCAG	CCCT
V350256906L3C003R02801138197	chr1	830555	50M	164	830719	830556	830720	V350256906L3C003R02801138197_chr1_830555	19	0	GCTT	ctcg
V350256906L3C003R02801325163	chr1	566394	50M	171	566565	566395	566566	V350256906L3C003R02801325163_chr1_566394	51	37	CCCC	AATA
V350256906L3C003R02801345169	chr1	1417479	50M	195	1417674	1417480	1417675	V350256906L3C003R02801345169_chr1_1417479	0	5	CACT	CCAA
V350256906L3C003R02901344907	chr1	726591	30M20S	153	726744	726592	726745	V350256906L3C003R02901344907_chr1_726591	9	69	gaat	attc
V350256906L3C003R03000243123	chr1	717955	50M	175	718130	717956	718131	V350256906L3C003R03000243123_chr1_717955	7	136	CCAT	cctg
V350256906L3C003R03000625781	chr1	417221	50M	151	417372	417222	417373	V350256906L3C003R03000625781_chr1_417221	198	129	ctaa	CAAG
V350256906L3C003R03000767163	chr1	395451	50M	167	395618	395452	395619	V350256906L3C003R03000767163_chr1_395451	41	77	ccac	tgcg
V350256906L3C003R03000781200	chr1	1033507	50M	166	1033673	1033508	1033674	V350256906L3C003R03000781200_chr1_1033507	0	88	ggtg	tcaa
V350256906L3C003R03000806156	chr1	261569	50M	151	261720	261570	261721	V350256906L3C003R03000806156_chr1_261569	57	67	TCTT	cact
V350256906L3C003R03001054017	chr1	73308	50M	178	73486	73309	73487	V350256906L3C003R03001054017_chr1_73308	89	65	gcct	catg
V350256906L3C003R03001169146	chr1	1393543	50M	183	1393726	1393544	1393727	V350256906L3C003R03001169146_chr1_1393543	96	69	taga	ccaa
V350256906L3C003R03100755534	chr1	555435	50M	201	555636	555436	555637	V350256906L3C003R03100755534_chr1_555435	51	57	ccag	ataa
V350256906L3C003R03100905831	chr1	937004	50M	176	937180	937005	937181	V350256906L3C003R03100905831_chr1_937004	57	35	CCTG	CCCC
V350256906L3C003R03101139626	chr1	930771	50M	134	930905	930772	930906	V350256906L3C003R03101139626_chr1_930771	0	8	acaa	CAGA
V350256906L3C003R03200668216	chr1	25364	50M	142	25506	25365	25507	V350256906L3C003R03200668216_chr1_25364	153	233	CAAA	TCCC
V350256906L3C003R03201399589	chr1	408878	50M	157	409035	408879	409036	V350256906L3C003R03201399589_chr1_408878	61	48	ctca	ggtt
V350256906L3C003R03300701696	chr1	156089	50M	172	156261	156090	156262	V350256906L3C003R03300701696_chr1_156089	140	0	ccag	caca
V350256906L3C003R03301218661	chr1	247439	50M	150	247589	247440	247590	V350256906L3C003R03301218661_chr1_247439	44	62	gagg	ccac
V350256906L3C003R03301247844	chr1	1151646	50M	164	1151810	1151647	1151811	V350256906L3C003R03301247844_chr1_1151646	71	235	GCTC	CCTC
V350256906L3C003R03400572143	chr1	382233	50M	157	382390	382234	382391	V350256906L3C003R03400572143_chr1_382233	0	24	ctta	ccag
V350256906L3C003R03400671722	chr1	1353348	50M	185	1353533	1353349	1353534	V350256906L3C003R03400671722_chr1_1353348	32	31	agcc	ggaa
V350256906L3C003R03400839232	chr1	1124161	50M	202	1124363	1124162	1124364	V350256906L3C003R03400839232_chr1_1124161	0	0	cgat	gttt
V350256906L3C003R03400957818	chr1	1135571	50M	173	1135744	1135572	1135745	V350256906L3C003R03400957818_chr1_1135571	8	28	GGTT	CCAC
V350256906L3C003R03400964958	chr1	883636	50M	203	883839	883637	883840	V350256906L3C003R03400964958_chr1_883636	4	0	AGTG	CAGT
V350256906L3C003R03400967414	chr1	552506	50M	160	552666	552507	552667	V350256906L3C003R03400967414_chr1_552506	89	33	tgca	gttt
V350256906L3C003R03400994780	chr1	21634	50M	158	21792	21635	21793	V350256906L3C003R03400994780_chr1_21634	48	60	CCAG	GCCG
V350256906L3C003R03401085378	chr1	814304	50M	176	814480	814305	814481	V350256906L3C003R03401085378_chr1_814304	35	35	CCAG	tata
V350256906L3C003R03401284294	chr1	1350066	50M	161	1350227	1350067	1350228	V350256906L3C003R03401284294_chr1_1350066	59	59	ggaa	ctga
V350256906L3C003R03500158949	chr1	1331004	50M	183	1331187	1331005	1331188	V350256906L3C003R03500158949_chr1_1331004	54	65	CATC	TTAG
V350256906L3C003R03500386974	chr1	629363	50M	169	629532	629364	629533	V350256906L3C003R03500386974_chr1_629363	72	51	TGAG	CTGG
V350256906L3C003R03500683164	chr1	27871	50M	149	28020	27872	28021	V350256906L3C003R03500683164_chr1_27871	28	32	tccc	TGAA
V350256906L3C003R03500905159	chr1	81450	50M	165	81615	81451	81616	V350256906L3C003R03500905159_chr1_81450	0	0	acca	attt
V350256906L3C003R03500967535	chr1	444768	50M	151	444919	444769	444920	V350256906L3C003R03500967535_chr1_444768	81	23	CCTT	GTTT
V350256906L3C003R03501048024	chr1	613762	50M	165	613927	613763	613928	V350256906L3C003R03501048024_chr1_613762	12	0	aaat	cttc
V350256906L3C003R03501162392	chr1	1039376	50M	168	1039544	1039377	1039545	V350256906L3C003R03501162392_chr1_1039376	51	51	tttt	taca
V350256906L3C003R03501404747	chr1	1377292	50M	155	1377447	1377293	1377448	V350256906L3C003R03501404747_chr1_1377292	18	0	CCCG	CAGC
V350256906L3C003R03600207122	chr1	394018	50M	168	394186	394019	394187	V350256906L3C003R03600207122_chr1_394018	0	126	aaag	cgtt
V350256906L3C003R03600634183	chr1	940662	50M	185	940847	940663	940848	V350256906L3C003R03600634183_chr1_940662	21	30	CTGG	cctg
V350256906L3C003R03601060350	chr1	825818	20M3I27M	176	825994	825819	825995	V350256906L3C003R03601060350_chr1_825818	101	273	cttc	GGAG
V350256906L3C003R03601101729	chr1	1273018	50M	137	1273155	1273019	1273156	V350256906L3C003R03601101729_chr1_1273018	214	77	CCGC	TCTG
V350256906L3C003R03601359966	chr1	617552	50M	179	617731	617553	617732	V350256906L3C003R03601359966_chr1_617552	7	49	ctgg	CAGT
V350256906L3C003R03700983578	chr1	555420	50M	188	555608	555421	555609	V350256906L3C003R03700983578_chr1_555420	36	29	atgg	ttag
V350256906L3C003R03701074745	chr1	439893	50M	162	440055	439894	440056	V350256906L3C003R03701074745_chr1_439893	55	71	CCAC	CCCC
V350256906L3C003R03701171403	chr1	241862	50M	123	241985	241863	241986	V350256906L3C003R03701171403_chr1_241862	39	51	CTAT	CTTT
V350256906L3C003R03800068136	chr1	714168	50M	149	714317	714169	714318	V350256906L3C003R03800068136_chr1_714168	41	0	GCGC	CCCG
V350256906L3C003R03800210555	chr1	709365	50M	187	709552	709366	709553	V350256906L3C003R03800210555_chr1_709365	56	100	CAGA	GGTA
V350256906L3C003R03800291194	chr1	80984	50M	158	81142	80985	81143	V350256906L3C003R03800291194_chr1_80984	57	59	ggca	attg
V350256906L3C003R03800382057	chr1	335550	50M	243	335793	335551	335794	V350256906L3C003R03800382057_chr1_335550	46	225	ctcc	tgaa
V350256906L3C003R03800876089	chr1	666693	50M	184	666877	666694	666878	V350256906L3C003R03800876089_chr1_666693	138	0	TTTA	ATTG
V350256906L3C003R03801050792	chr1	1064249	50M	159	1064408	1064250	1064409	V350256906L3C003R03801050792_chr1_1064249	31	78	TTTC	CTCC
V350256906L3C003R03801201882	chr1	783866	50M	150	784016	783867	784017	V350256906L3C003R03801201882_chr1_783866	48	0	TATT	ACCA
V350256906L3C003R03900025541	chr1	655391	50M	176	655567	655392	655568	V350256906L3C003R03900025541_chr1_655391	31	36	AGAG	CGAG
V350256906L3C003R03900180598	chr1	428160	50M	156	428316	428161	428317	V350256906L3C003R03900180598_chr1_428160	60	53	CGGG	cccg
V350256906L3C003R03900265604	chr1	1404286	50M	149	1404435	1404287	1404436	V350256906L3C003R03900265604_chr1_1404286	35	62	CGCG	cccg
V350256906L3C003R03900469607	chr1	1365004	50M	175	1365179	1365005	1365180	V350256906L3C003R03900469607_chr1_1365004	32	93	ggag	CACA
V350256906L3C003R03901158044	chr1	710923	50M	187	711110	710924	711111	V350256906L3C003R03901158044_chr1_710923	0	165	AGAA	ctgg
V350256906L3C003R04000081904	chr1	463721	50M	193	463914	463722	463915	V350256906L3C003R04000081904_chr1_463721	220	27	tgaa	CCAT
V350256906L3C003R04000511238	chr1	1203971	50M	179	1204150	1203972	1204151	V350256906L3C003R04000511238_chr1_1203971	0	20	CCAC	ggtg
V350256906L3C003R04000559140	chr1	456048	50M	156	456204	456049	456205	V350256906L3C003R04000559140_chr1_456048	375	531	CTTG	aata
V350256906L3C003R04000659109	chr1	1140011	50M	145	1140156	1140012	1140157	V350256906L3C003R04000659109_chr1_1140011	64	36	CTTC	CCCT
V350256906L3C003R04000785256	chr1	564056	50M	160	564216	564057	564217	V350256906L3C003R04000785256_chr1_564056	65	43	CCAC	TGAA
V350256906L3C003R04000958470	chr1	769868	50M	194	770062	769869	770063	V350256906L3C003R04000958470_chr1_769868	48	17	AAGA	CCCT
V350256906L3C003R04001259415	chr1	70656	50M	183	70839	70657	70840	V350256906L3C003R04001259415_chr1_70656	106	51	ctct	ataa
V350256906L3C003R04100018915	chr1	1028707	50M	228	1028935	1028708	1028936	V350256906L3C003R04100018915_chr1_1028707	48	77	ccaA	GCTG
V350256906L3C003R04101135410	chr1	30504	50M	170	30674	30505	30675	V350256906L3C003R04101135410_chr1_30504	39	82	tatt	CTTT
V350256906L3C003R04200704870	chr1	895874	50M	146	896020	895875	896021	V350256906L3C003R04200704870_chr1_895874	28	8	GAAG	GGAG
V350256906L3C003R04200910326	chr1	319246	50M	165	319411	319247	319412	V350256906L3C003R04200910326_chr1_319246	11	8	tata	tctt
V350256906L3C003R04201140216	chr1	50276	50M	133	50409	50277	50410	V350256906L3C003R04201140216_chr1_50276	37	0	TATT	AGTG
V350256906L3C003R04201272022	chr1	1269302	50M	168	1269470	1269303	1269471	V350256906L3C003R04201272022_chr1_1269302	35	75	AGTG	GACC
V350256906L3C003R04300105502	chr1	724808	14S36M	208	725016	724809	725017	V350256906L3C003R04300105502_chr1_724808	43	46	aatg	attc
V350256906L3C003R04300339612	chr1	1032999	50M	169	1033168	1033000	1033169	V350256906L3C003R04300339612_chr1_1032999	171	234	cctt	aaaa
V350256906L3C003R04300722935	chr1	563835	50M	164	563999	563836	564000	V350256906L3C003R04300722935_chr1_563835	51	31	CCTA	CTCT
V350256906L3C003R04300772230	chr1	164847	50M	162	165009	164848	165010	V350256906L3C003R04300772230_chr1_164847	16	73	TAAT	ggAT
V350256906L3C003R04300820937	chr1	555250	50M	201	555451	555251	555452	V350256906L3C003R04300820937_chr1_555250	65	67	AAAT	gtta
V350256906L3C003R04301150847	chr1	386270	50M	178	386448	386271	386449	V350256906L3C003R04301150847_chr1_386270	358	354	cccc	caaa
V350256906L3C003R04400155968	chr1	1378746	50M	132	1378878	1378747	1378879	V350256906L3C003R04400155968_chr1_1378746	61	38	GTGT	ctga
V350256906L3C003R04400332554	chr1	324604	50M	147	324751	324605	324752	V350256906L3C003R04400332554_chr1_324604	55	65	CGTT	CTGG
V350256906L3C003R04400569788	chr1	739995	50M	196	740191	739996	740192	V350256906L3C003R04400569788_chr1_739995	52	22	CCAT	ACTC
V350256906L3C003R04400998009	chr1	1348530	50M	176	1348706	1348531	1348707	V350256906L3C003R04400998009_chr1_1348530	17	25	gtag	gcag
V350256906L3C003R04401254017	chr1	1279460	50M	166	1279626	1279461	1279627	V350256906L3C003R04401254017_chr1_1279460	58	57	CCCC	CCTA
V350256906L3C003R04500072889	chr1	1098601	50M	181	1098782	1098602	1098783	V350256906L3C003R04500072889_chr1_1098601	43	0	CTGG	CCCC
V350256906L3C003R04500229107	chr1	159125	50M	189	159314	159126	159315	V350256906L3C003R04500229107_chr1_159125	0	146	AGCT	TAGG
V350256906L3C003R04500585081	chr1	595586	50M	164	595750	595587	595751	V350256906L3C003R04500585081_chr1_595586	136	0	cctt	gaaa
V350256906L3C003R04500622501	chr1	1355318	50M	171	1355489	1355319	1355490	V350256906L3C003R04500622501_chr1_1355318	51	12	CTTC	CGGG
V350256906L3C003R04500885703	chr1	1378510	50M	183	1378693	1378511	1378694	V350256906L3C003R04500885703_chr1_1378510	74	76	agat	TGTC
V350256906L3C003R04501023763	chr1	1047423	50M	165	1047588	1047424	1047589	V350256906L3C003R04501023763_chr1_1047423	35	50	Cgta	catg
V350256906L3C003R04501146736	chr1	46863	50M	193	47056	46864	47057	V350256906L3C003R04501146736_chr1_46863	261	68	CCTC	taaa
V350256906L3C003R04600248028	chr1	1331834	50M	168	1332002	1331835	1332003	V350256906L3C003R04600248028_chr1_1331834	11	5	tggg	gcaa
V350256906L3C003R04600285322	chr1	1360856	50M	174	1361030	1360857	1361031	V350256906L3C003R04600285322_chr1_1360856	119	0	aaaa	AGAG
V350256906L3C003R04600620906	chr1	620578	50M	155	620733	620579	620734	V350256906L3C003R04600620906_chr1_620578	8	54	tagt	cata
V350256906L3C003R04600842279	chr1	101663	50M	180	101843	101664	101844	V350256906L3C003R04600842279_chr1_101663	278	104	agat	tgtg
V350256906L3C003R04600965414	chr1	339300	50M	210	339510	339301	339511	V350256906L3C003R04600965414_chr1_339300	23	127	ctat	gtga
V350256906L3C003R04601074391	chr1	1397974	50M	144	1398118	1397975	1398119	V350256906L3C003R04601074391_chr1_1397974	44	72	CCCC	CTGG
V350256906L3C003R04601328699	chr1	1268703	50M	162	1268865	1268704	1268866	V350256906L3C003R04601328699_chr1_1268703	55	66	ACTC	CTGG
V350256906L3C003R04700084554	chr1	898306	50M	222	898528	898307	898529	V350256906L3C003R04700084554_chr1_898306	16	62	CCCC	CCTC
V350256906L3C003R04701404837	chr1	1313508	50M	171	1313679	1313509	1313680	V350256906L3C003R04701404837_chr1_1313508	47	59	CCAA	agga
V350256906L3C003R04800171933	chr1	24753	50M	121	24874	24754	24875	V350256906L3C003R04800171933_chr1_24753	21	0	CCAG	GGAT
V350256906L3C003R04800276274	chr1	231038	50M	178	231216	231039	231217	V350256906L3C003R04800276274_chr1_231038	0	15	attc	ggaa
V350256906L3C003R04800341653	chr1	426278	50M	169	426447	426279	426448	V350256906L3C003R04800341653_chr1_426278	73	68	caga	CCAG
V350256906L3C003R04800388969	chr1	630663	50M	165	630828	630664	630829	V350256906L3C003R04800388969_chr1_630663	31	0	TAAA	TAGT
V350256906L3C003R04800463658	chr1	527377	50M	169	527546	527378	527547	V350256906L3C003R04800463658_chr1_527377	21	66	CTTA	tatt
V350256906L3C003R04800483294	chr1	176609	50M	159	176768	176610	176769	V350256906L3C003R04800483294_chr1_176609	120	8	CAAG	GGTG
V350256906L3C003R04800508691	chr1	255354	50M	247	255601	255355	255602	V350256906L3C003R04800508691_chr1_255354	28	56	CTTG	CCTT
V350256906L3C003R04800906323	chr1	746132	50M	167	746299	746133	746300	V350256906L3C003R04800906323_chr1_746132	42	31	AGAA	CACT
V350256906L3C003R04801260396	chr1	1006751	50M	178	1006929	1006752	1006930	V350256906L3C003R04801260396_chr1_1006751	48	67	agca	cacg
V350256906L3C003R04801377455	chr1	149223	50M	138	149361	149224	149362	V350256906L3C003R04801377455_chr1_149223	58	40	CAAT	CTAT
V350256906L3C003R04900059716	chr1	1063491	50M	180	1063671	1063492	1063672	V350256906L3C003R04900059716_chr1_1063491	8	31	CGGG	GCGC
V350256906L3C003R04900148026	chr1	722458	50M	178	722636	722459	722637	V350256906L3C003R04900148026_chr1_722458	44	24	tgac	cagg
V350256906L3C003R04900195231	chr1	726193	25S25M	182	726375	726194	726376	V350256906L3C003R04900195231_chr1_726193	56	36	gaat	acct
V350256906L3C003R04900210588	chr1	252988	50M	200	253188	252989	253189	V350256906L3C003R04900210588_chr1_252988	57	38	CAGG	AGTC
V350256906L3C003R04900285420	chr1	317829	50M	163	317992	317830	317993	V350256906L3C003R04900285420_chr1_317829	0	156	CCCA	TGCG
V350256906L3C003R04900487462	chr1	534394	50M	212	534606	534395	534607	V350256906L3C003R04900487462_chr1_534394	0	42	cctt	ggag
V350256906L3C003R04900572553	chr1	319629	50M	182	319811	319630	319812	V350256906L3C003R04900572553_chr1_319629	38	25	ccag	cctc
V350256906L3C003R04900863036	chr1	726825	31S19M	147	726972	726826	726973	V350256906L3C003R04900863036_chr1_726825	0	23	gaat	tcca
V350256906L3C003R04901048006	chr1	396394	50M	182	396576	396395	396577	V350256906L3C003R04901048006_chr1_396394	74	39	TGCA	TATA
V350256906L3C003R04901142466	chr1	1374126	50M	167	1374293	1374127	1374294	V350256906L3C003R04901142466_chr1_1374126	67	55	CCGT	CAGA
V350256906L3C003R04901294952	chr1	1426049	50M	171	1426220	1426050	1426221	V350256906L3C003R04901294952_chr1_1426049	32	26	CAGG	CGTG
V350256906L3C003R05000122203	chr1	884062	50M	239	884301	884063	884302	V350256906L3C003R05000122203_chr1_884062	24	47	CCTG	CCTC
V350256906L3C003R05000315691	chr1	81502	50M	198	81700	81503	81701	V350256906L3C003R05000315691_chr1_81502	42	74	atac	ccca
V350256906L3C003R05000539386	chr1	992778	50M	213	992991	992779	992992	V350256906L3C003R05000539386_chr1_992778	67	73	CTTC	agcc
V350256906L3C003R05000611174	chr1	726825	28S22M	147	726972	726826	726973	V350256906L3C003R05000611174_chr1_726825	0	23	gaat	tcca
V350256906L3C003R05000704062	chr1	1308916	50M	153	1309069	1308917	1309070	V350256906L3C003R05000704062_chr1_1308916	50	72	GCAC	CAGG
V350256906L3C003R05000778934	chr1	1179395	50M	158	1179553	1179396	1179554	V350256906L3C003R05000778934_chr1_1179395	53	60	CGGC	CCCA
V350256906L3C003R05000934488	chr1	1356723	50M	175	1356898	1356724	1356899	V350256906L3C003R05000934488_chr1_1356723	30	17	CCTG	AGCA
V350256906L3C003R05000963829	chr1	1162032	50M	177	1162209	1162033	1162210	V350256906L3C003R05000963829_chr1_1162032	0	0	CGCT	CGCC
V350256906L3C003R05001258822	chr1	231819	50M	166	231985	231820	231986	V350256906L3C003R05001258822_chr1_231819	195	29	ctgt	tgtg
V350256906L3C003R05100044841	chr1	838837	50M	161	838998	838838	838999	V350256906L3C003R05100044841_chr1_838837	0	3	tata	acag
V350256906L3C003R05100044842	chr1	838837	50M	161	838998	838838	838999	V350256906L3C003R05100044842_chr1_838837	0	3	tata	acag
V350256906L3C003R05100174367	chr1	165825	50M	165	165990	165826	165991	V350256906L3C003R05100174367_chr1_165825	52	0	CAAT	GCTG
V350256906L3C003R05100384386	chr1	549855	50M	162	550017	549856	550018	V350256906L3C003R05100384386_chr1_549855	0	62	TCCA	CTAT
V350256906L3C003R05100427374	chr1	1221085	50M	157	1221242	1221086	1221243	V350256906L3C003R05100427374_chr1_1221085	44	47	AGCA	TGTC
V350256906L3C003R05101054373	chr1	789698	50M	159	789857	789699	789858	V350256906L3C003R05101054373_chr1_789698	36	0	ATTT	TGCA
V350256906L3C003R05200546283	chr1	989107	50M	177	989284	989108	989285	V350256906L3C003R05200546283_chr1_989107	30	0	GCCC	CAGG
V350256906L3C003R05200605514	chr1	456896	50M	176	457072	456897	457073	V350256906L3C003R05200605514_chr1_456896	68	51	ccac	tcca
V350256906L3C003R05200631615	chr1	108846	50M	205	109051	108847	109052	V350256906L3C003R05200631615_chr1_108846	146	44	GAGG	CCCT
V350256906L3C003R05201088583	chr1	1150825	50M	149	1150974	1150826	1150975	V350256906L3C003R05201088583_chr1_1150825	19	43	CCCT	AGCT
V350256906L3C003R05201193933	chr1	1386196	50M	197	1386393	1386197	1386394	V350256906L3C003R05201193933_chr1_1386196	117	13	GATT	TCAA
V350256906L3C003R05201306269	chr1	84514	50M	232	84746	84515	84747	V350256906L3C003R05201306269_chr1_84514	9	66	taca	tgat
V350256906L3C003R05201316650	chr1	903444	50M	190	903634	903445	903635	V350256906L3C003R05201316650_chr1_903444	44	38	CCGG	CCCT
V350256906L3C003R05201344449	chr1	839114	50M	156	839270	839115	839271	V350256906L3C003R05201344449_chr1_839114	68	52	TCCA	CTTC
V350256906L3C003R05300202359	chr1	460470	50M	168	460638	460471	460639	V350256906L3C003R05300202359_chr1_460470	53	55	AAGC	ccaa
V350256906L3C003R05300259338	chr1	145700	50M	178	145878	145701	145879	V350256906L3C003R05300259338_chr1_145700	49	41	ctga	gtca
V350256906L3C003R05301235203	chr1	1211858	50M	182	1212040	1211859	1212041	V350256906L3C003R05301235203_chr1_1211858	61	85	aaaa	caaa
V350256906L3C003R05400344997	chr1	1128703	50M	138	1128841	1128704	1128842	V350256906L3C003R05400344997_chr1_1128703	31	3	tcaa	gaaa
V350256906L3C003R05400542578	chr1	349495	50M	168	349663	349496	349664	V350256906L3C003R05400542578_chr1_349495	6	0	caga	AGAA
V350256906L3C003R05400573229	chr1	690959	50M	184	691143	690960	691144	V350256906L3C003R05400573229_chr1_690959	41	72	tttt	CAGT
V350256906L3C003R05400606231	chr1	1171469	50M	169	1171638	1171470	1171639	V350256906L3C003R05400606231_chr1_1171469	0	0	ACCA	GGGC
V350256906L3C003R05400910504	chr1	1402972	50M	151	1403123	1402973	1403124	V350256906L3C003R05400910504_chr1_1402972	65	55	CCTG	CCAT
V350256906L3C003R05500051710	chr1	75900	50M	152	76052	75901	76053	V350256906L3C003R05500051710_chr1_75900	31	55	taca	gtag
V350256906L3C003R05500139060	chr1	419383	50M	170	419553	419384	419554	V350256906L3C003R05500139060_chr1_419383	26	92	ccct	CAAA
V350256906L3C003R05500313396	chr1	1065302	50M	199	1065501	1065303	1065502	V350256906L3C003R05500313396_chr1_1065302	6	13	CGGA	ccgc
V350256906L3C003R05500414078	chr1	432515	50M	94	432609	432516	432610	V350256906L3C003R05500414078_chr1_432515	6	8	CATC	tctg
V350256906L3C003R05501009917	chr1	165854	50M	159	166013	165855	166014	V350256906L3C003R05501009917_chr1_165854	23	12	TCTT	TATG
V350256906L3C003R05501042523	chr1	404455	50M	141	404596	404456	404597	V350256906L3C003R05501042523_chr1_404455	96	237	ctgc	CCCC
V350256906L3C003R05501148760	chr1	12838	50M	176	13014	12839	13015	V350256906L3C003R05501148760_chr1_12838	134	0	TGTG	CCAG
V350256906L3C003R05501186827	chr1	241071	50M	194	241265	241072	241266	V350256906L3C003R05501186827_chr1_241071	83	59	tcat	cgtg
V350256906L3C003R05501300180	chr1	1069297	50M	125	1069422	1069298	1069423	V350256906L3C003R05501300180_chr1_1069297	74	0	tact	cccc
V350256906L3C003R05600054838	chr1	842513	50M	160	842673	842514	842674	V350256906L3C003R05600054838_chr1_842513	0	20	CTTC	taag
V350256906L3C003R05600068325	chr1	35670	50M	159	35829	35671	35830	V350256906L3C003R05600068325_chr1_35670	0	26	CATC	TGTG
V350256906L3C003R05600464243	chr1	661806	50M	164	661970	661807	661971	V350256906L3C003R05600464243_chr1_661806	144	308	TGCT	CTCC
V350256906L3C003R05600649868	chr1	1122846	50M	198	1123044	1122847	1123045	V350256906L3C003R05600649868_chr1_1122846	105	107	ctaa	caaa
V350256906L3C003R05600829842	chr1	1065943	50M	175	1066118	1065944	1066119	V350256906L3C003R05600829842_chr1_1065943	56	9	taat	cgcc
V350256906L3C003R05600995363	chr1	1333610	50M	190	1333800	1333611	1333801	V350256906L3C003R05600995363_chr1_1333610	41	70	CACT	GCCC
V350256906L3C003R05601005384	chr1	1354989	50M	189	1355178	1354990	1355179	V350256906L3C003R05601005384_chr1_1354989	57	47	CCAG	CCCC
V350256906L3C003R05700003000	chr1	803156	50M	165	803321	803157	803322	V350256906L3C003R05700003000_chr1_803156	52	81	AGAG	AACT
V350256906L3C003R05700020817	chr1	384042	50M	165	384207	384043	384208	V350256906L3C003R05700020817_chr1_384042	57	0	agtt	CCTt
V350256906L3C003R05700030058	chr1	995994	50M	151	996145	995995	996146	V350256906L3C003R05700030058_chr1_995994	20	51	ggcg	TCCA
V350256906L3C003R05700229661	chr1	914324	50M	174	914498	914325	914499	V350256906L3C003R05700229661_chr1_914324	26	28	CCGC	CGAG
V350256906L3C003R05701256133	chr1	687594	50M	148	687742	687595	687743	V350256906L3C003R05701256133_chr1_687594	25	0	CCCA	gcct
V350256906L3C003R05800028885	chr1	791583	50M	174	791757	791584	791758	V350256906L3C003R05800028885_chr1_791583	0	0	CCCC	CACG
V350256906L3C003R05800334317	chr1	901101	50M	186	901287	901102	901288	V350256906L3C003R05800334317_chr1_901101	25	46	GCTG	CCAC
V350256906L3C003R05800357663	chr1	705105	50M	167	705272	705106	705273	V350256906L3C003R05800357663_chr1_705105	66	160	acat	cctc
V350256906L3C003R05800541614	chr1	1189186	50M	185	1189371	1189187	1189372	V350256906L3C003R05800541614_chr1_1189186	15	46	CACC	CTCT
V350256906L3C003R05800633922	chr1	956483	50M	170	956653	956484	956654	V350256906L3C003R05800633922_chr1_956483	27	18	CCTG	CGGG
V350256906L3C003R05800679875	chr1	247908	50M	153	248061	247909	248062	V350256906L3C003R05800679875_chr1_247908	7	160	ccca	gttc
V350256906L3C003R05800771911	chr1	1134567	50M	166	1134733	1134568	1134734	V350256906L3C003R05800771911_chr1_1134567	41	79	TGGA	CCCA
V350256906L3C003R05800894330	chr1	31600	50M	147	31747	31601	31748	V350256906L3C003R05800894330_chr1_31600	50	197	ccca	gatt
V350256906L3C003R05900127203	chr1	1070242	50M	170	1070412	1070243	1070413	V350256906L3C003R05900127203_chr1_1070242	36	32	CCCT	TCTG
V350256906L3C003R05900415178	chr1	714634	50M	149	714783	714635	714784	V350256906L3C003R05900415178_chr1_714634	0	122	TAGC	ctcg
V350256906L3C003R05900803401	chr1	138783	50M	171	138954	138784	138955	V350256906L3C003R05900803401_chr1_138783	47	54	CCAT	CCTC
V350256906L3C003R05901273330	chr1	1200836	50M	153	1200989	1200837	1200990	V350256906L3C003R05901273330_chr1_1200836	58	63	ctgc	acac
V350256906L3C003R05901310753	chr1	583080	50M	165	583245	583081	583246	V350256906L3C003R05901310753_chr1_583080	336	171	agtg	CCCA
V350256906L3C003R05901364367	chr1	726825	18S22M10S	200	727025	726826	727026	V350256906L3C003R05901364367_chr1_726825	0	0	gaat	catt
V350256906L3C003R06000185617	chr1	930448	50M	180	930628	930449	930629	V350256906L3C003R06000185617_chr1_930448	74	71	ggct	cccg
V350256906L3C003R06000612807	chr1	1166030	50M	177	1166207	1166031	1166208	V350256906L3C003R06000612807_chr1_1166030	26	30	ggtt	GGGA
V350256906L3C003R06000747231	chr1	652464	50M	187	652651	652465	652652	V350256906L3C003R06000747231_chr1_652464	31	83	atga	ctat
V350256906L3C003R06000874588	chr1	41748	50M	159	41907	41749	41908	V350256906L3C003R06000874588_chr1_41748	537	641	ccct	tatt
V350256906L3C003R06100087262	chr1	458451	50M	149	458600	458452	458601	V350256906L3C003R06100087262_chr1_458451	89	92	tggc	cctc
V350256906L3C003R06100638960	chr1	820415	50M	168	820583	820416	820584	V350256906L3C003R06100638960_chr1_820415	172	32	cctt	cttc
V350256906L3C003R06100881683	chr1	470557	50M	168	470725	470558	470726	V350256906L3C003R06100881683_chr1_470557	59	85	ggtt	taaa
V350256906L3C003R06200100128	chr1	989156	50M	146	989302	989157	989303	V350256906L3C003R06200100128_chr1_989156	58	16	ACTT	CACC
V350256906L3C003R06200112957	chr1	927614	50M	173	927787	927615	927788	V350256906L3C003R06200112957_chr1_927614	26	38	actg	cctg
V350256906L3C003R06200259187	chr1	232498	50M	154	232652	232499	232653	V350256906L3C003R06200259187_chr1_232498	54	40	CACA	AAGG
V350256906L3C003R06200901382	chr1	423445	50M	143	423588	423446	423589	V350256906L3C003R06200901382_chr1_423445	0	99	aaaa	tggc
V350256906L3C003R06200942002	chr1	55874	50M	156	56030	55875	56031	V350256906L3C003R06200942002_chr1_55874	44	57	AATG	AAAG
V350256906L3C003R06300141932	chr1	1305824	50M	147	1305971	1305825	1305972	V350256906L3C003R06300141932_chr1_1305824	59	46	gctc	CTCA
V350256906L3C003R06301279105	chr1	88175	50M	181	88356	88176	88357	V350256906L3C003R06301279105_chr1_88175	49	56	ctgg	ggag
V350256906L3C003R06301315534	chr1	239069	50M	197	239266	239070	239267	V350256906L3C003R06301315534_chr1_239069	58	21	cgtt	TAAA
V350256906L3C003R06400118531	chr1	969871	50M	156	970027	969872	970028	V350256906L3C003R06400118531_chr1_969871	197	167	CCAA	GGCA
V350256906L3C003R06400340602	chr1	997193	50M	146	997339	997194	997340	V350256906L3C003R06400340602_chr1_997193	55	0	CCCA	CCTG
V350256906L3C003R06400623723	chr1	754277	50M	134	754411	754278	754412	V350256906L3C003R06400623723_chr1_754277	0	133	CTAT	CATC
V350256906L3C003R06401031031	chr1	651831	50M	162	651993	651832	651994	V350256906L3C003R06401031031_chr1_651831	5	167	CATA	CACA
V350256906L3C003R06401186215	chr1	466478	50M	172	466650	466479	466651	V350256906L3C003R06401186215_chr1_466478	66	76	CCAA	AAAA
V350256906L3C003R06500297694	chr1	868176	50M	169	868345	868177	868346	V350256906L3C003R06500297694_chr1_868176	0	34	GCCA	CGCC
V350256906L3C003R06500607851	chr1	16349	50M	179	16528	16350	16529	V350256906L3C003R06500607851_chr1_16349	104	145	CCCC	GGTC
V350256906L3C003R06500724759	chr1	846592	50M	164	846756	846593	846757	V350256906L3C003R06500724759_chr1_846592	0	0	GCAG	CACC
V350256906L3C003R06500956358	chr1	232474	50M	194	232668	232475	232669	V350256906L3C003R06500956358_chr1_232474	57	56	cgta	TAAC
V350256906L3C003R06501163710	chr1	391264	50M	183	391447	391265	391448	V350256906L3C003R06501163710_chr1_391264	154	110	caat	ccat
V350256906L3C003R06501371557	chr1	983591	50M	182	983773	983592	983774	V350256906L3C003R06501371557_chr1_983591	0	28	TGTG	GCCC
V350256906L3C003R06600684747	chr1	1048055	50M	167	1048222	1048056	1048223	V350256906L3C003R06600684747_chr1_1048055	283	116	cgcc	cttg
V350256906L3C003R06600916013	chr1	1368151	50M	197	1368348	1368152	1368349	V350256906L3C003R06600916013_chr1_1368151	9	17	CCCC	CACA
V350256906L3C003R06601292090	chr1	727853	50M	168	728021	727854	728022	V350256906L3C003R06601292090_chr1_727853	0	0	cgta	agag
V350256906L3C003R06601396672	chr1	61058	50M	165	61223	61059	61224	V350256906L3C003R06601396672_chr1_61058	188	94	AAGA	TCAA
V350256906L3C003R06700354743	chr1	238165	50M	202	238367	238166	238368	V350256906L3C003R06700354743_chr1_238165	39	47	catg	gaga
V350256906L3C003R06700693437	chr1	158386	50M	182	158568	158387	158569	V350256906L3C003R06700693437_chr1_158386	113	223	TAAT	CCAG
V350256906L3C003R06700786955	chr1	134927	50M	153	135080	134928	135081	V350256906L3C003R06700786955_chr1_134927	81	234	GGAA	CCAG
V350256906L3C003R06701094429	chr1	463184	50M	147	463331	463185	463332	V350256906L3C003R06701094429_chr1_463184	236	128	gact	AGTA
V350256906L3C003R06701177520	chr1	227943	50M	186	228129	227944	228130	V350256906L3C003R06701177520_chr1_227943	98	29	cttg	gttt
V350256906L3C003R06701342958	chr1	1290027	50M	160	1290187	1290028	1290188	V350256906L3C003R06701342958_chr1_1290027	0	0	CCCG	CCAC
V350256906L3C003R06800282414	chr1	973909	50M	143	974052	973910	974053	V350256906L3C003R06800282414_chr1_973909	39	0	CTAT	CCAG
V350256906L3C003R06800295149	chr1	1131717	50M	179	1131896	1131718	1131897	V350256906L3C003R06800295149_chr1_1131717	11	55	ctca	CACC
V350256906L3C003R06800365575	chr1	557095	50M	181	557276	557096	557277	V350256906L3C003R06800365575_chr1_557095	168	349	TGGC	GCCG
V350256906L3C003R06800806010	chr1	1375932	50M	140	1376072	1375933	1376073	V350256906L3C003R06800806010_chr1_1375932	16	61	ACCA	CGCC
V350256906L3C003R06800830835	chr1	1338097	50M	173	1338270	1338098	1338271	V350256906L3C003R06800830835_chr1_1338097	66	68	tctc	ccca
V350256906L3C003R06801233505	chr1	1003509	50M	149	1003658	1003510	1003659	V350256906L3C003R06801233505_chr1_1003509	63	39	GCCT	GGAG
V350256906L3C003R06801345632	chr1	415895	50M	210	416105	415896	416106	V350256906L3C003R06801345632_chr1_415895	83	48	AGTT	AAAG
V350256906L3C003R06900330703	chr1	645364	50M	167	645531	645365	645532	V350256906L3C003R06900330703_chr1_645364	24	119	acaa	TGAT
V350256906L3C003R06900709371	chr1	809577	50M	149	809726	809578	809727	V350256906L3C003R06900709371_chr1_809577	49	31	CTCC	GCCA
V350256906L3C003R06901119780	chr1	725907	19S31M	124	726031	725908	726032	V350256906L3C003R06901119780_chr1_725907	0	106	gaat	agtc
V350256906L3C003R06901323811	chr1	1396415	50M	176	1396591	1396416	1396592	V350256906L3C003R06901323811_chr1_1396415	3	54	CCCT	cgcc
V350256906L3C003R07000114063	chr1	1127493	50M	172	1127665	1127494	1127666	V350256906L3C003R07000114063_chr1_1127493	0	0	tgtt	ctaa
V350256906L3C003R07000263704	chr1	1030979	50M	194	1031173	1030980	1031174	V350256906L3C003R07000263704_chr1_1030979	5	0	tgtc	gacg
V350256906L3C003R07001230375	chr1	175717	50M	204	175921	175718	175922	V350256906L3C003R07001230375_chr1_175717	62	128	tgag	cctg
V350256906L3C003R07001289856	chr1	1088524	50M	167	1088691	1088525	1088692	V350256906L3C003R07001289856_chr1_1088524	21	55	CCCA	TGGA
V350256906L3C003R07100002126	chr1	567630	50M	143	567773	567631	567774	V350256906L3C003R07100002126_chr1_567630	197	54	CTTC	AACG
V350256906L3C003R07100103919	chr1	725054	50M	197	725251	725055	725252	V350256906L3C003R07100103919_chr1_725054	84	18	ctcg	attc
V350256906L3C003R07100190231	chr1	597869	50M	193	598062	597870	598063	V350256906L3C003R07100190231_chr1_597869	60	31	acaa	tggc
V350256906L3C003R07100223097	chr1	95873	50M	171	96044	95874	96045	V350256906L3C003R07100223097_chr1_95873	0	3	GCCC	CCCA
V350256906L3C003R07100292153	chr1	320401	50M	154	320555	320402	320556	V350256906L3C003R07100292153_chr1_320401	234	94	GGGG	GTCA
V350256906L3C003R07100620665	chr1	1076202	50M	183	1076385	1076203	1076386	V350256906L3C003R07100620665_chr1_1076202	93	66	CAGA	CGCA
V350256906L3C003R07100884050	chr1	786632	50M	163	786795	786633	786796	V350256906L3C003R07100884050_chr1_786632	72	57	TGAT	AACC
V350256906L3C003R07200033525	chr1	124033	50M	170	124203	124034	124204	V350256906L3C003R07200033525_chr1_124033	0	15	cagt	taaa
V350256906L3C003R07200898031	chr1	113379	50M	188	113567	113380	113568	V350256906L3C003R07200898031_chr1_113379	108	49	ATTC	TATA
V350256906L3C003R07201091665	chr1	608254	50M	172	608426	608255	608427	V350256906L3C003R07201091665_chr1_608254	190	131	ccta	gcta
V350256906L3C003R07201303867	chr1	19819	50M	166	19985	19820	19986	V350256906L3C003R07201303867_chr1_19819	21	187	GCCT	ccct
V350256906L3C004R00100442894	chr1	868725	50M	104	868829	868726	868830	V350256906L3C004R00100442894_chr1_868725	12	45	AAGG	AGTG
V350256906L3C004R00101057907	chr1	915342	50M	178	915520	915343	915521	V350256906L3C004R00101057907_chr1_915342	20	0	CCTG	CATG
V350256906L3C004R00101163977	chr1	937433	50M	162	937595	937434	937596	V350256906L3C004R00101163977_chr1_937433	66	63	GGGG	cccc
V350256906L3C004R00101243292	chr1	1122884	50M	175	1123059	1122885	1123060	V350256906L3C004R00101243292_chr1_1122884	143	92	cttg	cctt
V350256906L3C004R00101321555	chr1	230011	50M	169	230180	230012	230181	V350256906L3C004R00101321555_chr1_230011	0	134	gcct	CCAA
V350256906L3C004R00200010565	chr1	129564	50M	160	129724	129565	129725	V350256906L3C004R00200010565_chr1_129564	207	153	acca	gggc
V350256906L3C004R00200098515	chr1	1186321	50M	195	1186516	1186322	1186517	V350256906L3C004R00200098515_chr1_1186321	53	38	GGAA	CGTG
V350256906L3C004R00200885206	chr1	1109723	50M	176	1109899	1109724	1109900	V350256906L3C004R00200885206_chr1_1109723	57	71	CACG	TACA
V350256906L3C004R00200894016	chr1	725607	42M8S	225	725832	725608	725833	V350256906L3C004R00200894016_chr1_725607	91	51	gaat	catt
V350256906L3C004R00201054207	chr1	359826	50M	156	359982	359827	359983	V350256906L3C004R00201054207_chr1_359826	0	14	AAAT	CATG
V350256906L3C004R00300655787	chr1	1332957	50M	265	1333222	1332958	1333223	V350256906L3C004R00300655787_chr1_1332957	120	40	ccca	ccag
V350256906L3C004R00300774709	chr1	603647	50M	168	603815	603648	603816	V350256906L3C004R00300774709_chr1_603647	522	470	acta	cccc
V350256906L3C004R00301325247	chr1	636949	50M	158	637107	636950	637108	V350256906L3C004R00301325247_chr1_636949	69	92	acat	tctc
V350256906L3C004R00301401502	chr1	100574	50M	159	100733	100575	100734	V350256906L3C004R00301401502_chr1_100574	56	33	CACC	CCAT
V350256906L3C004R00400009396	chr1	426159	50M	169	426328	426160	426329	V350256906L3C004R00400009396_chr1_426159	10	26	aggg	GACC
V350256906L3C004R00400194257	chr1	619028	50M	201	619229	619029	619230	V350256906L3C004R00400194257_chr1_619028	60	64	ccaa	ccct
V350256906L3C004R00400235312	chr1	229750	50M	166	229916	229751	229917	V350256906L3C004R00400235312_chr1_229750	2	63	agcc	ggca
V350256906L3C004R00400504447	chr1	1115752	50M	166	1115918	1115753	1115919	V350256906L3C004R00400504447_chr1_1115752	6	49	ACTG	CCGG
V350256906L3C004R00400884180	chr1	57791	50M	210	58001	57792	58002	V350256906L3C004R00400884180_chr1_57791	0	0	TTTT	GCTG
V350256906L3C004R00400908523	chr1	635595	50M	181	635776	635596	635777	V350256906L3C004R00400908523_chr1_635595	0	164	tagg	cttt
V350256906L3C004R00500025659	chr1	12484	50M	176	12660	12485	12661	V350256906L3C004R00500025659_chr1_12484	0	25	CTCT	CTGG
V350256906L3C004R00500424728	chr1	810720	50M	195	810915	810721	810916	V350256906L3C004R00500424728_chr1_810720	37	39	CCAA	AGAG
V350256906L3C004R00500648551	chr1	1228827	50M	165	1228992	1228828	1228993	V350256906L3C004R00500648551_chr1_1228827	32	16	CTGC	CGCA
V350256906L3C004R00501193027	chr1	1413726	50M	176	1413902	1413727	1413903	V350256906L3C004R00501193027_chr1_1413726	18	10	CCAA	GGTT
V350256906L3C004R00600489438	chr1	398922	50M	165	399087	398923	399088	V350256906L3C004R00600489438_chr1_398922	177	12	aaag	tgac
V350256906L3C004R00600792336	chr1	838841	50M	168	839009	838842	839010	V350256906L3C004R00600792336_chr1_838841	0	0	aaag	gggt
V350256906L3C004R00700099821	chr1	38937	50M	189	39126	38938	39127	V350256906L3C004R00700099821_chr1_38937	52	56	ggga	tctg
V350256906L3C004R00700452948	chr1	1034225	50M	162	1034387	1034226	1034388	V350256906L3C004R00700452948_chr1_1034225	58	59	cagg	caat
V350256906L3C004R00701142500	chr1	640408	50M	181	640589	640409	640590	V350256906L3C004R00701142500_chr1_640408	24	35	taag	gctc
V350256906L3C004R00800091896	chr1	1016725	50M	195	1016920	1016726	1016921	V350256906L3C004R00800091896_chr1_1016725	68	63	CGCG	GGTG
V350256906L3C004R00800148676	chr1	1183698	13S37M	99	1183797	1183699	1183798	V350256906L3C004R00800148676_chr1_1183698	56	26	AGGC	CCTG
V350256906L3C004R00800839051	chr1	165437	50M	181	165618	165438	165619	V350256906L3C004R00800839051_chr1_165437	77	258	ACAA	TGCA
V350256906L3C004R00801107820	chr1	423605	50M	179	423784	423606	423785	V350256906L3C004R00801107820_chr1_423605	116	295	tctc	taac
V350256906L3C004R00801376552	chr1	724932	47M3S	168	725100	724933	725101	V350256906L3C004R00801376552_chr1_724932	0	130	gaat	ttcc
V350256906L3C004R00900193241	chr1	648233	50M	164	648397	648234	648398	V350256906L3C004R00900193241_chr1_648233	71	62	CCGC	ACAC
V350256906L3C004R00900273744	chr1	1211649	50M	193	1211842	1211650	1211843	V350256906L3C004R00900273744_chr1_1211649	68	51	ggcc	tggt
V350256906L3C004R00900422977	chr1	1319983	50M	172	1320155	1319984	1320156	V350256906L3C004R00900422977_chr1_1319983	92	39	tttg	ccct
V350256906L3C004R00900823575	chr1	259863	50M	173	260036	259864	260037	V350256906L3C004R00900823575_chr1_259863	28	11	CCTA	tcat
V350256906L3C004R00901066865	chr1	44605	50M	167	44772	44606	44773	V350256906L3C004R00901066865_chr1_44605	350	517	cctg	tgca
V350256906L3C004R00901135100	chr1	146624	50M	175	146799	146625	146800	V350256906L3C004R00901135100_chr1_146624	42	34	ACAG	ggta
V350256906L3C004R01000086612	chr1	1212030	50M	163	1212193	1212031	1212194	V350256906L3C004R01000086612_chr1_1212030	75	0	tata	ggta
V350256906L3C004R01000367099	chr1	956952	50M	176	957128	956953	957129	V350256906L3C004R01000367099_chr1_956952	0	0	CCCC	CCTT
V350256906L3C004R01000448434	chr1	319245	50M	179	319424	319246	319425	V350256906L3C004R01000448434_chr1_319245	10	21	ctat	gaca
V350256906L3C004R01000467212	chr1	1063040	50M	174	1063214	1063041	1063215	V350256906L3C004R01000467212_chr1_1063040	66	75	GGCC	GGAA
V350256906L3C004R01000621704	chr1	528696	50M	178	528874	528697	528875	V350256906L3C004R01000621704_chr1_528696	63	50	TGCT	gtat
V350256906L3C004R01000742754	chr1	45207	50M	200	45407	45208	45408	V350256906L3C004R01000742754_chr1_45207	340	140	attg	tgca
V350256906L3C004R01001167072	chr1	1349009	50M	181	1349190	1349010	1349191	V350256906L3C004R01001167072_chr1_1349009	0	0	actg	ccct
V350256906L3C004R01001388228	chr1	594575	50M	170	594745	594576	594746	V350256906L3C004R01001388228_chr1_594575	0	0	TTTA	ggga
V350256906L3C004R01100013952	chr1	257783	50M	133	257916	257784	257917	V350256906L3C004R01100013952_chr1_257783	26	0	CCTA	AATT
V350256906L3C004R01100127931	chr1	725217	50M	139	725356	725218	725357	V350256906L3C004R01100127931_chr1_725217	52	19	ggat	atcc
V350256906L3C004R01100191169	chr1	872561	50M	172	872733	872562	872734	V350256906L3C004R01100191169_chr1_872561	174	2	CCTC	GGCC
V350256906L3C004R01100206324	chr1	872930	50M	195	873125	872931	873126	V350256906L3C004R01100206324_chr1_872930	0	67	GGTG	CCAC
V350256906L3C004R01100458374	chr1	813117	50M	181	813298	813118	813299	V350256906L3C004R01100458374_chr1_813117	120	301	CAGG	TGGC
V350256906L3C004R01101223052	chr1	344983	50M	184	345167	344984	345168	V350256906L3C004R01101223052_chr1_344983	68	56	taca	ggtg
V350256906L3C004R01101303359	chr1	43266	50M	171	43437	43267	43438	V350256906L3C004R01101303359_chr1_43266	65	236	ctca	tatt
V350256906L3C004R01200203022	chr1	827594	50M	177	827771	827595	827772	V350256906L3C004R01200203022_chr1_827594	67	73	ccaa	gcaa
V350256906L3C004R01200291834	chr1	1185217	50M	189	1185406	1185218	1185407	V350256906L3C004R01200291834_chr1_1185217	0	0	cccg	agca
V350256906L3C004R01200621178	chr1	51203	50M	167	51370	51204	51371	V350256906L3C004R01200621178_chr1_51203	155	4	CATG	CCCA
V350256906L3C004R01200772942	chr1	728409	50M	174	728583	728410	728584	V350256906L3C004R01200772942_chr1_728409	116	290	gctc	tcaa
V350256906L3C004R01201030733	chr1	79703	50M	181	79884	79704	79885	V350256906L3C004R01201030733_chr1_79703	61	69	acag	tggt
V350256906L3C004R01201192564	chr1	370443	50M	254	370697	370444	370698	V350256906L3C004R01201192564_chr1_370443	39	31	ccac	ggac
V350256906L3C004R01201192863	chr1	863441	50M	186	863627	863442	863628	V350256906L3C004R01201192863_chr1_863441	0	174	GAAG	ctaa
V350256906L3C004R01201340146	chr1	1392101	50M	205	1392306	1392102	1392307	V350256906L3C004R01201340146_chr1_1392101	40	21	AGCT	CCCA
V350256906L3C004R01300413320	chr1	1077609	50M	175	1077784	1077610	1077785	V350256906L3C004R01300413320_chr1_1077609	28	106	tttt	ctaa
V350256906L3C004R01301021682	chr1	360342	50M	189	360531	360343	360532	V350256906L3C004R01301021682_chr1_360342	63	79	GCCT	AATA
V350256906L3C004R01301078753	chr1	1417500	50M	141	1417641	1417501	1417642	V350256906L3C004R01301078753_chr1_1417500	11	0	CCTG	GGCG
V350256906L3C004R01400089118	chr1	680004	50M	182	680186	680005	680187	V350256906L3C004R01400089118_chr1_680004	162	119	ggtg	cctc
V350256906L3C004R01400126048	chr1	232548	50M	160	232708	232549	232709	V350256906L3C004R01400126048_chr1_232548	4	30	AGTA	AAAA
V350256906L3C004R01400192572	chr1	1094950	50M	183	1095133	1094951	1095134	V350256906L3C004R01400192572_chr1_1094950	112	56	TGGA	CCAG
V350256906L3C004R01400750408	chr1	610615	16S34M	194	610809	610616	610810	V350256906L3C004R01400750408_chr1_610615	31	13	TGTT	TGCT
V350256906L3C004R01400890053	chr1	555914	50M	141	556055	555915	556056	V350256906L3C004R01400890053_chr1_555914	33	40	cctt	ctga
V350256906L3C004R01400912471	chr1	167966	50M	187	168153	167967	168154	V350256906L3C004R01400912471_chr1_167966	0	105	GGAG	TCGT
V350256906L3C004R01401050868	chr1	1081245	50M	181	1081426	1081246	1081427	V350256906L3C004R01401050868_chr1_1081245	36	38	GGAG	CTCA
V350256906L3C004R01401076201	chr1	1390792	50M	176	1390968	1390793	1390969	V350256906L3C004R01401076201_chr1_1390792	39	50	TCCG	GGCC
V350256906L3C004R01401190261	chr1	37634	50M	203	37837	37635	37838	V350256906L3C004R01401190261_chr1_37634	215	284	TAGG	cgaa
V350256906L3C004R01401361041	chr1	724982	38M12S	142	725124	724983	725125	V350256906L3C004R01401361041_chr1_724982	12	145	gaat	tcca
V350256906L3C004R01500140976	chr1	901709	50M	194	901903	901710	901904	V350256906L3C004R01500140976_chr1_901709	27	0	CCCA	CGTA
V350256906L3C004R01500226831	chr1	1313328	50M	158	1313486	1313329	1313487	V350256906L3C004R01500226831_chr1_1313328	36	69	AGCG	CCGA
V350256906L3C004R01500720077	chr1	1199863	50M	145	1200008	1199864	1200009	V350256906L3C004R01500720077_chr1_1199863	97	15	TAAT	ccta
V350256906L3C004R01500771349	chr1	802382	50M	166	802548	802383	802549	V350256906L3C004R01500771349_chr1_802382	52	68	CTCA	AGGG
V350256906L3C004R01500971686	chr1	362450	50M	185	362635	362451	362636	V350256906L3C004R01500971686_chr1_362450	56	50	GCAT	TCTG
V350256906L3C004R01600306255	chr1	44351	50M	184	44535	44352	44536	V350256906L3C004R01600306255_chr1_44351	96	280	aatg	ccag
V350256906L3C004R01600357539	chr1	1140726	50M	189	1140915	1140727	1140916	V350256906L3C004R01600357539_chr1_1140726	64	63	CCCA	CCTC
V350256906L3C004R01600765469	chr1	782153	50M	155	782308	782154	782309	V350256906L3C004R01600765469_chr1_782153	11	0	CTGG	CTGG
V350256906L3C004R01601065884	chr1	1103230	50M	163	1103393	1103231	1103394	V350256906L3C004R01601065884_chr1_1103230	17	24	CCCC	cccC
V350256906L3C004R01601069580	chr1	259148	50M	145	259293	259149	259294	V350256906L3C004R01601069580_chr1_259148	64	33	TGAA	AAAC
V350256906L3C004R01601163789	chr1	1303022	29M4D21M	271	1303293	1303023	1303294	V350256906L3C004R01601163789_chr1_1303022	57	139	GGCA	cccc
V350256906L3C004R01601316767	chr1	125938	50M	163	126101	125939	126102	V350256906L3C004R01601316767_chr1_125938	17	25	CAAA	tgta
V350256906L3C004R01700067673	chr1	869242	50M	151	869393	869243	869394	V350256906L3C004R01700067673_chr1_869242	253	143	GGCA	CCCC
V350256906L3C004R01700084565	chr1	628179	50M	187	628366	628180	628367	V350256906L3C004R01700084565_chr1_628179	52	59	CAAG	TGTT
V350256906L3C004R01700447782	chr1	547504	50M	188	547692	547505	547693	V350256906L3C004R01700447782_chr1_547504	0	185	cggt	CAGG
V350256906L3C004R01700688643	chr1	246497	50M	166	246663	246498	246664	V350256906L3C004R01700688643_chr1_246497	12	17	caac	CTAA
V350256906L3C004R01700848500	chr1	1283278	50M	178	1283456	1283279	1283457	V350256906L3C004R01700848500_chr1_1283278	0	4	CCTT	GGCT
V350256906L3C004R01700887213	chr1	705281	50M	165	705446	705282	705447	V350256906L3C004R01700887213_chr1_705281	151	0	cgag	tggt
V350256906L3C004R01701211291	chr1	122045	50M	187	122232	122046	122233	V350256906L3C004R01701211291_chr1_122045	27	48	CCTG	CAAT
V350256906L3C004R01800306147	chr1	129651	50M	165	129816	129652	129817	V350256906L3C004R01800306147_chr1_129651	226	61	atcc	taca
V350256906L3C004R01800306899	chr1	121553	50M	181	121734	121554	121735	V350256906L3C004R01800306899_chr1_121553	43	45	acca	TAAA
V350256906L3C004R01800433043	chr1	689787	50M	181	689968	689788	689969	V350256906L3C004R01800433043_chr1_689787	8	11	taaa	gacc
V350256906L3C004R01800557760	chr1	329456	50M	179	329635	329457	329636	V350256906L3C004R01800557760_chr1_329456	61	0	CAGG	TGTG
V350256906L3C004R01801083008	chr1	767336	50M	180	767516	767337	767517	V350256906L3C004R01801083008_chr1_767336	57	53	TGAA	TGAA
V350256906L3C004R01801263796	chr1	1197724	50M	178	1197902	1197725	1197903	V350256906L3C004R01801263796_chr1_1197724	5	2	CCCG	TAGA
V350256906L3C004R01801303650	chr1	863396	50M	160	863556	863397	863557	V350256906L3C004R01801303650_chr1_863396	8	103	AGTC	gtga
V350256906L3C004R01801367402	chr1	158984	50M	200	159184	158985	159185	V350256906L3C004R01801367402_chr1_158984	0	16	gacc	CCAC
V350256906L3C004R01900141563	chr1	726686	50M	160	726846	726687	726847	V350256906L3C004R01900141563_chr1_726686	37	2	gaat	ccat
V350256906L3C004R01900172690	chr1	774922	50M	187	775109	774923	775110	V350256906L3C004R01900172690_chr1_774922	22	89	cgta	ccct
V350256906L3C004R01900280728	chr1	611032	50M	182	611214	611033	611215	V350256906L3C004R01900280728_chr1_611032	0	0	CAAA	TGCC
V350256906L3C004R01900417593	chr1	132415	50M	193	132608	132416	132609	V350256906L3C004R01900417593_chr1_132415	17	147	CCAC	CCAA
V350256906L3C004R01900565559	chr1	757231	50M	232	757463	757232	757464	V350256906L3C004R01900565559_chr1_757231	9	231	CCCT	CAGG
V350256906L3C004R01900628664	chr1	899782	50M	184	899966	899783	899967	V350256906L3C004R01900628664_chr1_899782	16	0	CGTG	CTCC
V350256906L3C004R01900700524	chr1	645931	50M	174	646105	645932	646106	V350256906L3C004R01900700524_chr1_645931	147	273	GGtg	catg
V350256906L3C004R01900857905	chr1	726318	50M	181	726499	726319	726500	V350256906L3C004R01900857905_chr1_726318	27	22	ggaa	ttgc
V350256906L3C004R02000164463	chr1	156632	50M	158	156790	156633	156791	V350256906L3C004R02000164463_chr1_156632	0	0	TATC	TGTC
V350256906L3C004R02000300123	chr1	177096	50M	163	177259	177097	177260	V350256906L3C004R02000300123_chr1_177096	153	316	ACGG	GGGA
V350256906L3C004R02000361018	chr1	933020	50M	145	933165	933021	933166	V350256906L3C004R02000361018_chr1_933020	0	0	CCCA	CCCC
V350256906L3C004R02000422988	chr1	687612	50M	169	687781	687613	687782	V350256906L3C004R02000422988_chr1_687612	43	15	tttt	gagc
V350256906L3C004R02000582216	chr1	1179903	50M	171	1180074	1179904	1180075	V350256906L3C004R02000582216_chr1_1179903	169	0	CACT	CACA
V350256906L3C004R02000849847	chr1	1394369	50M	188	1394557	1394370	1394558	V350256906L3C004R02000849847_chr1_1394369	23	151	ggtt	CCTC
V350256906L3C004R02100010775	chr1	12906	50M	172	13078	12907	13079	V350256906L3C004R02100010775_chr1_12906	103	39	GGCA	CCCA
V350256906L3C004R02100936598	chr1	171534	50M	185	171719	171535	171720	V350256906L3C004R02100936598_chr1_171534	71	0	CTGC	CTGT
V350256906L3C004R02101142494	chr1	602932	50M	150	603082	602933	603083	V350256906L3C004R02101142494_chr1_602932	11	23	tact	ctag
V350256906L3C004R02200469298	chr1	665611	50M	152	665763	665612	665764	V350256906L3C004R02200469298_chr1_665611	139	243	ccct	TAGG
V350256906L3C004R02200591893	chr1	820827	50M	176	821003	820828	821004	V350256906L3C004R02200591893_chr1_820827	0	0	tgtc	taaa
V350256906L3C004R02200965257	chr1	1011073	15M1D35M	176	1011249	1011074	1011250	V350256906L3C004R02200965257_chr1_1011073	0	0	TGAG	CCCC
V350256906L3C004R02201145081	chr1	1241387	50M	170	1241557	1241388	1241558	V350256906L3C004R02201145081_chr1_1241387	59	52	CCTG	TGTG
V350256906L3C004R02201246930	chr1	1200294	50M	192	1200486	1200295	1200487	V350256906L3C004R02201246930_chr1_1200294	51	38	CTAA	TCCC
V350256906L3C004R02201255906	chr1	436277	50M	179	436456	436278	436457	V350256906L3C004R02201255906_chr1_436277	19	27	CTGA	ggga
V350256906L3C004R02300046226	chr1	950511	50M	199	950710	950512	950711	V350256906L3C004R02300046226_chr1_950511	0	0	CGTG	CCAA
V350256906L3C004R02300271145	chr1	91596	50M	168	91764	91597	91765	V350256906L3C004R02300271145_chr1_91596	3	9	TCAC	agca
V350256906L3C004R02300389246	chr1	726343	2S24M24S	176	726519	726344	726520	V350256906L3C004R02300389246_chr1_726343	52	42	ggaa	ttcc
V350256906L3C004R02300601394	chr1	1270227	50M	225	1270452	1270228	1270453	V350256906L3C004R02300601394_chr1_1270227	66	20	TGTC	TGCT
V350256906L3C004R02300614754	chr1	397592	50M	198	397790	397593	397791	V350256906L3C004R02300614754_chr1_397592	94	75	CATG	CCTC
V350256906L3C004R02300752347	chr1	1378477	50M	165	1378642	1378478	1378643	V350256906L3C004R02300752347_chr1_1378477	79	25	ccac	TAGA
V350256906L3C004R02301144316	chr1	653575	50M	177	653752	653576	653753	V350256906L3C004R02301144316_chr1_653575	32	68	GAAA	ACCC
V350256906L3C004R02301203763	chr1	19248	50M	173	19421	19249	19422	V350256906L3C004R02301203763_chr1_19248	232	231	CGTG	CCCC
V350256906L3C004R02301359144	chr1	908457	50M	201	908658	908458	908659	V350256906L3C004R02301359144_chr1_908457	63	51	CCCT	CGGG
V350256906L3C004R02400923134	chr1	1281078	50M	179	1281257	1281079	1281258	V350256906L3C004R02400923134_chr1_1281078	0	0	CCAG	CAAG
V350256906L3C004R02400950951	chr1	15124	50M	176	15300	15125	15301	V350256906L3C004R02400950951_chr1_15124	50	47	CAGC	cacc
V350256906L3C004R02400968830	chr1	914289	50M	164	914453	914290	914454	V350256906L3C004R02400968830_chr1_914289	61	72	CTCT	CCAT
V350256906L3C004R02400977508	chr1	13063	50M	180	13243	13064	13244	V350256906L3C004R02400977508_chr1_13063	24	0	CTGC	CTTT
V350256906L3C004R02401322091	chr1	378630	50M	237	378867	378631	378868	V350256906L3C004R02401322091_chr1_378630	17	0	AGTT	CCCT
V350256906L3C004R02500786599	chr1	1382170	50M	144	1382314	1382171	1382315	V350256906L3C004R02500786599_chr1_1382170	49	23	cctg	ttac
V350256906L3C004R02500873502	chr1	172906	50M	168	173074	172907	173075	V350256906L3C004R02500873502_chr1_172906	155	38	acca	CCCA
V350256906L3C004R02501155026	chr1	887871	50M	176	888047	887872	888048	V350256906L3C004R02501155026_chr1_887871	0	0	CCCG	CCTG
V350256906L3C004R02501357791	chr1	1177617	50M	167	1177784	1177618	1177785	V350256906L3C004R02501357791_chr1_1177617	15	10	CCCT	GGCT
V350256906L3C004R02600063982	chr1	59833	50M	176	60009	59834	60010	V350256906L3C004R02600063982_chr1_59833	77	67	CATG	GTGA
V350256906L3C004R02600252907	chr1	619989	50M	169	620158	619990	620159	V350256906L3C004R02600252907_chr1_619989	6	76	TTAT	CCCT
V350256906L3C004R02600342285	chr1	639853	50M	179	640032	639854	640033	V350256906L3C004R02600342285_chr1_639853	0	11	CACA	TATT
V350256906L3C004R02600589665	chr1	1162667	50M	154	1162821	1162668	1162822	V350256906L3C004R02600589665_chr1_1162667	27	25	GGCC	cgca
V350256906L3C004R02601188724	chr1	1353803	50M	153	1353956	1353804	1353957	V350256906L3C004R02601188724_chr1_1353803	46	65	taga	accg
V350256906L3C004R02601385212	chr1	1073906	50M	170	1074076	1073907	1074077	V350256906L3C004R02601385212_chr1_1073906	60	59	cacc	CTAT
V350256906L3C004R02700086934	chr1	51947	50M	114	52061	51948	52062	V350256906L3C004R02700086934_chr1_51947	122	73	CAAA	CCCT
V350256906L3C004R02700445869	chr1	249348	50M	144	249492	249349	249493	V350256906L3C004R02700445869_chr1_249348	0	37	gcag	caag
V350256906L3C004R02700900498	chr1	652450	50M	158	652608	652451	652609	V350256906L3C004R02700900498_chr1_652450	17	40	caca	ccca
V350256906L3C004R02701058118	chr1	1332164	50M	140	1332304	1332165	1332305	V350256906L3C004R02701058118_chr1_1332164	0	8	tgtc	caaa
V350256906L3C004R02800253783	chr1	1082508	50M	176	1082684	1082509	1082685	V350256906L3C004R02800253783_chr1_1082508	62	57	ggtg	GGCT
V350256906L3C004R02800470975	chr1	121520	50M	154	121674	121521	121675	V350256906L3C004R02800470975_chr1_121520	76	54	cctc	ttta
V350256906L3C004R02800688286	chr1	65108	50M	203	65311	65109	65312	V350256906L3C004R02800688286_chr1_65108	0	141	CTAT	CCAC
V350256906L3C004R02800713193	chr1	555471	50M	166	555637	555472	555638	V350256906L3C004R02800713193_chr1_555471	84	58	gcaa	tata
V350256906L3C004R02800884920	chr1	1115333	50M	109	1115442	1115334	1115443	V350256906L3C004R02800884920_chr1_1115333	45	22	GGGA	CTCC
V350256906L3C004R02801169181	chr1	917417	50M	182	917599	917418	917600	V350256906L3C004R02801169181_chr1_917417	14	59	CAGG	TGTG
V350256906L3C004R02801178461	chr1	442628	50M	176	442804	442629	442805	V350256906L3C004R02801178461_chr1_442628	34	35	tcat	AAAA
V350256906L3C004R02801311768	chr1	108007	50M	197	108204	108008	108205	V350256906L3C004R02801311768_chr1_108007	59	39	gcat	ggaa
V350256906L3C004R02900044369	chr1	1065072	50M	161	1065233	1065073	1065234	V350256906L3C004R02900044369_chr1_1065072	0	26	GGAT	CTCG
V350256906L3C004R02900219738	chr1	60818	50M	198	61016	60819	61017	V350256906L3C004R02900219738_chr1_60818	0	146	AATC	CTGG
V350256906L3C004R02900483500	chr1	1036648	50M	230	1036878	1036649	1036879	V350256906L3C004R02900483500_chr1_1036648	80	44	aggc	AAAA
V350256906L3C004R02900610113	chr1	1127267	50M	161	1127428	1127268	1127429	V350256906L3C004R02900610113_chr1_1127267	0	47	caca	caaa
V350256906L3C004R02900655734	chr1	146649	50M	171	146820	146650	146821	V350256906L3C004R02900655734_chr1_146649	67	55	CTGT	cccc
V350256906L3C004R02900736832	chr1	317923	50M	169	318092	317924	318093	V350256906L3C004R02900736832_chr1_317923	87	246	agtt	CAAA
V350256906L3C004R02900795954	chr1	889175	50M	168	889343	889176	889344	V350256906L3C004R02900795954_chr1_889175	0	16	CGGC	TGGT
V350256906L3C004R02900809969	chr1	915820	50M	175	915995	915821	915996	V350256906L3C004R02900809969_chr1_915820	61	72	CCTG	AGAG
V350256906L3C004R02900865248	chr1	910361	50M	176	910537	910362	910538	V350256906L3C004R02900865248_chr1_910361	54	42	GTCA	ctct
V350256906L3C004R03000066687	chr1	638815	50M	205	639020	638816	639021	V350256906L3C004R03000066687_chr1_638815	20	66	gttt	CATA
V350256906L3C004R03000084464	chr1	980958	50M	140	981098	980959	981099	V350256906L3C004R03000084464_chr1_980958	91	11	CCCA	GGGA
V350256906L3C004R03000100763	chr1	1379171	50M	160	1379331	1379172	1379332	V350256906L3C004R03000100763_chr1_1379171	12	72	tctc	aggt
V350256906L3C004R03000136861	chr1	842642	50M	163	842805	842643	842806	V350256906L3C004R03000136861_chr1_842642	51	52	tgat	gctg
V350256906L3C004R03000610945	chr1	1358768	50M	152	1358920	1358769	1358921	V350256906L3C004R03000610945_chr1_1358768	76	17	agta	cacc
V350256906L3C004R03001058966	chr1	861683	50M	157	861840	861684	861841	V350256906L3C004R03001058966_chr1_861683	54	55	CCTG	CACT
V350256906L3C004R03100241759	chr1	1347274	50M	155	1347429	1347275	1347430	V350256906L3C004R03100241759_chr1_1347274	324	169	ccca	ccta
V350256906L3C004R03100458724	chr1	257369	50M	182	257551	257370	257552	V350256906L3C004R03100458724_chr1_257369	0	0	CCAC	ccag
V350256906L3C004R03100503487	chr1	1338066	50M	184	1338250	1338067	1338251	V350256906L3C004R03100503487_chr1_1338066	54	48	TTAA	ggca
V350256906L3C004R03100593847	chr1	693256	50M	164	693420	693257	693421	V350256906L3C004R03100593847_chr1_693256	72	51	atgg	ccag
V350256906L3C004R03100653833	chr1	923890	50M	184	924074	923891	924075	V350256906L3C004R03100653833_chr1_923890	0	153	cggg	ccag
V350256906L3C004R03100893943	chr1	1106730	50M	183	1106913	1106731	1106914	V350256906L3C004R03100893943_chr1_1106730	8	18	CCCT	CAGA
V350256906L3C004R03101126048	chr1	1253409	50M	161	1253570	1253410	1253571	V350256906L3C004R03101126048_chr1_1253409	7	0	gcta	tgtc
V350256906L3C004R03101334355	chr1	843170	50M	170	843340	843171	843341	V350256906L3C004R03101334355_chr1_843170	58	15	CCTC	TGGA
V350256906L3C004R03200626228	chr1	65799	50M	175	65974	65800	65975	V350256906L3C004R03200626228_chr1_65799	124	88	GCAA	ACCT
V350256906L3C004R03200652491	chr1	1018211	50M	167	1018378	1018212	1018379	V350256906L3C004R03200652491_chr1_1018211	65	0	CGCC	CCCG
V350256906L3C004R03200654005	chr1	60042	50M	165	60207	60043	60208	V350256906L3C004R03200654005_chr1_60042	46	60	TATA	ATGG
V350256906L3C004R03200979980	chr1	1268372	50M	161	1268533	1268373	1268534	V350256906L3C004R03200979980_chr1_1268372	12	47	CGTG	ACGC
V350256906L3C004R03201028673	chr1	232842	50M	229	233071	232843	233072	V350256906L3C004R03201028673_chr1_232842	77	88	TGTT	TGAA
V350256906L3C004R03300055613	chr1	242863	50M	165	243028	242864	243029	V350256906L3C004R03300055613_chr1_242863	48	58	TGAG	CCCC
V350256906L3C004R03300329619	chr1	1032552	50M	170	1032722	1032553	1032723	V350256906L3C004R03300329619_chr1_1032552	0	77	tctc	cttg
V350256906L3C004R03300529921	chr1	927547	50M	170	927717	927548	927718	V350256906L3C004R03300529921_chr1_927547	8	7	gttt	caac
V350256906L3C004R03300625635	chr1	816447	50M	171	816618	816448	816619	V350256906L3C004R03300625635_chr1_816447	5	64	agtt	ctaa
V350256906L3C004R03300786532	chr1	228051	44M6S	160	228211	228052	228212	V350256906L3C004R03300786532_chr1_228051	33	111	gtta	taag
V350256906L3C004R03400250193	chr1	1023039	50M	166	1023205	1023040	1023206	V350256906L3C004R03400250193_chr1_1023039	53	92	GGGA	GGAG
V350256906L3C004R03400638338	chr1	650833	50M	150	650983	650834	650984	V350256906L3C004R03400638338_chr1_650833	19	96	CTAA	tggc
V350256906L3C004R03400770510	chr1	852663	50M	168	852831	852664	852832	V350256906L3C004R03400770510_chr1_852663	123	45	CCCA	GGAG
V350256906L3C004R03401036954	chr1	1344995	50M	181	1345176	1344996	1345177	V350256906L3C004R03401036954_chr1_1344995	62	6	ggta	catc
V350256906L3C004R03401171346	chr1	1039319	50M	152	1039471	1039320	1039472	V350256906L3C004R03401171346_chr1_1039319	0	0	ccaa	gcgt
V350256906L3C004R03401326775	chr1	1221702	50M	191	1221893	1221703	1221894	V350256906L3C004R03401326775_chr1_1221702	2	27	CCTT	GAGG
V350256906L3C004R03500241000	chr1	1064866	50M	190	1065056	1064867	1065057	V350256906L3C004R03500241000_chr1_1064866	18	16	TTTG	CCCT
V350256906L3C004R03500982068	chr1	1197313	50M	151	1197464	1197314	1197465	V350256906L3C004R03500982068_chr1_1197313	87	37	ctgc	ggag
V350256906L3C004R03501038732	chr1	691172	50M	166	691338	691173	691339	V350256906L3C004R03501038732_chr1_691172	54	82	TTCA	AGTC
V350256906L3C004R03501081754	chr1	132283	50M	126	132409	132284	132410	V350256906L3C004R03501081754_chr1_132283	0	23	GCCC	AGCC
V350256906L3C004R03600008270	chr1	1130574	50M	182	1130756	1130575	1130757	V350256906L3C004R03600008270_chr1_1130574	84	22	ttgg	ctag
V350256906L3C004R03600156006	chr1	924421	50M	236	924657	924422	924658	V350256906L3C004R03600156006_chr1_924421	43	38	CGTG	ACCC
V350256906L3C004R03600504876	chr1	932904	50M	170	933074	932905	933075	V350256906L3C004R03600504876_chr1_932904	65	50	CTGA	CCCC
V350256906L3C004R03600573174	chr1	668961	50M	184	669145	668962	669146	V350256906L3C004R03600573174_chr1_668961	226	42	acac	CCAC
V350256906L3C004R03600765053	chr1	129616	50M	169	129785	129617	129786	V350256906L3C004R03600765053_chr1_129616	259	92	tggc	ccag
V350256906L3C004R03600950947	chr1	746518	50M	165	746683	746519	746684	V350256906L3C004R03600950947_chr1_746518	60	23	CAGC	TAAC
V350256906L3C004R03601145655	chr1	124454	50M	171	124625	124455	124626	V350256906L3C004R03601145655_chr1_124454	14	110	TATA	tcct
V350256906L3C004R03601229090	chr1	758884	50M	199	759083	758885	759084	V350256906L3C004R03601229090_chr1_758884	241	42	CACT	CACT
V350256906L3C004R03601258462	chr1	727296	50M	163	727459	727297	727460	V350256906L3C004R03601258462_chr1_727296	45	0	aatg	TTTC
V350256906L3C004R03700423926	chr1	1022139	50M	164	1022303	1022140	1022304	V350256906L3C004R03700423926_chr1_1022139	9	20	AGAG	CGTA
V350256906L3C004R03700713177	chr1	822523	50M	169	822692	822524	822693	V350256906L3C004R03700713177_chr1_822523	0	0	tgag	ACCA
V350256906L3C004R03701098252	chr1	122735	50M	180	122915	122736	122916	V350256906L3C004R03701098252_chr1_122735	18	12	AACG	GAGG
V350256906L3C004R03701294577	chr1	105302	50M	189	105491	105303	105492	V350256906L3C004R03701294577_chr1_105302	0	0	GAAT	TCTG
V350256906L3C004R03800618976	chr1	849821	50M	185	850006	849822	850007	V350256906L3C004R03800618976_chr1_849821	50	63	CCAG	cact
V350256906L3C004R03800668339	chr1	1314871	50M	176	1315047	1314872	1315048	V350256906L3C004R03800668339_chr1_1314871	86	59	ggtg	cccg
V350256906L3C004R03801117417	chr1	242043	50M	188	242231	242044	242232	V350256906L3C004R03801117417_chr1_242043	23	108	CCCA	CTTG
V350256906L3C004R03900222271	chr1	1322331	50M	155	1322486	1322332	1322487	V350256906L3C004R03900222271_chr1_1322331	0	0	ATTG	GGAT
V350256906L3C004R03900512034	chr1	825024	50M	184	825208	825025	825209	V350256906L3C004R03900512034_chr1_825024	6	30	ccca	actc
V350256906L3C004R03900951511	chr1	20034	50M	193	20227	20035	20228	V350256906L3C004R03900951511_chr1_20034	236	94	ctca	ctgt
V350256906L3C004R03900994078	chr1	122952	50M	160	123112	122953	123113	V350256906L3C004R03900994078_chr1_122952	49	5	CAAA	acac
V350256906L3C004R03901356220	chr1	1425939	50M	166	1426105	1425940	1426106	V350256906L3C004R03901356220_chr1_1425939	31	46	CCAG	TCTC
V350256906L3C004R04000015949	chr1	1376468	50M	204	1376672	1376469	1376673	V350256906L3C004R04000015949_chr1_1376468	58	53	CCAC	TGGG
V350256906L3C004R04000119208	chr1	686551	50M	172	686723	686552	686724	V350256906L3C004R04000119208_chr1_686551	46	83	cagc	cctg
V350256906L3C004R04000560770	chr1	1073000	50M	177	1073177	1073001	1073178	V350256906L3C004R04000560770_chr1_1073000	13	6	aacg	gagg
V350256906L3C004R04001175350	chr1	933304	50M	180	933484	933305	933485	V350256906L3C004R04001175350_chr1_933304	33	24	CACG	AGGC
V350256906L3C004R04100379511	chr1	97497	19M4D31M	221	97718	97498	97719	V350256906L3C004R04100379511_chr1_97497	13	0	CCAC	GGAG
V350256906L3C004R04100381748	chr1	1144771	50M	166	1144937	1144772	1144938	V350256906L3C004R04100381748_chr1_1144771	76	49	CCCA	gaCT
V350256906L3C004R04100480180	chr1	48392	50M	194	48586	48393	48587	V350256906L3C004R04100480180_chr1_48392	53	64	CTAA	ccat
V350256906L3C004R04101153613	chr1	246112	50M	174	246286	246113	246287	V350256906L3C004R04101153613_chr1_246112	0	0	CATA	tcat
V350256906L3C004R04101168235	chr1	926636	50M	144	926780	926637	926781	V350256906L3C004R04101168235_chr1_926636	17	161	cctc	agcc
V350256906L3C004R04200055838	chr1	588067	50M	142	588209	588068	588210	V350256906L3C004R04200055838_chr1_588067	48	21	catt	taaa
V350256906L3C004R04200108376	chr1	902037	50M	181	902218	902038	902219	V350256906L3C004R04200108376_chr1_902037	34	45	CCAC	CCCA
V350256906L3C004R04200859818	chr1	146677	50M	138	146815	146678	146816	V350256906L3C004R04200859818_chr1_146677	56	50	CAAT	cagt
V350256906L3C004R04201398838	chr1	469316	50M	142	469458	469317	469459	V350256906L3C004R04201398838_chr1_469316	71	43	tgtg	cagt
V350256906L3C004R04300363119	chr1	427897	50M	204	428101	427898	428102	V350256906L3C004R04300363119_chr1_427897	115	43	ccca	TTTC
V350256906L3C004R04300617761	chr1	1134242	50M	170	1134412	1134243	1134413	V350256906L3C004R04300617761_chr1_1134242	0	0	CCCT	GCTG
V350256906L3C004R04300932838	chr1	685274	50M	163	685437	685275	685438	V350256906L3C004R04300932838_chr1_685274	53	1	ggag	CTTC
V350256906L3C004R04400429703	chr1	828009	50M	142	828151	828010	828152	V350256906L3C004R04400429703_chr1_828009	29	63	cgta	cagg
V350256906L3C004R04400459243	chr1	1418539	50M	157	1418696	1418540	1418697	V350256906L3C004R04400459243_chr1_1418539	38	9	tggg	tttg
V350256906L3C004R04400510633	chr1	917242	50M	159	917401	917243	917402	V350256906L3C004R04400510633_chr1_917242	0	30	CCGC	TGGT
V350256906L3C004R04400570049	chr1	1172387	50M	161	1172548	1172388	1172549	V350256906L3C004R04400570049_chr1_1172387	168	85	TTCC	TCTC
V350256906L3C004R04400709780	chr1	385500	50M	187	385687	385501	385688	V350256906L3C004R04400709780_chr1_385500	232	45	cccc	ccat
V350256906L3C004R04400723590	chr1	1113729	50M	182	1113911	1113730	1113912	V350256906L3C004R04400723590_chr1_1113729	70	71	cggg	ggag
V350256906L3C004R04401258358	chr1	845877	50M	158	846035	845878	846036	V350256906L3C004R04401258358_chr1_845877	183	119	CGCG	CTCA
V350256906L3C004R04500003095	chr1	49078	50M	190	49268	49079	49269	V350256906L3C004R04500003095_chr1_49078	0	5	caca	tttg
V350256906L3C004R04500322508	chr1	457283	50M	159	457442	457284	457443	V350256906L3C004R04500322508_chr1_457283	50	32	tttt	cctt
V350256906L3C004R04500439578	chr1	640959	50M	196	641155	640960	641156	V350256906L3C004R04500439578_chr1_640959	27	60	GTAG	GAAG
V350256906L3C004R04500506060	chr1	448615	50M	147	448762	448616	448763	V350256906L3C004R04500506060_chr1_448615	50	82	ggtt	attc
V350256906L3C004R04500577165	chr1	1068731	50M	167	1068898	1068732	1068899	V350256906L3C004R04500577165_chr1_1068731	56	48	GCCA	CAGC
V350256906L3C004R04500846888	chr1	260830	50M	217	261047	260831	261048	V350256906L3C004R04500846888_chr1_260830	38	145	taag	CCAT
V350256906L3C004R04500937891	chr1	235582	50M	171	235753	235583	235754	V350256906L3C004R04500937891_chr1_235582	178	75	GAGA	CTTA
V350256906L3C004R04501353528	chr1	232725	50M	149	232874	232726	232875	V350256906L3C004R04501353528_chr1_232725	13	86	TGTC	CCAT
V350256906L3C004R04600031604	chr1	581316	50M	164	581480	581317	581481	V350256906L3C004R04600031604_chr1_581316	0	1	ctcc	aatc
V350256906L3C004R04700378122	chr1	588289	50M	188	588477	588290	588478	V350256906L3C004R04700378122_chr1_588289	37	43	taaa	ggct
V350256906L3C004R04700473176	chr1	923674	50M	166	923840	923675	923841	V350256906L3C004R04700473176_chr1_923674	0	23	aaag	cgca
V350256906L3C004R04700854285	chr1	435861	50M	210	436071	435862	436072	V350256906L3C004R04700854285_chr1_435861	71	60	caat	cttt
V350256906L3C004R04701133467	chr1	435908	50M	178	436086	435909	436087	V350256906L3C004R04701133467_chr1_435908	24	45	gaga	cctg
V350256906L3C004R04800053224	chr1	725651	35M15S	186	725837	725652	725838	V350256906L3C004R04800053224_chr1_725651	135	46	ggaa	catt
V350256906L3C004R04800294845	chr1	620181	50M	165	620346	620182	620347	V350256906L3C004R04800294845_chr1_620181	53	64	TCCC	atca
V350256906L3C004R04800363907	chr1	1211052	50M	212	1211264	1211053	1211265	V350256906L3C004R04800363907_chr1_1211052	282	70	GGAT	cccc
V350256906L3C004R04800397083	chr1	1273263	50M	165	1273428	1273264	1273429	V350256906L3C004R04800397083_chr1_1273263	0	117	gcgg	CTTC
V350256906L3C004R04800448051	chr1	554559	50M	145	554704	554560	554705	V350256906L3C004R04800448051_chr1_554559	0	41	CACA	ccgg
V350256906L3C004R04800666489	chr1	339959	50M	192	340151	339960	340152	V350256906L3C004R04800666489_chr1_339959	77	57	CTCA	ccct
V350256906L3C004R04800977440	chr1	872844	50M	194	873038	872845	873039	V350256906L3C004R04800977440_chr1_872844	71	0	GGTA	CCCT
V350256906L3C004R04800990611	chr1	747663	50M	165	747828	747664	747829	V350256906L3C004R04800990611_chr1_747663	260	95	cacg	tgtt
V350256906L3C004R04801291609	chr1	108661	50M	164	108825	108662	108826	V350256906L3C004R04801291609_chr1_108661	28	167	catt	GGAA
V350256906L3C004R04900196544	chr1	641193	50M	164	641357	641194	641358	V350256906L3C004R04900196544_chr1_641193	22	83	AACT	TATA
V350256906L3C004R04900519022	chr1	124729	50M	167	124896	124730	124897	V350256906L3C004R04900519022_chr1_124729	214	158	ccag	TCAC
V350256906L3C004R04900721071	chr1	584735	50M	162	584897	584736	584898	V350256906L3C004R04900721071_chr1_584735	66	53	tgta	caaa
V350256906L3C004R04900898748	chr1	142838	50M	165	143003	142839	143004	V350256906L3C004R04900898748_chr1_142838	31	114	cacc	CCAT
V350256906L3C004R04901397174	chr1	56101	50M	171	56272	56102	56273	V350256906L3C004R04901397174_chr1_56101	128	63	TCTC	GGCA
V350256906L3C004R05000268740	chr1	1354170	50M	186	1354356	1354171	1354357	V350256906L3C004R05000268740_chr1_1354170	35	55	tgtt	TGTG
V350256906L3C004R05000458151	chr1	579974	50M	172	580146	579975	580147	V350256906L3C004R05000458151_chr1_579974	22	14	CCTC	ACAG
V350256906L3C004R05000611396	chr1	1335773	50M	164	1335937	1335774	1335938	V350256906L3C004R05000611396_chr1_1335773	17	0	CACA	TAAC
V350256906L3C004R05000790602	chr1	239789	50M	186	239975	239790	239976	V350256906L3C004R05000790602_chr1_239789	36	32	CCTC	GGGG
V350256906L3C004R05001181014	chr1	1183982	50M	144	1184126	1183983	1184127	V350256906L3C004R05001181014_chr1_1183982	11	0	CCCT	CGGC
V350256906L3C004R05100050997	chr1	965784	50M	150	965934	965785	965935	V350256906L3C004R05100050997_chr1_965784	117	0	tgct	CCAT
V350256906L3C004R05100431277	chr1	625845	50M	145	625990	625846	625991	V350256906L3C004R05100431277_chr1_625845	55	40	CCTA	agat
V350256906L3C004R05100478252	chr1	443277	50M	161	443438	443278	443439	V350256906L3C004R05100478252_chr1_443277	39	48	ggct	ACTC
V350256906L3C004R05100610795	chr1	32219	50M	156	32375	32220	32376	V350256906L3C004R05100610795_chr1_32219	6	89	TGGT	GTTT
V350256906L3C004R05101242492	chr1	1171801	50M	185	1171986	1171802	1171987	V350256906L3C004R05101242492_chr1_1171801	14	11	GGTC	CCGG
V350256906L3C004R05101268376	chr1	907932	50M	162	908094	907933	908095	V350256906L3C004R05101268376_chr1_907932	11	76	ggtc	gctc
V350256906L3C004R05200239139	chr1	1416760	50M	162	1416922	1416761	1416923	V350256906L3C004R05200239139_chr1_1416760	0	93	ggcc	CAAA
V350256906L3C004R05200630870	chr1	773374	50M	165	773539	773375	773540	V350256906L3C004R05200630870_chr1_773374	71	70	ccca	gctc
V350256906L3C004R05200688371	chr1	837330	50M	150	837480	837331	837481	V350256906L3C004R05200688371_chr1_837330	14	18	CTAT	CACC
V350256906L3C004R05201137479	chr1	630581	50M	163	630744	630582	630745	V350256906L3C004R05201137479_chr1_630581	25	42	GGAT	CCCA
V350256906L3C004R05201267685	chr1	632573	50M	171	632744	632574	632745	V350256906L3C004R05201267685_chr1_632573	16	160	ctat	tcag
V350256906L3C004R05201307961	chr1	1140927	50M	171	1141098	1140928	1141099	V350256906L3C004R05201307961_chr1_1140927	51	106	CAGG	GCAG
V350256906L3C004R05300427834	chr1	47017	50M	190	47207	47018	47208	V350256906L3C004R05300427834_chr1_47017	107	0	acaa	CGTG
V350256906L3C004R05300815588	chr1	1395440	10M1D40M	155	1395595	1395441	1395596	V350256906L3C004R05300815588_chr1_1395440	44	49	CGTG	tgtc
V350256906L3C004R05300853312	chr1	918272	50M	156	918428	918273	918429	V350256906L3C004R05300853312_chr1_918272	0	1	GCCA	GCAG
V350256906L3C004R05400142913	chr1	428373	50M	146	428519	428374	428520	V350256906L3C004R05400142913_chr1_428373	42	77	gtca	ccta
V350256906L3C004R05400507598	chr1	863156	50M	189	863345	863157	863346	V350256906L3C004R05400507598_chr1_863156	76	59	CTGT	CCAG
V350256906L3C004R05400723584	chr1	724936	50M	155	725091	724937	725092	V350256906L3C004R05400723584_chr1_724936	0	121	ggaa	attc
V350256906L3C004R05500262236	chr1	1068504	50M	234	1068738	1068505	1068739	V350256906L3C004R05500262236_chr1_1068504	86	49	CCTG	CCTT
V350256906L3C004R05500325392	chr1	725615	50M	217	725832	725616	725833	V350256906L3C004R05500325392_chr1_725615	99	51	cgga	catt
V350256906L3C004R05500485765	chr1	1132850	50M	187	1133037	1132851	1133038	V350256906L3C004R05500485765_chr1_1132850	54	54	CGCG	TGCG
V350256906L3C004R05501133388	chr1	388461	50M	176	388637	388462	388638	V350256906L3C004R05501133388_chr1_388461	79	64	aaag	gcca
V350256906L3C004R05501236541	chr1	351169	50M	189	351358	351170	351359	V350256906L3C004R05501236541_chr1_351169	0	148	ggca	CCTG
V350256906L3C004R05600089680	chr1	90854	50M	184	91038	90855	91039	V350256906L3C004R05600089680_chr1_90854	46	51	TCGC	gtag
V350256906L3C004R05600157726	chr1	103015	50M	168	103183	103016	103184	V350256906L3C004R05600157726_chr1_103015	140	27	aggg	cctg
V350256906L3C004R05600264209	chr1	121075	50M	169	121244	121076	121245	V350256906L3C004R05600264209_chr1_121075	0	135	atgt	ACAT
V350256906L3C004R05600361714	chr1	846272	50M	172	846444	846273	846445	V350256906L3C004R05600361714_chr1_846272	56	85	GGTC	AGCC
V350256906L3C004R05600394628	chr1	625009	50M	183	625192	625010	625193	V350256906L3C004R05600394628_chr1_625009	56	57	AGTG	CTTC
V350256906L3C004R05600429736	chr1	1034114	50M	177	1034291	1034115	1034292	V350256906L3C004R05600429736_chr1_1034114	19	10	cccg	gctg
V350256906L3C004R05600458024	chr1	20009	50M	214	20223	20010	20224	V350256906L3C004R05600458024_chr1_20009	211	98	tccc	gctg
V350256906L3C004R05600607358	chr1	718333	50M	142	718475	718334	718476	V350256906L3C004R05600607358_chr1_718333	0	79	ccat	ccat
V350256906L3C004R05600629161	chr1	988181	50M	176	988357	988182	988358	V350256906L3C004R05600629161_chr1_988181	116	30	tgta	ccca
V350256906L3C004R05600708072	chr1	1352631	50M	161	1352792	1352632	1352793	V350256906L3C004R05600708072_chr1_1352631	195	78	tgct	ccaa
V350256906L3C004R05600791326	chr1	1394811	50M	170	1394981	1394812	1394982	V350256906L3C004R05600791326_chr1_1394811	22	0	CCCG	CCAC
V350256906L3C004R05600838961	chr1	1156882	50M	176	1157058	1156883	1157059	V350256906L3C004R05600838961_chr1_1156882	49	30	tggc	TAGC
V350256906L3C004R05601127741	chr1	333817	50M	169	333986	333818	333987	V350256906L3C004R05601127741_chr1_333817	0	0	ctat	ACAC
V350256906L3C004R05601267651	chr1	677712	50M	167	677879	677713	677880	V350256906L3C004R05601267651_chr1_677712	48	0	ctgt	cctg
V350256906L3C004R05700377225	chr1	725716	45M5S	132	725848	725717	725849	V350256906L3C004R05700377225_chr1_725716	167	35	ggaa	tgag
V350256906L3C004R05700388005	chr1	133260	50M	178	133438	133261	133439	V350256906L3C004R05700388005_chr1_133260	50	69	GTCC	TCAC
V350256906L3C004R05700852713	chr1	1374859	50M	260	1375119	1374860	1375120	V350256906L3C004R05700852713_chr1_1374859	58	19	CGGC	cgtg
V350256906L3C004R05701310469	chr1	1352072	50M	169	1352241	1352073	1352242	V350256906L3C004R05701310469_chr1_1352072	44	74	ataa	caag
V350256906L3C004R05800180396	chr1	232497	50M	154	232651	232498	232652	V350256906L3C004R05800180396_chr1_232497	55	39	ACAC	AGGA
V350256906L3C004R05800329728	chr1	1154042	50M	161	1154203	1154043	1154204	V350256906L3C004R05800329728_chr1_1154042	20	28	CCCA	AGCA
V350256906L3C004R05800459130	chr1	578523	50M	157	578680	578524	578681	V350256906L3C004R05800459130_chr1_578523	60	67	CCTA	GAAC
V350256906L3C004R05801004484	chr1	53552	50M	163	53715	53553	53716	V350256906L3C004R05801004484_chr1_53552	286	213	ATAT	TATG
V350256906L3C004R05900290880	chr1	747122	50M	139	747261	747123	747262	V350256906L3C004R05900290880_chr1_747122	53	56	CCTG	TGGC
V350256906L3C004R05900344410	chr1	1057921	50M	158	1058079	1057922	1058080	V350256906L3C004R05900344410_chr1_1057921	41	50	CAGA	CGAG
V350256906L3C004R05900473533	chr1	1278695	50M	172	1278867	1278696	1278868	V350256906L3C004R05900473533_chr1_1278695	39	97	CCTC	GGTC
V350256906L3C004R05900695767	chr1	62802	50M	157	62959	62803	62960	V350256906L3C004R05900695767_chr1_62802	103	47	AGTT	CTTG
V350256906L3C004R05900822082	chr1	950977	50M	134	951111	950978	951112	V350256906L3C004R05900822082_chr1_950977	76	27	CCCA	CCCC
V350256906L3C004R05901220751	chr1	25765	50M	185	25950	25766	25951	V350256906L3C004R05901220751_chr1_25765	0	58	CCTG	TGGA
V350256906L3C004R05901229062	chr1	952719	50M	188	952907	952720	952908	V350256906L3C004R05901229062_chr1_952719	42	39	cagg	ataa
V350256906L3C004R05901294446	chr1	138420	50M	154	138574	138421	138575	V350256906L3C004R05901294446_chr1_138420	33	71	CTGT	CACA
V350256906L3C004R06001036387	chr1	638044	50M	122	638166	638045	638167	V350256906L3C004R06001036387_chr1_638044	48	0	GATT	GAAA
V350256906L3C004R06001194220	chr1	907649	50M	130	907779	907650	907780	V350256906L3C004R06001194220_chr1_907649	45	0	CACA	CAGG
V350256906L3C004R06001259678	chr1	939032	50M	137	939169	939033	939170	V350256906L3C004R06001259678_chr1_939032	288	425	GCAG	GGGC
V350256906L3C004R06001267510	chr1	724563	50M	158	724721	724564	724722	V350256906L3C004R06001267510_chr1_724563	153	0	actc	agcc
V350256906L3C004R06100432371	chr1	764308	50M	166	764474	764309	764475	V350256906L3C004R06100432371_chr1_764308	27	49	taca	gcta
V350256906L3C004R06100760344	chr1	670359	50M	168	670527	670360	670528	V350256906L3C004R06100760344_chr1_670359	56	146	ccca	acaa
V350256906L3C004R06100802706	chr1	67283	50M	186	67469	67284	67470	V350256906L3C004R06100802706_chr1_67283	54	32	CTTT	TGGA
V350256906L3C004R06100853879	chr1	726327	7S38M5S	179	726506	726328	726507	V350256906L3C004R06100853879_chr1_726327	36	29	tgga	catt
V350256906L3C004R06101115393	chr1	254811	50M	127	254938	254812	254939	V350256906L3C004R06101115393_chr1_254811	90	1	catg	ggga
V350256906L3C004R06101115394	chr1	254811	50M	127	254938	254812	254939	V350256906L3C004R06101115394_chr1_254811	90	1	catg	ggga
V350256906L3C004R06101219042	chr1	139194	50M	176	139370	139195	139371	V350256906L3C004R06101219042_chr1_139194	63	88	GGAA	CCCG
V350256906L3C004R06200339417	chr1	1429312	50M	188	1429500	1429313	1429501	V350256906L3C004R06200339417_chr1_1429312	10	14	ctag	CGGG
V350256906L3C004R06200841818	chr1	679082	50M	155	679237	679083	679238	V350256906L3C004R06200841818_chr1_679082	169	54	atat	caat
V350256906L3C004R06200841969	chr1	347139	50M	160	347299	347140	347300	V350256906L3C004R06200841969_chr1_347139	70	65	ggtg	ccaa
V350256906L3C004R06200969605	chr1	725299	47M3S	144	725443	725300	725444	V350256906L3C004R06200969605_chr1_725299	0	45	cccg	ccat
V350256906L3C004R06201277404	chr1	347764	50M	183	347947	347765	347948	V350256906L3C004R06201277404_chr1_347764	19	139	ATCT	aaag
V350256906L3C004R06301079684	chr1	1095452	50M	161	1095613	1095453	1095614	V350256906L3C004R06301079684_chr1_1095452	43	31	ccaa	CCTG
V350256906L3C004R06301132188	chr1	686942	50M	167	687109	686943	687110	V350256906L3C004R06301132188_chr1_686942	39	75	ctta	gttt
V350256906L3C004R06301186799	chr1	992647	50M	219	992866	992648	992867	V350256906L3C004R06301186799_chr1_992647	6	0	actg	agcg
V350256906L3C004R06301346370	chr1	725636	5S45M	194	725830	725637	725831	V350256906L3C004R06301346370_chr1_725636	120	53	cgaa	ttcc
V350256906L3C004R06400198323	chr1	1234032	50M	167	1234199	1234033	1234200	V350256906L3C004R06400198323_chr1_1234032	66	57	CCAC	TCTC
V350256906L3C004R06400260855	chr1	698840	50M	131	698971	698841	698972	V350256906L3C004R06400260855_chr1_698840	13	102	CCAG	GTTT
V350256906L3C004R06400319267	chr1	128307	50M	175	128482	128308	128483	V350256906L3C004R06400319267_chr1_128307	114	42	TGTA	AAAG
V350256906L3C004R06400526252	chr1	1351185	50M	196	1351381	1351186	1351382	V350256906L3C004R06400526252_chr1_1351185	117	30	cgaa	ccag
V350256906L3C004R06400949320	chr1	971939	50M	182	972121	971940	972122	V350256906L3C004R06400949320_chr1_971939	63	63	CCAG	ATAG
V350256906L3C004R06500057399	chr1	357249	50M	178	357427	357250	357428	V350256906L3C004R06500057399_chr1_357249	57	69	cctg	CTAA
V350256906L3C004R06500101032	chr1	1387424	50M	156	1387580	1387425	1387581	V350256906L3C004R06500101032_chr1_1387424	0	0	AGCA	GGAG
V350256906L3C004R06500244367	chr1	319561	50M	141	319702	319562	319703	V350256906L3C004R06500244367_chr1_319561	0	22	gttt	ccat
V350256906L3C004R06500251502	chr1	37888	50M	213	38101	37889	38102	V350256906L3C004R06500251502_chr1_37888	233	20	GTTG	caga
V350256906L3C004R06500335276	chr1	533729	50M	168	533897	533730	533898	V350256906L3C004R06500335276_chr1_533729	55	223	GCAG	TGTC
V350256906L3C004R06500346082	chr1	1053652	50M	186	1053838	1053653	1053839	V350256906L3C004R06500346082_chr1_1053652	0	4	CTGG	GGGA
V350256906L3C004R06500689829	chr1	666552	50M	145	666697	666553	666698	V350256906L3C004R06500689829_chr1_666552	219	134	GTCA	TAAA
V350256906L3C004R06501140107	chr1	1072046	50M	165	1072211	1072047	1072212	V350256906L3C004R06501140107_chr1_1072046	18	0	CCTG	CCCC
V350256906L3C004R06501150748	chr1	1170713	50M	143	1170856	1170714	1170857	V350256906L3C004R06501150748_chr1_1170713	186	43	CCCT	TCCA
V350256906L3C004R06501159170	chr1	670318	50M	146	670464	670319	670465	V350256906L3C004R06501159170_chr1_670318	15	161	GCTA	cctg
V350256906L3C004R06501383161	chr1	351673	50M	166	351839	351674	351840	V350256906L3C004R06501383161_chr1_351673	19	30	TGTA	AAAA
V350256906L3C004R06600325361	chr1	777427	50M	197	777624	777428	777625	V350256906L3C004R06600325361_chr1_777427	35	79	CTGG	TGCA
V350256906L3C004R06600347914	chr1	227991	50M	157	228148	227992	228149	V350256906L3C004R06600347914_chr1_227991	93	48	ccta	agaa
V350256906L3C004R06600511279	chr1	447472	50M	175	447647	447473	447648	V350256906L3C004R06600511279_chr1_447472	59	60	cagt	aaca
V350256906L3C004R06600716279	chr1	998767	50M	184	998951	998768	998952	V350256906L3C004R06600716279_chr1_998767	28	27	GGCT	CTCA
V350256906L3C004R06600977138	chr1	1333992	50M	175	1334167	1333993	1334168	V350256906L3C004R06600977138_chr1_1333992	54	42	CACG	GGGA
V350256906L3C004R06601023192	chr1	837215	50M	154	837369	837216	837370	V350256906L3C004R06601023192_chr1_837215	45	53	CCCA	ACTG
V350256906L3C004R06601077222	chr1	81924	50M	169	82093	81925	82094	V350256906L3C004R06601077222_chr1_81924	42	67	acaa	catt
V350256906L3C004R06601152773	chr1	527266	50M	182	527448	527267	527449	V350256906L3C004R06601152773_chr1_527266	38	0	aagt	ccta
V350256906L3C004R06601240427	chr1	463460	50M	167	463627	463461	463628	V350256906L3C004R06601240427_chr1_463460	0	126	caaa	gttg
V350256906L3C004R06701107168	chr1	414081	50M	158	414239	414082	414240	V350256906L3C004R06701107168_chr1_414081	40	55	ccca	aatc
V350256906L3C004R06701114503	chr1	38666	50M	134	38800	38667	38801	V350256906L3C004R06701114503_chr1_38666	295	189	gtct	ctga
V350256906L3C004R06701190022	chr1	418662	50M	171	418833	418663	418834	V350256906L3C004R06701190022_chr1_418662	2	3	ctat	ggtc
V350256906L3C004R06701357532	chr1	79365	50M	161	79526	79366	79527	V350256906L3C004R06701357532_chr1_79365	44	62	ccag	cctc
V350256906L3C004R06800298029	chr1	1254188	50M	160	1254348	1254189	1254349	V350256906L3C004R06800298029_chr1_1254188	63	76	ACCC	CGCT
V350256906L3C004R06800666936	chr1	1218218	50M	168	1218386	1218219	1218387	V350256906L3C004R06800666936_chr1_1218218	42	102	cgcc	ccga
V350256906L3C004R06800719073	chr1	766321	50M	206	766527	766322	766528	V350256906L3C004R06800719073_chr1_766321	0	24	ctgt	agtg
V350256906L3C004R06800843775	chr1	1308896	50M	175	1309071	1308897	1309072	V350256906L3C004R06800843775_chr1_1308896	70	74	CCTA	CTCA
V350256906L3C004R06801157401	chr1	402924	50M	166	403090	402925	403091	V350256906L3C004R06801157401_chr1_402924	161	0	cctc	tgag
V350256906L3C004R06900218415	chr1	321716	50M	176	321892	321717	321893	V350256906L3C004R06900218415_chr1_321716	262	89	TGCT	AGTA
V350256906L3C004R06900641399	chr1	908521	50M	175	908696	908522	908697	V350256906L3C004R06900641399_chr1_908521	51	89	AGAG	CCAG
V350256906L3C004R06900879251	chr1	726710	42M8S	145	726855	726711	726856	V350256906L3C004R06900879251_chr1_726710	61	11	gaat	catt
V350256906L3C004R06901187646	chr1	77963	50M	158	78121	77964	78122	V350256906L3C004R06901187646_chr1_77963	71	13	agag	atat
V350256906L3C004R07000321088	chr1	17548	50M	177	17725	17549	17726	V350256906L3C004R07000321088_chr1_17548	77	62	CCAC	CCTG
V350256906L3C004R07000779808	chr1	571981	50M	173	572154	571982	572155	V350256906L3C004R07000779808_chr1_571981	11	6	ctat	AGCA
V350256906L3C004R07000853879	chr1	124552	50M	199	124751	124553	124752	V350256906L3C004R07000853879_chr1_124552	37	236	TTTT	cctc
V350256906L3C004R07001000403	chr1	704055	50M	162	704217	704056	704218	V350256906L3C004R07001000403_chr1_704055	59	17	TATA	GTTT
V350256906L3C004R07001030469	chr1	725616	10S40M	204	725820	725617	725821	V350256906L3C004R07001030469_chr1_725616	100	63	ggaa	gtcc
V350256906L3C004R07100187877	chr1	635374	50M	190	635564	635375	635565	V350256906L3C004R07100187877_chr1_635374	0	11	gaaa	caaa
V350256906L3C004R07100341222	chr1	911820	50M	178	911998	911821	911999	V350256906L3C004R07100341222_chr1_911820	14	0	GCCA	CCGG
V350256906L3C004R07101085954	chr1	343715	50M	176	343891	343716	343892	V350256906L3C004R07101085954_chr1_343715	81	0	ccca	taat
V350256906L3C004R07200387359	chr1	848618	50M	158	848776	848619	848777	V350256906L3C004R07200387359_chr1_848618	56	68	CCCA	TGAG
V350256906L3C004R07201094991	chr1	237776	50M	165	237941	237777	237942	V350256906L3C004R07201094991_chr1_237776	16	90	GCAA	tcag
V350256906L3C005R00100094163	chr1	816549	13S37M	130	816679	816550	816680	V350256906L3C005R00100094163_chr1_816549	0	125	aaat	ggaa
V350256906L3C005R00100716447	chr1	172404	50M	164	172568	172405	172569	V350256906L3C005R00100716447_chr1_172404	2	0	CCAc	GCCA
V350256906L3C005R00100832591	chr1	254338	50M	203	254541	254339	254542	V350256906L3C005R00100832591_chr1_254338	17	24	TGGC	tgta
V350256906L3C005R00100886923	chr1	829686	50M	159	829845	829687	829846	V350256906L3C005R00100886923_chr1_829686	69	32	TGAT	ccca
V350256906L3C005R00100971264	chr1	1367371	50M	180	1367551	1367372	1367552	V350256906L3C005R00100971264_chr1_1367371	126	6	CCCA	GACA
V350256906L3C005R00101365349	chr1	328011	50M	266	328277	328012	328278	V350256906L3C005R00101365349_chr1_328011	47	0	CCTC	GGAC
V350256906L3C005R00200676871	chr1	876528	50M	165	876693	876529	876694	V350256906L3C005R00200676871_chr1_876528	44	44	CCTG	CAGT
V350256906L3C005R00200692847	chr1	1199911	50M	161	1200072	1199912	1200073	V350256906L3C005R00200692847_chr1_1199911	49	53	ggag	aggc
V350256906L3C005R00300020130	chr1	850494	50M	176	850670	850495	850671	V350256906L3C005R00300020130_chr1_850494	0	0	tggt	tgtg
V350256906L3C005R00300374633	chr1	78818	50M	174	78992	78819	78993	V350256906L3C005R00300374633_chr1_78818	135	0	caaa	gaag
V350256906L3C005R00300394987	chr1	105328	50M	254	105582	105329	105583	V350256906L3C005R00300394987_chr1_105328	14	73	ACGG	CACA
V350256906L3C005R00300572780	chr1	1125627	50M	161	1125788	1125628	1125789	V350256906L3C005R00300572780_chr1_1125627	34	63	cttt	ccca
V350256906L3C005R00301302901	chr1	416707	50M	206	416913	416708	416914	V350256906L3C005R00301302901_chr1_416707	78	69	CAGC	TAAG
V350256906L3C005R00400316791	chr1	344608	50M	180	344788	344609	344789	V350256906L3C005R00400316791_chr1_344608	259	79	agtc	ccct
V350256906L3C005R00400495868	chr1	257275	50M	164	257439	257276	257440	V350256906L3C005R00400495868_chr1_257275	50	53	CCTT	ccca
V350256906L3C005R00400560708	chr1	724927	50M	165	725092	724928	725093	V350256906L3C005R00400560708_chr1_724927	0	122	gaat	catt
V350256906L3C005R00400583914	chr1	1185341	50M	157	1185498	1185342	1185499	V350256906L3C005R00400583914_chr1_1185341	45	64	ccct	ccta
V350256906L3C005R00400658393	chr1	134753	50M	165	134918	134754	134919	V350256906L3C005R00400658393_chr1_134753	0	72	CCCA	TAAA
V350256906L3C005R00400664263	chr1	1301956	50M	192	1302148	1301957	1302149	V350256906L3C005R00400664263_chr1_1301956	64	74	gaag	gttt
V350256906L3C005R00401290715	chr1	986289	50M	188	986477	986290	986478	V350256906L3C005R00401290715_chr1_986289	36	48	TGCC	ACCC
V350256906L3C005R00401333997	chr1	761398	50M	155	761553	761399	761554	V350256906L3C005R00401333997_chr1_761398	62	67	CTGC	CAAT
V350256906L3C005R00500183145	chr1	1380735	50M	183	1380918	1380736	1380919	V350256906L3C005R00500183145_chr1_1380735	49	114	tcct	ttta
V350256906L3C005R00500195648	chr1	1328917	50M	164	1329081	1328918	1329082	V350256906L3C005R00500195648_chr1_1328917	88	52	GCAA	CGAG
V350256906L3C005R00500265869	chr1	1423374	50M	141	1423515	1423375	1423516	V350256906L3C005R00500265869_chr1_1423374	46	0	CCTT	aaat
V350256906L3C005R00500377268	chr1	959617	50M	190	959807	959618	959808	V350256906L3C005R00500377268_chr1_959617	441	251	CTGA	CCCT
V350256906L3C005R00500391674	chr1	649961	50M	178	650139	649962	650140	V350256906L3C005R00500391674_chr1_649961	63	47	TCAT	ggga
V350256906L3C005R00500684698	chr1	661963	50M	168	662131	661964	662132	V350256906L3C005R00500684698_chr1_661963	301	250	ACCG	CCCA
V350256906L3C005R00500965683	chr1	102928	50M	150	103078	102929	103079	V350256906L3C005R00500965683_chr1_102928	53	132	ccct	cacc
V350256906L3C005R00500981794	chr1	1348352	50M	196	1348548	1348353	1348549	V350256906L3C005R00500981794_chr1_1348352	131	35	ggaa	agac
V350256906L3C005R00501138682	chr1	1429841	50M	190	1430031	1429842	1430032	V350256906L3C005R00501138682_chr1_1429841	7	82	CCGG	GTCA
V350256906L3C005R00501199307	chr1	1023264	50M	150	1023414	1023265	1023415	V350256906L3C005R00501199307_chr1_1023264	151	123	CGCT	GGCC
V350256906L3C005R00600044561	chr1	1034435	50M	138	1034573	1034436	1034574	V350256906L3C005R00600044561_chr1_1034435	31	62	ggtt	agtt
V350256906L3C005R00600249211	chr1	1034956	50M	133	1035089	1034957	1035090	V350256906L3C005R00600249211_chr1_1034956	60	18	ctat	tctc
V350256906L3C005R00600389917	chr1	97284	50M	146	97430	97285	97431	V350256906L3C005R00600389917_chr1_97284	67	30	CACA	AAAT
V350256906L3C005R00600432667	chr1	1422343	50M	154	1422497	1422344	1422498	V350256906L3C005R00600432667_chr1_1422343	0	52	CCAC	CAAG
V350256906L3C005R00601040054	chr1	907033	50M	179	907212	907034	907213	V350256906L3C005R00601040054_chr1_907033	6	0	CCTC	CCAG
V350256906L3C005R00601107126	chr1	725299	7S43M	239	725538	725300	725539	V350256906L3C005R00601107126_chr1_725299	0	22	cccg	ccat
V350256906L3C005R00601318435	chr1	648562	50M	219	648781	648563	648782	V350256906L3C005R00601318435_chr1_648562	46	70	CATG	CAAT
V350256906L3C005R00700002258	chr1	535639	50M	151	535790	535640	535791	V350256906L3C005R00700002258_chr1_535639	0	11	ctct	tgag
V350256906L3C005R00700172884	chr1	173939	50M	169	174108	173940	174109	V350256906L3C005R00700172884_chr1_173939	93	8	CAAA	AATG
V350256906L3C005R00700221752	chr1	1081824	50M	144	1081968	1081825	1081969	V350256906L3C005R00700221752_chr1_1081824	68	48	AGCA	CCAG
V350256906L3C005R00700547213	chr1	41918	50M	197	42115	41919	42116	V350256906L3C005R00700547213_chr1_41918	630	433	ccta	gaca
V350256906L3C005R00700580737	chr1	1191202	50M	176	1191378	1191203	1191379	V350256906L3C005R00700580737_chr1_1191202	36	41	CCCT	TGAG
V350256906L3C005R00700706401	chr1	1423898	50M	180	1424078	1423899	1424079	V350256906L3C005R00700706401_chr1_1423898	0	2	tggg	aacc
V350256906L3C005R00701261932	chr1	143424	50M	200	143624	143425	143625	V350256906L3C005R00701261932_chr1_143424	254	114	ccaa	agtt
V350256906L3C005R00701303586	chr1	605848	50M	218	606066	605849	606067	V350256906L3C005R00701303586_chr1_605848	60	62	atct	GTTT
V350256906L3C005R00701325807	chr1	119891	50M	193	120084	119892	120085	V350256906L3C005R00701325807_chr1_119891	45	225	ggga	CCAC
V350256906L3C005R00701337949	chr1	790968	50M	175	791143	790969	791144	V350256906L3C005R00701337949_chr1_790968	60	55	GGAG	CCCC
V350256906L3C005R00800328432	chr1	1083405	50M	209	1083614	1083406	1083615	V350256906L3C005R00800328432_chr1_1083405	5	22	tggg	GTGG
V350256906L3C005R00800386172	chr1	795740	50M	160	795900	795741	795901	V350256906L3C005R00800386172_chr1_795740	2	0	ctaa	GCCT
V350256906L3C005R00800723225	chr1	1014077	50M	184	1014261	1014078	1014262	V350256906L3C005R00800723225_chr1_1014077	108	0	TGGG	CCCA
V350256906L3C005R00800918823	chr1	1344758	50M	184	1344942	1344759	1344943	V350256906L3C005R00800918823_chr1_1344758	15	9	agat	cgag
V350256906L3C005R00801254015	chr1	1056698	50M	189	1056887	1056699	1056888	V350256906L3C005R00801254015_chr1_1056698	20	43	CCCC	CCAT
V350256906L3C005R00900010091	chr1	692768	27M1D23M	164	692932	692769	692933	V350256906L3C005R00900010091_chr1_692768	193	29	ctag	cgtg
V350256906L3C005R00900066154	chr1	551765	50M	162	551927	551766	551928	V350256906L3C005R00900066154_chr1_551765	240	78	caaa	cccc
V350256906L3C005R00900603397	chr1	1120005	50M	145	1120150	1120006	1120151	V350256906L3C005R00900603397_chr1_1120005	464	319	GGCG	GAAG
V350256906L3C005R00900788275	chr1	1015219	50M	161	1015380	1015220	1015381	V350256906L3C005R00900788275_chr1_1015219	0	0	TGTG	CCCC
V350256906L3C005R00901143464	chr1	68101	50M	159	68260	68102	68261	V350256906L3C005R00901143464_chr1_68101	41	64	ccta	GTAA
V350256906L3C005R00901297858	chr1	123475	50M	185	123660	123476	123661	V350256906L3C005R00901297858_chr1_123475	0	16	TATA	tcta
V350256906L3C005R00901382822	chr1	1124359	50M	195	1124554	1124360	1124555	V350256906L3C005R00901382822_chr1_1124359	0	4	aaac	tgtt
V350256906L3C005R01000912837	chr1	339125	50M	180	339305	339126	339306	V350256906L3C005R01000912837_chr1_339125	40	18	gttg	tata
V350256906L3C005R01001179362	chr1	705569	50M	166	705735	705570	705736	V350256906L3C005R01001179362_chr1_705569	51	89	TCCA	ctcc
V350256906L3C005R01001372688	chr1	1133583	50M	182	1133765	1133584	1133766	V350256906L3C005R01001372688_chr1_1133583	65	60	TCCT	GCCC
V350256906L3C005R01100276256	chr1	254709	50M	217	254926	254710	254927	V350256906L3C005R01100276256_chr1_254709	108	0	acct	tgat
V350256906L3C005R01100918985	chr1	1420574	50M	162	1420736	1420575	1420737	V350256906L3C005R01100918985_chr1_1420574	22	33	CCCT	GTCT
V350256906L3C005R01101056121	chr1	1389906	50M	167	1390073	1389907	1390074	V350256906L3C005R01101056121_chr1_1389906	43	5	TGAG	GGGA
V350256906L3C005R01200027731	chr1	860527	50M	195	860722	860528	860723	V350256906L3C005R01200027731_chr1_860527	204	79	CCAC	cccc
V350256906L3C005R01200087326	chr1	55180	50M	199	55379	55181	55380	V350256906L3C005R01200087326_chr1_55180	152	0	caag	caaa
V350256906L3C005R01200176308	chr1	22477	50M	188	22665	22478	22666	V350256906L3C005R01200176308_chr1_22477	0	10	CAAT	CCAG
V350256906L3C005R01200313681	chr1	931071	50M	168	931239	931072	931240	V350256906L3C005R01200313681_chr1_931071	57	83	CCCT	CCGG
V350256906L3C005R01200514219	chr1	30682	50M	169	30851	30683	30852	V350256906L3C005R01200514219_chr1_30682	74	27	GATC	GCtc
V350256906L3C005R01200875126	chr1	47316	50M	162	47478	47317	47479	V350256906L3C005R01200875126_chr1_47316	47	81	AGTA	CATC
V350256906L3C005R01201032036	chr1	910418	50M	184	910602	910419	910603	V350256906L3C005R01201032036_chr1_910418	33	77	CCTT	ATAA
V350256906L3C005R01300583194	chr1	642781	50M	176	642957	642782	642958	V350256906L3C005R01300583194_chr1_642781	34	43	ccta	gacc
V350256906L3C005R01301136469	chr1	113190	50M	179	113369	113191	113370	V350256906L3C005R01301136469_chr1_113190	49	118	GAGA	CCTT
V350256906L3C005R01400596963	chr1	769649	50M	162	769811	769650	769812	V350256906L3C005R01400596963_chr1_769649	267	105	CCAG	TCCT
V350256906L3C005R01401146496	chr1	76082	50M	168	76250	76083	76251	V350256906L3C005R01401146496_chr1_76082	55	28	acaa	ttgg
V350256906L3C005R01401188938	chr1	897902	50M	186	898088	897903	898089	V350256906L3C005R01401188938_chr1_897902	19	0	TGGC	TGAG
V350256906L3C005R01401360854	chr1	139125	50M	146	139271	139126	139272	V350256906L3C005R01401360854_chr1_139125	64	0	TGTC	CAGC
V350256906L3C005R01500151755	chr1	1358028	50M	164	1358192	1358029	1358193	V350256906L3C005R01500151755_chr1_1358028	63	25	tccA	cctg
V350256906L3C005R01500265522	chr1	785008	50M	180	785188	785009	785189	V350256906L3C005R01500265522_chr1_785008	0	0	tgtg	gccc
V350256906L3C005R01500361067	chr1	1171374	50M	168	1171542	1171375	1171543	V350256906L3C005R01500361067_chr1_1171374	49	69	gaaa	TGGA
V350256906L3C005R01500513225	chr1	826292	50M	192	826484	826293	826485	V350256906L3C005R01500513225_chr1_826292	0	0	GCCC	attt
V350256906L3C005R01500591349	chr1	470229	50M	148	470377	470230	470378	V350256906L3C005R01500591349_chr1_470229	30	55	acat	CAAG
V350256906L3C005R01500601704	chr1	137672	50M	169	137841	137673	137842	V350256906L3C005R01500601704_chr1_137672	33	53	CCCA	CTAC
V350256906L3C005R01500804920	chr1	934787	50M	161	934948	934788	934949	V350256906L3C005R01500804920_chr1_934787	56	66	AACG	CCGT
V350256906L3C005R01501140177	chr1	608567	50M	161	608728	608568	608729	V350256906L3C005R01501140177_chr1_608567	0	0	aaaa	agcc
V350256906L3C005R01501373412	chr1	101039	50M	219	101258	101040	101259	V350256906L3C005R01501373412_chr1_101039	102	26	TGTC	caag
V350256906L3C005R01501399074	chr1	100405	50M	181	100586	100406	100587	V350256906L3C005R01501399074_chr1_100405	68	68	ccat	CCTG
V350256906L3C005R01600095271	chr1	621465	50M	162	621627	621466	621628	V350256906L3C005R01600095271_chr1_621465	43	66	GGTA	AGCC
V350256906L3C005R01600294910	chr1	128026	50M	159	128185	128027	128186	V350256906L3C005R01600294910_chr1_128026	35	57	acag	ACTG
V350256906L3C005R01600609039	chr1	701994	50M	169	702163	701995	702164	V350256906L3C005R01600609039_chr1_701994	0	1	tact	GATG
V350256906L3C005R01600912779	chr1	1410841	50M	162	1411003	1410842	1411004	V350256906L3C005R01600912779_chr1_1410841	34	16	CCGA	CTGC
V350256906L3C005R01600932736	chr1	726606	6S41M3S	138	726744	726607	726745	V350256906L3C005R01600932736_chr1_726606	0	69	gaat	attc
V350256906L3C005R01601308312	chr1	331439	50M	163	331602	331440	331603	V350256906L3C005R01601308312_chr1_331439	10	53	TGGC	CCCC
V350256906L3C005R01601360341	chr1	577854	50M	158	578012	577855	578013	V350256906L3C005R01601360341_chr1_577854	123	281	CTTT	CCCC
V350256906L3C005R01700671761	chr1	247326	50M	128	247454	247327	247455	V350256906L3C005R01700671761_chr1_247326	1	29	AATT	tgaa
V350256906L3C005R01700969233	chr1	993107	50M	159	993266	993108	993267	V350256906L3C005R01700969233_chr1_993107	11	0	ctca	ctcc
V350256906L3C005R01800011488	chr1	783866	50M	122	783988	783867	783989	V350256906L3C005R01800011488_chr1_783866	48	0	TATT	TTTT
V350256906L3C005R01800396773	chr1	160119	50M	166	160285	160120	160286	V350256906L3C005R01800396773_chr1_160119	0	143	CCCA	GTTT
V350256906L3C005R01800579943	chr1	890421	50M	171	890592	890422	890593	V350256906L3C005R01800579943_chr1_890421	74	63	CTGC	CCAT
V350256906L3C005R01800606854	chr1	140327	50M	181	140508	140328	140509	V350256906L3C005R01800606854_chr1_140327	211	255	CCTG	ccca
V350256906L3C005R01801033589	chr1	1352433	50M	177	1352610	1352434	1352611	V350256906L3C005R01801033589_chr1_1352433	0	174	aaaa	cctg
V350256906L3C005R01801035496	chr1	545415	50M	192	545607	545416	545608	V350256906L3C005R01801035496_chr1_545415	0	163	CGGC	GGGC
V350256906L3C005R01900010262	chr1	114103	50M	163	114266	114104	114267	V350256906L3C005R01900010262_chr1_114103	0	0	TATT	tgaa
V350256906L3C005R01900171715	chr1	159820	50M	158	159978	159821	159979	V350256906L3C005R01900171715_chr1_159820	30	89	ATTC	CCAG
V350256906L3C005R01900311538	chr1	373505	50M	147	373652	373506	373653	V350256906L3C005R01900311538_chr1_373505	25	7	tgtg	caag
V350256906L3C005R01900325249	chr1	1234289	50M	134	1234423	1234290	1234424	V350256906L3C005R01900325249_chr1_1234289	6	61	CCCG	CCTG
V350256906L3C005R01900491375	chr1	133805	50M	189	133994	133806	133995	V350256906L3C005R01900491375_chr1_133805	182	104	CCCT	CCAT
V350256906L3C005R01901006641	chr1	463775	50M	169	463944	463776	463945	V350256906L3C005R01901006641_chr1_463775	166	0	catg	CCCT
V350256906L3C005R01901056516	chr1	1257668	50M	128	1257796	1257669	1257797	V350256906L3C005R01901056516_chr1_1257668	109	0	CACA	TCTT
V350256906L3C005R01901295318	chr1	753325	50M	149	753474	753326	753475	V350256906L3C005R01901295318_chr1_753325	24	62	GAAG	cccc
V350256906L3C005R02000001705	chr1	589317	50M	271	589588	589318	589589	V350256906L3C005R02000001705_chr1_589317	29	35	atag	ctta
V350256906L3C005R02000114911	chr1	565078	50M	173	565251	565079	565252	V350256906L3C005R02000114911_chr1_565078	84	62	CAGC	GTTG
V350256906L3C005R02000186319	chr1	337082	50M	159	337241	337083	337242	V350256906L3C005R02000186319_chr1_337082	24	39	ctga	gaca
V350256906L3C005R02000258596	chr1	825827	2S48M	181	826008	825828	826009	V350256906L3C005R02000258596_chr1_825827	110	259	aaaa	tgaa
V350256906L3C005R02001182223	chr1	720423	50M	117	720540	720424	720541	V350256906L3C005R02001182223_chr1_720423	0	58	ctgt	aaag
V350256906L3C005R02001362646	chr1	1143388	50M	164	1143552	1143389	1143553	V350256906L3C005R02001362646_chr1_1143388	128	0	ggag	CCCT
V350256906L3C005R02100198673	chr1	1391831	50M	165	1391996	1391832	1391997	V350256906L3C005R02100198673_chr1_1391831	96	22	CAGC	CCTC
V350256906L3C005R02100402597	chr1	1320251	50M	167	1320418	1320252	1320419	V350256906L3C005R02100402597_chr1_1320251	7	87	ggta	acct
V350256906L3C005R02100775836	chr1	835624	50M	173	835797	835625	835798	V350256906L3C005R02100775836_chr1_835624	102	222	atat	cctg
V350256906L3C005R02100863347	chr1	24239	50M	166	24405	24240	24406	V350256906L3C005R02100863347_chr1_24239	22	132	tatt	ggca
V350256906L3C005R02101055329	chr1	720645	50M	185	720830	720646	720831	V350256906L3C005R02101055329_chr1_720645	0	0	ctct	tctt
V350256906L3C005R02101087986	chr1	566243	50M	145	566388	566244	566389	V350256906L3C005R02101087986_chr1_566243	40	45	TAAC	CTCT
V350256906L3C005R02200189108	chr1	87054	50M	185	87239	87055	87240	V350256906L3C005R02200189108_chr1_87054	0	54	ctgt	acat
V350256906L3C005R02200467768	chr1	439338	50M	208	439546	439339	439547	V350256906L3C005R02200467768_chr1_439338	29	20	CCCC	CGTC
V350256906L3C005R02200540480	chr1	460810	50M	143	460953	460811	460954	V350256906L3C005R02200540480_chr1_460810	61	16	cctg	caat
V350256906L3C005R02200763743	chr1	1128777	50M	176	1128953	1128778	1128954	V350256906L3C005R02200763743_chr1_1128777	67	58	tctg	agaa
V350256906L3C005R02300371148	chr1	467139	50M	192	467331	467140	467332	V350256906L3C005R02300371148_chr1_467139	117	0	CTAG	atta
V350256906L3C005R02300589397	chr1	810905	50M	183	811088	810906	811089	V350256906L3C005R02300589397_chr1_810905	29	37	CCCT	CCTC
V350256906L3C005R02300728160	chr1	340330	50M	171	340501	340331	340502	V350256906L3C005R02300728160_chr1_340330	30	60	ACAG	CTAC
V350256906L3C005R02301065817	chr1	906149	50M	163	906312	906150	906313	V350256906L3C005R02301065817_chr1_906149	75	55	TGCT	GTCC
V350256906L3C005R02301305306	chr1	675981	50M	135	676116	675982	676117	V350256906L3C005R02301305306_chr1_675981	0	39	GTGA	ATAT
V350256906L3C005R02301357420	chr1	852988	50M	180	853168	852989	853169	V350256906L3C005R02301357420_chr1_852988	46	63	AGTG	TGAA
V350256906L3C005R02400021923	chr1	125716	50M	142	125858	125717	125859	V350256906L3C005R02400021923_chr1_125716	239	97	TGAC	CCTA
V350256906L3C005R02400377233	chr1	1365962	50M	176	1366138	1365963	1366139	V350256906L3C005R02400377233_chr1_1365962	48	27	GGGT	TTTG
V350256906L3C005R02400799263	chr1	1139681	50M	118	1139799	1139682	1139800	V350256906L3C005R02400799263_chr1_1139681	14	61	CTGC	CACT
V350256906L3C005R02400845882	chr1	733034	50M	161	733195	733035	733196	V350256906L3C005R02400845882_chr1_733034	7	168	CAAG	CCCT
V350256906L3C005R02400851709	chr1	359758	50M	164	359922	359759	359923	V350256906L3C005R02400851709_chr1_359758	51	69	CCAC	CATT
V350256906L3C005R02400874612	chr1	1358503	50M	160	1358663	1358504	1358664	V350256906L3C005R02400874612_chr1_1358503	11	0	gcct	tgaa
V350256906L3C005R02401384519	chr1	914207	50M	209	914416	914208	914417	V350256906L3C005R02401384519_chr1_914207	143	35	CTGG	CGGG
V350256906L3C005R02500376463	chr1	415484	50M	204	415688	415485	415689	V350256906L3C005R02500376463_chr1_415484	105	105	TCAA	acac
V350256906L3C005R02500421456	chr1	107796	50M	141	107937	107797	107938	V350256906L3C005R02500421456_chr1_107796	75	32	tatg	aaca
V350256906L3C005R02500576058	chr1	245487	50M	162	245649	245488	245650	V350256906L3C005R02500576058_chr1_245487	46	76	ctgc	tgag
V350256906L3C005R02500718008	chr1	1029988	50M	224	1030212	1029989	1030213	V350256906L3C005R02500718008_chr1_1029988	68	49	gcca	agag
V350256906L3C005R02500905447	chr1	108829	50M	147	108976	108830	108977	V350256906L3C005R02500905447_chr1_108829	163	16	ATAT	TTAT
V350256906L3C005R02500991019	chr1	634126	50M	165	634291	634127	634292	V350256906L3C005R02500991019_chr1_634126	178	13	tggg	ccaa
V350256906L3C005R02501074738	chr1	21505	50M	198	21703	21506	21704	V350256906L3C005R02501074738_chr1_21505	0	0	CTGA	GAGA
V350256906L3C005R02501184261	chr1	597505	50M	168	597673	597506	597674	V350256906L3C005R02501184261_chr1_597505	114	112	tgtt	ccat
V350256906L3C005R02600059560	chr1	1103933	50M	150	1104083	1103934	1104084	V350256906L3C005R02600059560_chr1_1103933	64	40	TCCC	CTCT
V350256906L3C005R02600243707	chr1	384578	50M	162	384740	384579	384741	V350256906L3C005R02600243707_chr1_384578	303	159	cctc	catg
V350256906L3C005R02600620711	chr1	1201114	50M	176	1201290	1201115	1201291	V350256906L3C005R02600620711_chr1_1201114	0	32	tctc	tgta
V350256906L3C005R02600820898	chr1	626574	50M	176	626750	626575	626751	V350256906L3C005R02600820898_chr1_626574	68	133	ctca	ATCC
V350256906L3C005R02601074392	chr1	761403	50M	124	761527	761404	761528	V350256906L3C005R02601074392_chr1_761403	57	41	CCCT	TATT
V350256906L3C005R02601192199	chr1	687846	50M	157	688003	687847	688004	V350256906L3C005R02601192199_chr1_687846	76	30	aggc	ccca
V350256906L3C005R02700043540	chr1	1238089	50M	171	1238260	1238090	1238261	V350256906L3C005R02700043540_chr1_1238089	35	7	CCAG	GGAA
V350256906L3C005R02700534174	chr1	244006	50M	173	244179	244007	244180	V350256906L3C005R02700534174_chr1_244006	31	29	AAAG	tatg
V350256906L3C005R02700547639	chr1	33721	50M	190	33911	33722	33912	V350256906L3C005R02700547639_chr1_33721	184	0	ccat	agag
V350256906L3C005R02700816607	chr1	1318748	50M	170	1318918	1318749	1318919	V350256906L3C005R02700816607_chr1_1318748	0	8	ccca	gtag
V350256906L3C005R02800042692	chr1	633845	50M	161	634006	633846	634007	V350256906L3C005R02800042692_chr1_633845	279	298	ctga	tccc
V350256906L3C005R02800200269	chr1	93182	50M	133	93315	93183	93316	V350256906L3C005R02800200269_chr1_93182	0	47	taaa	taag
V350256906L3C005R02800368245	chr1	924964	50M	200	925164	924965	925165	V350256906L3C005R02800368245_chr1_924964	49	45	tcac	taag
V350256906L3C005R02800605841	chr1	798468	50M	151	798619	798469	798620	V350256906L3C005R02800605841_chr1_798468	27	66	cccg	CCCC
V350256906L3C005R02800736309	chr1	1374924	50M	162	1375086	1374925	1375087	V350256906L3C005R02800736309_chr1_1374924	17	52	CGTG	GCCT
V350256906L3C005R02801028455	chr1	651985	50M	181	652166	651986	652167	V350256906L3C005R02801028455_chr1_651985	159	21	AAAA	TGTT
V350256906L3C005R02900142374	chr1	17712	50M	157	17869	17713	17870	V350256906L3C005R02900142374_chr1_17712	49	26	TCAC	TACT
V350256906L3C005R02900465818	chr1	549453	50M	168	549621	549454	549622	V350256906L3C005R02900465818_chr1_549453	0	0	TCAC	CCAC
V350256906L3C005R02900546060	chr1	1409620	50M	152	1409772	1409621	1409773	V350256906L3C005R02900546060_chr1_1409620	2	0	gagt	ggtg
V350256906L3C005R02900574182	chr1	795041	50M	180	795221	795042	795222	V350256906L3C005R02900574182_chr1_795041	69	74	cttg	AGAC
V350256906L3C005R02900634374	chr1	725518	4S38M8S	125	725643	725519	725644	V350256906L3C005R02900634374_chr1_725518	2	127	aatg	ccat
V350256906L3C005R02901023787	chr1	69321	50M	160	69481	69322	69482	V350256906L3C005R02901023787_chr1_69321	0	0	CTTT	ACAC
V350256906L3C005R02901393920	chr1	717128	50M	154	717282	717129	717283	V350256906L3C005R02901393920_chr1_717128	34	23	GTGA	CCCA
V350256906L3C005R03000384520	chr1	67768	50M	198	67966	67769	67967	V350256906L3C005R03000384520_chr1_67768	0	0	CCCC	TGTG
V350256906L3C005R03000862720	chr1	259331	50M	213	259544	259332	259545	V350256906L3C005R03000862720_chr1_259331	71	55	AATC	GTTT
V350256906L3C005R03001104039	chr1	713495	50M	173	713668	713496	713669	V350256906L3C005R03001104039_chr1_713495	210	71	gttg	tgag
V350256906L3C005R03001107813	chr1	679732	50M	167	679899	679733	679900	V350256906L3C005R03001107813_chr1_679732	57	57	CAAC	caGA
V350256906L3C005R03001343981	chr1	24010	50M	165	24175	24011	24176	V350256906L3C005R03001343981_chr1_24010	12	31	ccca	gccg
V350256906L3C005R03100239754	chr1	1129562	50M	194	1129756	1129563	1129757	V350256906L3C005R03100239754_chr1_1129562	58	73	caat	tgtc
V350256906L3C005R03100942591	chr1	1272022	50M	163	1272185	1272023	1272186	V350256906L3C005R03100942591_chr1_1272022	91	44	CATG	TCAG
V350256906L3C005R03200497617	chr1	153212	50M	168	153380	153213	153381	V350256906L3C005R03200497617_chr1_153212	306	138	ccag	ccaa
V350256906L3C005R03200877820	chr1	539177	50M	175	539352	539178	539353	V350256906L3C005R03200877820_chr1_539177	132	219	ACCT	GCCT
V350256906L3C005R03200945180	chr1	42976	50M	189	43165	42977	43166	V350256906L3C005R03200945180_chr1_42976	14	0	CCAT	GGCT
V350256906L3C005R03201356405	chr1	1372952	50M	180	1373132	1372953	1373133	V350256906L3C005R03201356405_chr1_1372952	55	62	CCCC	CGAG
V350256906L3C005R03300323099	chr1	231747	50M	171	231918	231748	231919	V350256906L3C005R03300323099_chr1_231747	267	96	cagg	cttg
V350256906L3C005R03300721666	chr1	730120	50M	172	730292	730121	730293	V350256906L3C005R03300721666_chr1_730120	30	48	TATA	CTTC
V350256906L3C005R03300868406	chr1	1092805	50M	172	1092977	1092806	1092978	V350256906L3C005R03300868406_chr1_1092805	143	0	cgcc	TTCC
V350256906L3C005R03301026053	chr1	52891	50M	188	53079	52892	53080	V350256906L3C005R03301026053_chr1_52891	29	0	GGAT	TAAT
V350256906L3C005R03301202696	chr1	1032332	50M	189	1032521	1032333	1032522	V350256906L3C005R03301202696_chr1_1032332	30	25	tggt	agtg
V350256906L3C005R03301257958	chr1	1405603	50M	173	1405776	1405604	1405777	V350256906L3C005R03301257958_chr1_1405603	50	58	gcct	caca
V350256906L3C005R03400146016	chr1	541487	50M	209	541696	541488	541697	V350256906L3C005R03400146016_chr1_541487	87	31	CCAG	CCCC
V350256906L3C005R03400757809	chr1	31726	50M	187	31913	31727	31914	V350256906L3C005R03400757809_chr1_31726	176	95	aaaa	CTGG
V350256906L3C005R03401332228	chr1	715343	50M	148	715491	715344	715492	V350256906L3C005R03401332228_chr1_715343	28	56	accc	tcag
V350256906L3C005R03500091442	chr1	364165	50M	168	364333	364166	364334	V350256906L3C005R03500091442_chr1_364165	0	0	tcca	CTGA
V350256906L3C005R03500368191	chr1	53033	50M	161	53194	53034	53195	V350256906L3C005R03500368191_chr1_53033	13	31	CACT	GGCA
V350256906L3C005R03500468460	chr1	827582	50M	176	827758	827583	827759	V350256906L3C005R03500468460_chr1_827582	72	60	acac	cctg
V350256906L3C005R03500710954	chr1	970099	50M	164	970263	970100	970264	V350256906L3C005R03500710954_chr1_970099	95	51	CGGG	CCAG
V350256906L3C005R03500785603	chr1	1172089	50M	162	1172251	1172090	1172252	V350256906L3C005R03500785603_chr1_1172089	47	32	CCCT	CAAA
V350256906L3C005R03500837508	chr1	30104	50M	159	30263	30105	30264	V350256906L3C005R03500837508_chr1_30104	61	43	agtg	CTTT
V350256906L3C005R03501244366	chr1	237556	50M	225	237781	237557	237782	V350256906L3C005R03501244366_chr1_237556	54	11	GGAT	CTTG
V350256906L3C005R03501309861	chr1	710399	50M	159	710558	710400	710559	V350256906L3C005R03501309861_chr1_710399	61	77	acca	ggag
V350256906L3C005R03501321582	chr1	401049	50M	195	401244	401050	401245	V350256906L3C005R03501321582_chr1_401049	15	13	atag	caag
V350256906L3C005R03501323286	chr1	1311785	50M	135	1311920	1311786	1311921	V350256906L3C005R03501323286_chr1_1311785	56	58	CCCC	GCTC
V350256906L3C005R03501341764	chr1	75477	50M	188	75665	75478	75666	V350256906L3C005R03501341764_chr1_75477	51	239	acat	gcca
V350256906L3C005R03600414080	chr1	681463	50M	158	681621	681464	681622	V350256906L3C005R03600414080_chr1_681463	16	50	tata	ccat
V350256906L3C005R03600433443	chr1	841358	50M	160	841518	841359	841519	V350256906L3C005R03600433443_chr1_841358	0	77	TGAA	GTGG
V350256906L3C005R03600440715	chr1	596599	50M	187	596786	596600	596787	V350256906L3C005R03600440715_chr1_596599	22	0	ccca	tcct
V350256906L3C005R03600453647	chr1	1420386	50M	173	1420559	1420387	1420560	V350256906L3C005R03600453647_chr1_1420386	76	7	TCTG	CCGC
V350256906L3C005R03600510619	chr1	329539	50M	184	329723	329540	329724	V350256906L3C005R03600510619_chr1_329539	77	40	GCCA	CCCA
V350256906L3C005R03601170363	chr1	318726	50M	159	318885	318727	318886	V350256906L3C005R03601170363_chr1_318726	59	60	gcta	ggga
V350256906L3C005R03700177511	chr1	400818	50M	181	400999	400819	401000	V350256906L3C005R03700177511_chr1_400818	56	36	tcac	ccaa
V350256906L3C005R03700361359	chr1	1277054	50M	167	1277221	1277055	1277222	V350256906L3C005R03700361359_chr1_1277054	0	152	TGCT	CCCT
V350256906L3C005R03700790848	chr1	739927	50M	148	740075	739928	740076	V350256906L3C005R03700790848_chr1_739927	38	8	GACC	GTTG
V350256906L3C005R03700932809	chr1	416375	50M	234	416609	416376	416610	V350256906L3C005R03700932809_chr1_416375	0	0	agga	GGAG
V350256906L3C005R03701204036	chr1	164262	50M	130	164392	164263	164393	V350256906L3C005R03701204036_chr1_164262	67	27	CCTT	gctg
V350256906L3C005R03701219521	chr1	1115402	50M	168	1115570	1115403	1115571	V350256906L3C005R03701219521_chr1_1115402	0	0	CCCC	TGTT
V350256906L3C005R03800185816	chr1	1160209	50M	150	1160359	1160210	1160360	V350256906L3C005R03800185816_chr1_1160209	58	74	cccg	CACA
V350256906L3C005R03800342039	chr1	247828	50M	151	247979	247829	247980	V350256906L3C005R03800342039_chr1_247828	13	78	ccaa	gctc
V350256906L3C005R03800966450	chr1	393812	50M	179	393991	393813	393992	V350256906L3C005R03800966450_chr1_393812	133	10	cttc	attt
V350256906L3C005R03801143991	chr1	166210	50M	187	166397	166211	166398	V350256906L3C005R03801143991_chr1_166210	35	222	cctg	atac
V350256906L3C005R03801245412	chr1	624557	50M	155	624712	624558	624713	V350256906L3C005R03801245412_chr1_624557	0	6	AGAT	CCTC
V350256906L3C005R03900786494	chr1	250351	50M	155	250506	250352	250507	V350256906L3C005R03900786494_chr1_250351	43	9	ggaa	gtgt
V350256906L3C005R03900974532	chr1	834313	50M	167	834480	834314	834481	V350256906L3C005R03900974532_chr1_834313	92	44	CTGC	agcc
V350256906L3C005R03901110117	chr1	1356653	50M	199	1356852	1356654	1356853	V350256906L3C005R03901110117_chr1_1356653	20	0	GAAT	CCTG
V350256906L3C005R04000133002	chr1	1071102	50M	205	1071307	1071103	1071308	V350256906L3C005R04000133002_chr1_1071102	0	35	tctt	GTCC
V350256906L3C005R04000201117	chr1	238789	50M	175	238964	238790	238965	V350256906L3C005R04000201117_chr1_238789	237	163	TACA	ggag
V350256906L3C005R04000242414	chr1	592963	50M	205	593168	592964	593169	V350256906L3C005R04000242414_chr1_592963	0	0	ATTT	ttat
V350256906L3C005R04000263498	chr1	442460	50M	217	442677	442461	442678	V350256906L3C005R04000263498_chr1_442460	84	41	atat	AAAC
V350256906L3C005R04000320071	chr1	724938	41M9S	163	725101	724939	725102	V350256906L3C005R04000320071_chr1_724938	0	131	aatg	attc
V350256906L3C005R04000556378	chr1	908591	50M	187	908778	908592	908779	V350256906L3C005R04000556378_chr1_908591	0	171	GCAT	CCAG
V350256906L3C005R04000734505	chr1	825244	50M	149	825393	825245	825394	V350256906L3C005R04000734505_chr1_825244	0	10	tcat	gaaa
V350256906L3C005R04000952936	chr1	1348408	50M	185	1348593	1348409	1348594	V350256906L3C005R04000952936_chr1_1348408	75	67	acgt	cttg
V350256906L3C005R04001043375	chr1	1216191	50M	177	1216368	1216192	1216369	V350256906L3C005R04001043375_chr1_1216191	66	124	CACA	GGCA
V350256906L3C005R04001305885	chr1	724665	45M5S	217	724882	724666	724883	V350256906L3C005R04001305885_chr1_724665	51	43	tgga	CATT
V350256906L3C005R04100260695	chr1	1037191	50M	179	1037370	1037192	1037371	V350256906L3C005R04100260695_chr1_1037191	81	23	cctg	agcg
V350256906L3C005R04100598328	chr1	1429697	50M	180	1429877	1429698	1429878	V350256906L3C005R04100598328_chr1_1429697	151	0	CGTG	CCAG
V350256906L3C005R04201080634	chr1	80295	50M	160	80455	80296	80456	V350256906L3C005R04201080634_chr1_80295	2	39	cacc	cttt
V350256906L3C005R04300121000	chr1	932835	50M	164	932999	932836	933000	V350256906L3C005R04300121000_chr1_932835	44	0	CCTC	GGCC
V350256906L3C005R04300182140	chr1	466657	50M	208	466865	466658	466866	V350256906L3C005R04300182140_chr1_466657	83	53	ATTG	ACTT
V350256906L3C005R04300457444	chr1	328434	50M	169	328603	328435	328604	V350256906L3C005R04300457444_chr1_328434	46	39	ATGT	CCCC
V350256906L3C005R04300560263	chr1	726606	5S45M	148	726754	726607	726755	V350256906L3C005R04300560263_chr1_726606	0	59	gaat	attc
V350256906L3C005R04300783099	chr1	1240895	50M	168	1241063	1240896	1241064	V350256906L3C005R04300783099_chr1_1240895	23	44	GGAG	TGGG
V350256906L3C005R04301032238	chr1	1142728	50M	162	1142890	1142729	1142891	V350256906L3C005R04301032238_chr1_1142728	88	0	CCTA	CACG
V350256906L3C005R04301149866	chr1	971340	50M	162	971502	971341	971503	V350256906L3C005R04301149866_chr1_971340	25	13	TGAG	CACA
V350256906L3C005R04400146437	chr1	733100	50M	177	733277	733101	733278	V350256906L3C005R04400146437_chr1_733100	73	250	TGTA	CTGT
V350256906L3C005R04400162851	chr1	78051	50M	166	78217	78052	78218	V350256906L3C005R04400162851_chr1_78051	5	40	agca	ggtc
V350256906L3C005R04400302469	chr1	1144893	27M1I22M	164	1145057	1144894	1145058	V350256906L3C005R04400302469_chr1_1144893	5	0	TCTT	tcta
V350256906L3C005R04400310374	chr1	635490	50M	171	635661	635491	635662	V350256906L3C005R04400310374_chr1_635490	0	49	ccag	gggg
V350256906L3C005R04400430625	chr1	98978	50M	160	99138	98979	99139	V350256906L3C005R04400430625_chr1_98978	21	55	CCTC	tgac
V350256906L3C005R04401068345	chr1	1258299	50M	163	1258462	1258300	1258463	V350256906L3C005R04401068345_chr1_1258299	119	20	CCCA	CATG
V350256906L3C005R04401165686	chr1	779312	50M	154	779466	779313	779467	V350256906L3C005R04401165686_chr1_779312	25	69	AGAG	ctaa
V350256906L3C005R04500057364	chr1	751917	50M	180	752097	751918	752098	V350256906L3C005R04500057364_chr1_751917	35	67	ACat	ggct
V350256906L3C005R04500070829	chr1	341275	50M	164	341439	341276	341440	V350256906L3C005R04500070829_chr1_341275	47	76	CCAG	CACA
V350256906L3C005R04500195916	chr1	466792	50M	165	466957	466793	466958	V350256906L3C005R04500195916_chr1_466792	126	23	GACA	CATT
V350256906L3C005R04500573208	chr1	423568	50M	160	423728	423569	423729	V350256906L3C005R04500573208_chr1_423568	79	239	actg	cctt
V350256906L3C005R04500758936	chr1	428631	50M	161	428792	428632	428793	V350256906L3C005R04500758936_chr1_428631	0	5	attt	GTTC
V350256906L3C005R04500910135	chr1	928033	50M	179	928212	928034	928213	V350256906L3C005R04500910135_chr1_928033	52	19	ctaA	TGAA
V350256906L3C005R04600032061	chr1	1379404	50M	145	1379549	1379405	1379550	V350256906L3C005R04600032061_chr1_1379404	0	49	gtct	GCAC
V350256906L3C005R04600293128	chr1	1333823	50M	145	1333968	1333824	1333969	V350256906L3C005R04600293128_chr1_1333823	54	64	ACCC	CCTC
V350256906L3C005R04600301323	chr1	68614	50M	221	68835	68615	68836	V350256906L3C005R04600301323_chr1_68614	143	34	tatt	CCAT
V350256906L3C005R04600392514	chr1	264734	50M	170	264904	264735	264905	V350256906L3C005R04600392514_chr1_264734	24	106	ggaa	ctct
V350256906L3C005R04600743696	chr1	345968	50M	182	346150	345969	346151	V350256906L3C005R04600743696_chr1_345968	15	11	ggtc	catg
V350256906L3C005R04601083444	chr1	927880	50M	169	928049	927881	928050	V350256906L3C005R04601083444_chr1_927880	8	36	aata	ATAT
V350256906L3C005R04701055015	chr1	579426	50M	184	579610	579427	579611	V350256906L3C005R04701055015_chr1_579426	144	13	agag	ctaa
V350256906L3C005R04701060231	chr1	1004685	50M	161	1004846	1004686	1004847	V350256906L3C005R04701060231_chr1_1004685	86	39	ACCT	CCAC
V350256906L3C005R04800497537	chr1	876828	50M	137	876965	876829	876966	V350256906L3C005R04800497537_chr1_876828	59	196	GACA	CCTC
V350256906L3C005R04800544713	chr1	1132863	50M	123	1132986	1132864	1132987	V350256906L3C005R04800544713_chr1_1132863	41	3	TGTT	TGGC
V350256906L3C005R04801006392	chr1	726405	31S19M	192	726597	726406	726598	V350256906L3C005R04801006392_chr1_726405	6	3	aatg	ccat
V350256906L3C005R04801017303	chr1	781282	50M	185	781467	781283	781468	V350256906L3C005R04801017303_chr1_781282	63	30	CCTG	tatc
V350256906L3C005R04801061354	chr1	17497	50M	174	17671	17498	17672	V350256906L3C005R04801061354_chr1_17497	26	8	CCCC	GGGG
V350256906L3C005R04801400545	chr1	645349	50M	182	645531	645350	645532	V350256906L3C005R04801400545_chr1_645349	39	119	tgaa	TGAT
V350256906L3C005R04900323990	chr1	1148148	50M	176	1148324	1148149	1148325	V350256906L3C005R04900323990_chr1_1148148	14	14	GAGC	TCTG
V350256906L3C005R04900396724	chr1	1007749	50M	185	1007934	1007750	1007935	V350256906L3C005R04900396724_chr1_1007749	44	60	CTTG	AGCA
V350256906L3C005R04900737479	chr1	1318607	50M	175	1318782	1318608	1318783	V350256906L3C005R04900737479_chr1_1318607	35	19	ctac	cctc
V350256906L3C005R04901105322	chr1	698719	50M	144	698863	698720	698864	V350256906L3C005R04901105322_chr1_698719	31	0	CCAG	GAAA
V350256906L3C005R05000100237	chr1	1001213	50M	187	1001400	1001214	1001401	V350256906L3C005R05000100237_chr1_1001213	89	26	gctg	cccc
V350256906L3C005R05000256274	chr1	830681	50M	180	830861	830682	830862	V350256906L3C005R05000256274_chr1_830681	36	69	cccg	ccca
V350256906L3C005R05000257784	chr1	1294190	50M	170	1294360	1294191	1294361	V350256906L3C005R05000257784_chr1_1294190	62	58	CGTG	CTCA
V350256906L3C005R05000462937	chr1	915053	50M	152	915205	915054	915206	V350256906L3C005R05000462937_chr1_915053	41	71	CGGC	CACA
V350256906L3C005R05000628660	chr1	908240	50M	167	908407	908241	908408	V350256906L3C005R05000628660_chr1_908240	2	13	GGTT	CCCC
V350256906L3C005R05001101947	chr1	30359	50M	182	30541	30360	30542	V350256906L3C005R05001101947_chr1_30359	0	2	aaag	GAAG
V350256906L3C005R05001160278	chr1	813754	50M	146	813900	813755	813901	V350256906L3C005R05001160278_chr1_813754	251	105	ACCA	AAAA
V350256906L3C005R05100008080	chr1	567993	50M	167	568160	567994	568161	V350256906L3C005R05100008080_chr1_567993	29	32	TAGA	CCTA
V350256906L3C005R05100156949	chr1	334647	50M	165	334812	334648	334813	V350256906L3C005R05100156949_chr1_334647	77	102	ggag	tggg
V350256906L3C005R05100370241	chr1	726945	50M	205	727150	726946	727151	V350256906L3C005R05100370241_chr1_726945	50	46	gaat	GTTT
V350256906L3C005R05100380361	chr1	1126852	50M	172	1127024	1126853	1127025	V350256906L3C005R05100380361_chr1_1126852	37	30	caaa	cctc
V350256906L3C005R05100589883	chr1	1181453	50M	142	1181595	1181454	1181596	V350256906L3C005R05100589883_chr1_1181453	9	45	GGCT	CTGA
V350256906L3C005R05100657430	chr1	152904	50M	137	153041	152905	153042	V350256906L3C005R05100657430_chr1_152904	614	477	cacc	tgag
V350256906L3C005R05101031785	chr1	14807	50M	177	14984	14808	14985	V350256906L3C005R05101031785_chr1_14807	214	190	CCCA	CATG
V350256906L3C005R05101113633	chr1	593647	50M	182	593829	593648	593830	V350256906L3C005R05101113633_chr1_593647	59	57	GGAT	GTAA
V350256906L3C005R05101222946	chr1	954573	50M	145	954718	954574	954719	V350256906L3C005R05101222946_chr1_954573	50	25	caag	CCCA
V350256906L3C005R05101305675	chr1	381044	50M	223	381267	381045	381268	V350256906L3C005R05101305675_chr1_381044	69	129	ccat	tgat
V350256906L3C005R05200309537	chr1	1377536	50M	178	1377714	1377537	1377715	V350256906L3C005R05200309537_chr1_1377536	57	66	CTGT	CCCT
V350256906L3C005R05200649842	chr1	1030175	50M	162	1030337	1030176	1030338	V350256906L3C005R05200649842_chr1_1030175	58	30	tttg	cata
V350256906L3C005R05200707224	chr1	745634	50M	185	745819	745635	745820	V350256906L3C005R05200707224_chr1_745634	20	31	TCAA	GCCA
V350256906L3C005R05200854339	chr1	549250	50M	175	549425	549251	549426	V350256906L3C005R05200854339_chr1_549250	0	13	CTTA	CTTT
V350256906L3C005R05200877916	chr1	1022285	50M	184	1022469	1022286	1022470	V350256906L3C005R05200877916_chr1_1022285	38	29	GGGC	GGCC
V350256906L3C005R05200905109	chr1	1323079	50M	166	1323245	1323080	1323246	V350256906L3C005R05200905109_chr1_1323079	83	60	CCTC	CAAA
V350256906L3C005R05200977496	chr1	1091103	50M	169	1091272	1091104	1091273	V350256906L3C005R05200977496_chr1_1091103	30	22	TGGT	GAAA
V350256906L3C005R05300018132	chr1	20850	50M	171	21021	20851	21022	V350256906L3C005R05300018132_chr1_20850	27	53	CACA	CAGG
V350256906L3C005R05300054860	chr1	1211338	50M	202	1211540	1211339	1211541	V350256906L3C005R05300054860_chr1_1211338	0	0	caat	cagg
V350256906L3C005R05300686611	chr1	18264	50M	167	18431	18265	18432	V350256906L3C005R05300686611_chr1_18264	61	24	CTAC	GTGT
V350256906L3C005R05301123581	chr1	438263	50M	186	438449	438264	438450	V350256906L3C005R05301123581_chr1_438263	15	0	CAGG	CTGC
V350256906L3C005R05301198081	chr1	789365	50M	172	789537	789366	789538	V350256906L3C005R05301198081_chr1_789365	253	102	GGAG	CAAT
V350256906L3C005R05301219526	chr1	711743	50M	189	711932	711744	711933	V350256906L3C005R05301219526_chr1_711743	9	128	caaa	cgct
V350256906L3C005R05400262108	chr1	397127	50M	174	397301	397128	397302	V350256906L3C005R05400262108_chr1_397127	0	0	ATTG	gcag
V350256906L3C005R05400285411	chr1	822049	50M	215	822264	822050	822265	V350256906L3C005R05400285411_chr1_822049	139	222	gtgg	agct
V350256906L3C005R05400589916	chr1	576584	50M	165	576749	576585	576750	V350256906L3C005R05400589916_chr1_576584	57	46	gcca	CCTA
V350256906L3C005R05400888257	chr1	115417	50M	187	115604	115418	115605	V350256906L3C005R05400888257_chr1_115417	69	87	gaat	cttt
V350256906L3C005R05401343651	chr1	1158766	50M	131	1158897	1158767	1158898	V350256906L3C005R05401343651_chr1_1158766	131	207	CCTC	GTGA
V350256906L3C005R05401355183	chr1	343618	50M	189	343807	343619	343808	V350256906L3C005R05401355183_chr1_343618	178	0	gctt	AGAT
V350256906L3C005R05500301366	chr1	636009	50M	177	636186	636010	636187	V350256906L3C005R05500301366_chr1_636009	169	0	cagt	tgga
V350256906L3C005R05500427700	chr1	445859	50M	198	446057	445860	446058	V350256906L3C005R05500427700_chr1_445859	154	90	cggg	gctc
V350256906L3C005R05500652353	chr1	591988	50M	167	592155	591989	592156	V350256906L3C005R05500652353_chr1_591988	0	3	caaa	atat
V350256906L3C005R05600569268	chr1	1173340	50M	167	1173507	1173341	1173508	V350256906L3C005R05600569268_chr1_1173340	47	56	CCCG	CGAG
V350256906L3C005R05601038644	chr1	646000	50M	173	646173	646001	646174	V350256906L3C005R05601038644_chr1_646000	216	205	gttt	tgat
V350256906L3C005R05700478298	chr1	1264124	50M	148	1264272	1264125	1264273	V350256906L3C005R05700478298_chr1_1264124	57	42	CTGG	CCCA
V350256906L3C005R05800332577	chr1	428623	50M	170	428793	428624	428794	V350256906L3C005R05800332577_chr1_428623	0	4	ggac	GGTT
V350256906L3C005R05800981423	chr1	1074078	50M	168	1074246	1074079	1074247	V350256906L3C005R05800981423_chr1_1074078	61	39	CCTG	CCCC
V350256906L3C005R05801026481	chr1	1074327	50M	176	1074503	1074328	1074504	V350256906L3C005R05801026481_chr1_1074327	37	112	AGCC	CCCC
V350256906L3C005R05801257374	chr1	825881	50M	161	826042	825882	826043	V350256906L3C005R05801257374_chr1_825881	164	225	TTTT	tgaa
V350256906L3C005R05900480037	chr1	983256	50M	148	983404	983257	983405	V350256906L3C005R05900480037_chr1_983256	76	40	CGTG	CAGG
V350256906L3C005R05900950332	chr1	1289577	50M	225	1289802	1289578	1289803	V350256906L3C005R05900950332_chr1_1289577	67	27	TTGA	GGCC
V350256906L3C005R06000198705	chr1	741908	50M	173	742081	741909	742082	V350256906L3C005R06000198705_chr1_741908	118	17	GGCA	GGAT
V350256906L3C005R06000205629	chr1	711373	50M	186	711559	711374	711560	V350256906L3C005R06000205629_chr1_711373	72	0	AAGA	caac
V350256906L3C005R06000257168	chr1	778442	50M	198	778640	778443	778641	V350256906L3C005R06000257168_chr1_778442	90	73	CCGA	CTTC
V350256906L3C005R06000432339	chr1	1028869	50M	150	1029019	1028870	1029020	V350256906L3C005R06000432339_chr1_1028869	24	0	GCCA	agga
V350256906L3C005R06000446928	chr1	951438	50M	206	951644	951439	951645	V350256906L3C005R06000446928_chr1_951438	0	29	TGCt	cagt
V350256906L3C005R06000526332	chr1	820212	50M	170	820382	820213	820383	V350256906L3C005R06000526332_chr1_820212	0	139	attc	gctg
V350256906L3C005R06000599548	chr1	1105827	50M	188	1106015	1105828	1106016	V350256906L3C005R06000599548_chr1_1105827	84	272	CCCC	CCCA
V350256906L3C005R06000825309	chr1	1087368	50M	157	1087525	1087369	1087526	V350256906L3C005R06000825309_chr1_1087368	9	38	caac	ggac
V350256906L3C005R06100119387	chr1	821134	50M	154	821288	821135	821289	V350256906L3C005R06100119387_chr1_821134	60	67	gggg	aaaa
V350256906L3C005R06100131062	chr1	1332061	50M	165	1332226	1332062	1332227	V350256906L3C005R06100131062_chr1_1332061	64	38	gcga	accc
V350256906L3C005R06100177243	chr1	651130	50M	194	651324	651131	651325	V350256906L3C005R06100177243_chr1_651130	64	91	tgag	AGTT
V350256906L3C005R06100336527	chr1	1253624	50M	183	1253807	1253625	1253808	V350256906L3C005R06100336527_chr1_1253624	40	42	ccca	ctca
V350256906L3C005R06100464468	chr1	857293	50M	179	857472	857294	857473	V350256906L3C005R06100464468_chr1_857293	57	63	CCTG	GCTC
V350256906L3C005R06100965336	chr1	670013	50M	171	670184	670014	670185	V350256906L3C005R06100965336_chr1_670013	51	54	cctc	TTTG
V350256906L3C005R06101045131	chr1	148114	50M	173	148287	148115	148288	V350256906L3C005R06101045131_chr1_148114	38	211	tgag	caag
V350256906L3C005R06200131735	chr1	892889	50M	165	893054	892890	893055	V350256906L3C005R06200131735_chr1_892889	57	65	CCTG	tgct
V350256906L3C005R06200195113	chr1	886506	50M	210	886716	886507	886717	V350256906L3C005R06200195113_chr1_886506	43	87	CCTC	GATG
V350256906L3C005R06200856718	chr1	1196937	50M	168	1197105	1196938	1197106	V350256906L3C005R06200856718_chr1_1196937	29	61	CACT	cagt
V350256906L3C005R06200941724	chr1	911294	50M	220	911514	911295	911515	V350256906L3C005R06200941724_chr1_911294	9	0	TGGc	CGAC
V350256906L3C005R06201127321	chr1	1113891	50M	167	1114058	1113892	1114059	V350256906L3C005R06201127321_chr1_1113891	51	40	agat	CATG
V350256906L3C005R06300208854	chr1	946011	50M	167	946178	946012	946179	V350256906L3C005R06300208854_chr1_946011	0	2	CTAA	ccag
V350256906L3C005R06300268058	chr1	1002840	50M	173	1003013	1002841	1003014	V350256906L3C005R06300268058_chr1_1002840	61	77	CTGG	CCCT
V350256906L3C005R06300311202	chr1	1140214	50M	184	1140398	1140215	1140399	V350256906L3C005R06300311202_chr1_1140214	47	51	GAGA	GTCT
V350256906L3C005R06300686183	chr1	750177	50M	165	750342	750178	750343	V350256906L3C005R06300686183_chr1_750177	0	63	GGCA	CGCA
V350256906L3C005R06300721506	chr1	1275851	50M	155	1276006	1275852	1276007	V350256906L3C005R06300721506_chr1_1275851	71	14	GATG	CTGA
V350256906L3C005R06300745011	chr1	415905	50M	171	416076	415906	416077	V350256906L3C005R06300745011_chr1_415905	76	40	ATCA	TATT
V350256906L3C005R06301144287	chr1	1382441	50M	178	1382619	1382442	1382620	V350256906L3C005R06301144287_chr1_1382441	0	26	gttc	actc
V350256906L3C005R06301238604	chr1	92122	50M	183	92305	92123	92306	V350256906L3C005R06301238604_chr1_92122	208	157	cgca	caga
V350256906L3C005R06301343970	chr1	414875	50M	185	415060	414876	415061	V350256906L3C005R06301343970_chr1_414875	25	42	ctta	ggcc
V350256906L3C005R06301354323	chr1	334630	50M	179	334809	334631	334810	V350256906L3C005R06301354323_chr1_334630	60	105	cttg	gata
V350256906L3C005R06400215306	chr1	1195231	50M	120	1195351	1195232	1195352	V350256906L3C005R06400215306_chr1_1195231	74	4	tgtg	AGAG
V350256906L3C005R06400267510	chr1	887067	50M	239	887306	887068	887307	V350256906L3C005R06400267510_chr1_887067	70	38	CCCA	CTCT
V350256906L3C005R06400296345	chr1	332962	50M	152	333114	332963	333115	V350256906L3C005R06400296345_chr1_332962	55	19	tctc	gacc
V350256906L3C005R06400456416	chr1	711764	50M	150	711914	711765	711915	V350256906L3C005R06400456416_chr1_711764	0	110	cgtc	cctc
V350256906L3C005R06400552601	chr1	1217079	50M	161	1217240	1217080	1217241	V350256906L3C005R06400552601_chr1_1217079	0	58	CTGA	GGTG
V350256906L3C005R06400742843	chr1	639262	50M	149	639411	639263	639412	V350256906L3C005R06400742843_chr1_639262	7	66	ACCA	CCAC
V350256906L3C005R06400853105	chr1	232535	38M1D12M	151	232686	232536	232687	V350256906L3C005R06400853105_chr1_232535	17	52	ACCA	CACA
V350256906L3C005R06400890240	chr1	820879	50M	124	821003	820880	821004	V350256906L3C005R06400890240_chr1_820879	17	0	tatt	taaa
V350256906L3C005R06401221019	chr1	367389	50M	145	367534	367390	367535	V350256906L3C005R06401221019_chr1_367389	23	52	TCTT	ACAG
V350256906L3C005R06401292407	chr1	911028	50M	159	911187	911029	911188	V350256906L3C005R06401292407_chr1_911028	85	42	TGTG	ccct
V350256906L3C005R06500367484	chr1	401832	50M	166	401998	401833	401999	V350256906L3C005R06500367484_chr1_401832	32	22	cttg	gaat
V350256906L3C005R06500524226	chr1	654202	50M	171	654373	654203	654374	V350256906L3C005R06500524226_chr1_654202	136	202	gggt	cttt
V350256906L3C005R06500912836	chr1	667021	50M	160	667181	667022	667182	V350256906L3C005R06500912836_chr1_667021	124	253	ccca	cact
V350256906L3C005R06600139823	chr1	773043	50M	176	773219	773044	773220	V350256906L3C005R06600139823_chr1_773043	6	110	cagt	ctgg
V350256906L3C005R06600495135	chr1	253948	50M	156	254104	253949	254105	V350256906L3C005R06600495135_chr1_253948	39	63	tagc	tagc
V350256906L3C005R06600758016	chr1	80595	50M	165	80760	80596	80761	V350256906L3C005R06600758016_chr1_80595	53	48	caaa	ccat
V350256906L3C005R06600941257	chr1	986304	50M	171	986475	986305	986476	V350256906L3C005R06600941257_chr1_986304	21	50	AGCT	CCTA
V350256906L3C005R06601176367	chr1	1195439	50M	183	1195622	1195440	1195623	V350256906L3C005R06601176367_chr1_1195439	53	31	GCAG	GTGT
V350256906L3C005R06601241719	chr1	1080488	50M	129	1080617	1080489	1080618	V350256906L3C005R06601241719_chr1_1080488	30	1	CCCC	TGGA
V350256906L3C005R06601336947	chr1	1137735	50M	197	1137932	1137736	1137933	V350256906L3C005R06601336947_chr1_1137735	27	0	ccca	ggct
V350256906L3C005R06601389771	chr1	1308513	50M	158	1308671	1308514	1308672	V350256906L3C005R06601389771_chr1_1308513	52	33	CAGC	CGCC
V350256906L3C005R06700407759	chr1	1010453	50M	159	1010612	1010454	1010613	V350256906L3C005R06700407759_chr1_1010453	37	50	GGAG	CACT
V350256906L3C005R06700503385	chr1	65090	50M	147	65237	65091	65238	V350256906L3C005R06700503385_chr1_65090	0	116	TTGG	AAAA
V350256906L3C005R06700563501	chr1	1273392	50M	167	1273559	1273393	1273560	V350256906L3C005R06700563501_chr1_1273392	81	30	TAGC	GCCA
V350256906L3C005R06700834753	chr1	62752	50M	175	62927	62753	62928	V350256906L3C005R06700834753_chr1_62752	153	15	GCAC	TCTG
V350256906L3C005R06701138066	chr1	1179336	50M	166	1179502	1179337	1179503	V350256906L3C005R06701138066_chr1_1179336	12	9	CCTG	GCCC
V350256906L3C005R06701203752	chr1	1113080	50M	194	1113274	1113081	1113275	V350256906L3C005R06701203752_chr1_1113080	64	79	TAGA	GGGC
V350256906L3C005R06701379379	chr1	1055994	50M	184	1056178	1055995	1056179	V350256906L3C005R06701379379_chr1_1055994	72	78	CTAG	caag
V350256906L3C005R06800088320	chr1	67893	50M	162	68055	67894	68056	V350256906L3C005R06800088320_chr1_67893	64	73	ATCA	ccag
V350256906L3C005R06801117573	chr1	707596	50M	187	707783	707597	707784	V350256906L3C005R06801117573_chr1_707596	12	0	GGGT	CCTG
V350256906L3C005R06900128269	chr1	663127	50M	154	663281	663128	663282	V350256906L3C005R06900128269_chr1_663127	62	35	GGAC	AGCT
V350256906L3C005R06900183794	chr1	1200304	50M	153	1200457	1200305	1200458	V350256906L3C005R06900183794_chr1_1200304	41	67	GACG	CAAC
V350256906L3C005R06900384070	chr1	1317705	20M2D30M	169	1317874	1317706	1317875	V350256906L3C005R06900384070_chr1_1317705	135	304	CCAA	TAGT
V350256906L3C005R06900404385	chr1	573574	50M	170	573744	573575	573745	V350256906L3C005R06900404385_chr1_573574	56	80	GTAT	TTtg
V350256906L3C005R06900464882	chr1	706442	50M	138	706580	706443	706581	V350256906L3C005R06900464882_chr1_706442	181	142	GCCC	CCCT
V350256906L3C005R06900501677	chr1	850123	50M	161	850284	850124	850285	V350256906L3C005R06900501677_chr1_850123	0	5	cgag	cgat
V350256906L3C005R06900786118	chr1	230620	50M	162	230782	230621	230783	V350256906L3C005R06900786118_chr1_230620	68	64	aaat	cact
V350256906L3C005R07000171406	chr1	1380989	50M	178	1381167	1380990	1381168	V350256906L3C005R07000171406_chr1_1380989	48	7	cccg	cctt
V350256906L3C005R07000232129	chr1	46550	50M	166	46716	46551	46717	V350256906L3C005R07000232129_chr1_46550	0	154	CATc	tcta
V350256906L3C005R07000313349	chr1	172500	50M	155	172655	172501	172656	V350256906L3C005R07000313349_chr1_172500	22	67	CCAG	CTGC
V350256906L3C005R07000425774	chr1	659148	50M	133	659281	659149	659282	V350256906L3C005R07000425774_chr1_659148	22	82	CTTC	CCTA
V350256906L3C005R07000555444	chr1	612405	50M	188	612593	612406	612594	V350256906L3C005R07000555444_chr1_612405	0	36	cagc	cttc
V350256906L3C005R07000776889	chr1	1160206	50M	156	1160362	1160207	1160363	V350256906L3C005R07000776889_chr1_1160206	61	77	cctc	CCCC
V350256906L3C005R07000822052	chr1	781040	50M	133	781173	781041	781174	V350256906L3C005R07000822052_chr1_781040	10	0	AAAC	AGCG
V350256906L3C005R07000921800	chr1	933986	50M	195	934181	933987	934182	V350256906L3C005R07000921800_chr1_933986	51	25	CCGG	GAGG
V350256906L3C005R07001241515	chr1	338340	50M	192	338532	338341	338533	V350256906L3C005R07001241515_chr1_338340	26	13	TGTA	agcc
V350256906L3C005R07100197535	chr1	866000	50M	151	866151	866001	866152	V350256906L3C005R07100197535_chr1_866000	68	44	CCCT	CTCT
V350256906L3C005R07100401929	chr1	16252	50M	175	16427	16253	16428	V350256906L3C005R07100401929_chr1_16252	7	182	AGAG	CACT
V350256906L3C005R07100422542	chr1	705907	50M	158	706065	705908	706066	V350256906L3C005R07100422542_chr1_705907	7	14	cgca	CCTC
V350256906L3C005R07100441001	chr1	1424487	50M	173	1424660	1424488	1424661	V350256906L3C005R07100441001_chr1_1424487	0	0	CCTG	CTCA
V350256906L3C005R07100724963	chr1	807497	50M	141	807638	807498	807639	V350256906L3C005R07100724963_chr1_807497	23	56	TAGC	TATA
V350256906L3C005R07100747005	chr1	884713	50M	171	884884	884714	884885	V350256906L3C005R07100747005_chr1_884713	118	23	CAGC	CTCA
V350256906L3C005R07100943538	chr1	625264	50M	179	625443	625265	625444	V350256906L3C005R07100943538_chr1_625264	53	48	TGAA	CCTT
V350256906L3C005R07101111285	chr1	779348	50M	170	779518	779349	779519	V350256906L3C005R07101111285_chr1_779348	0	17	GAAC	ctct
V350256906L3C005R07101231685	chr1	784277	50M	163	784440	784278	784441	V350256906L3C005R07101231685_chr1_784277	153	0	TGTG	TGGG
V350256906L3C005R07200419176	chr1	109742	50M	166	109908	109743	109909	V350256906L3C005R07200419176_chr1_109742	0	41	TGCT	ctgt
V350256906L3C005R07200595816	chr1	152337	50M	163	152500	152338	152501	V350256906L3C005R07200595816_chr1_152337	490	653	tgag	tagc
V350256906L3C005R07201392871	chr1	566787	50M	171	566958	566788	566959	V350256906L3C005R07201392871_chr1_566787	75	183	CTGC	AATT
V350256906L3C006R00100555291	chr1	748031	50M	173	748204	748032	748205	V350256906L3C006R00100555291_chr1_748031	77	9	cagt	ccag
V350256906L3C006R00100715119	chr1	331890	50M	164	332054	331891	332055	V350256906L3C006R00100715119_chr1_331890	164	10	CCAT	ACCT
V350256906L3C006R00100771174	chr1	540273	50M	181	540454	540274	540455	V350256906L3C006R00100771174_chr1_540273	54	83	cact	ccct
V350256906L3C006R00101063563	chr1	779337	50M	187	779524	779338	779525	V350256906L3C006R00101063563_chr1_779337	0	11	CCAG	catg
V350256906L3C006R00101162818	chr1	623144	50M	169	623313	623145	623314	V350256906L3C006R00101162818_chr1_623144	19	188	GATT	CACA
V350256906L3C006R00200166626	chr1	835961	50M	175	836136	835962	836137	V350256906L3C006R00200166626_chr1_835961	58	60	tcca	caca
V350256906L3C006R00200440926	chr1	1064761	50M	197	1064958	1064762	1064959	V350256906L3C006R00200440926_chr1_1064761	34	32	AGGG	CGTG
V350256906L3C006R00200825145	chr1	884279	50M	158	884437	884280	884438	V350256906L3C006R00200825145_chr1_884279	69	59	CCCA	TCTT
V350256906L3C006R00200927523	chr1	44653	50M	167	44820	44654	44821	V350256906L3C006R00200927523_chr1_44653	398	565	cagg	gtgt
V350256906L3C006R00300033305	chr1	1357456	50M	178	1357634	1357457	1357635	V350256906L3C006R00300033305_chr1_1357456	32	8	TGGC	GGCC
V350256906L3C006R00300270920	chr1	1081894	50M	170	1082064	1081895	1082065	V350256906L3C006R00300270920_chr1_1081894	0	0	CACC	TCCC
V350256906L3C006R00300386454	chr1	1129061	50M	198	1129259	1129062	1129260	V350256906L3C006R00300386454_chr1_1129061	0	0	tctc	ccct
V350256906L3C006R00301124376	chr1	1008014	50M	170	1008184	1008015	1008185	V350256906L3C006R00301124376_chr1_1008014	0	13	TCTC	GGGG
V350256906L3C006R00301208762	chr1	68983	50M	166	69149	68984	69150	V350256906L3C006R00301208762_chr1_68983	0	139	GGCT	GGAA
V350256906L3C006R00301251392	chr1	1159831	50M	175	1160006	1159832	1160007	V350256906L3C006R00301251392_chr1_1159831	15	50	tgta	TGAA
V350256906L3C006R00400095739	chr1	228779	50M	190	228969	228780	228970	V350256906L3C006R00400095739_chr1_228779	56	54	TGTG	gaat
V350256906L3C006R00400159065	chr1	748922	50M	217	749139	748923	749140	V350256906L3C006R00400159065_chr1_748922	21	56	CCCT	TGAC
V350256906L3C006R00400578982	chr1	1140549	50M	186	1140735	1140550	1140736	V350256906L3C006R00400578982_chr1_1140549	62	63	GGCT	GCCT
V350256906L3C006R00400746133	chr1	836393	50M	195	836588	836394	836589	V350256906L3C006R00400746133_chr1_836393	63	65	cagg	tggt
V350256906L3C006R00401372269	chr1	578831	50M	170	579001	578832	579002	V350256906L3C006R00401372269_chr1_578831	48	27	CAGA	CCAA
V350256906L3C006R00500155383	chr1	67415	50M	180	67595	67416	67596	V350256906L3C006R00500155383_chr1_67415	42	48	TATG	TTAA
V350256906L3C006R00501264612	chr1	374202	50M	173	374375	374203	374376	V350256906L3C006R00501264612_chr1_374202	21	28	tttg	ctga
V350256906L3C006R00600067541	chr1	688275	50M	172	688447	688276	688448	V350256906L3C006R00600067541_chr1_688275	43	215	cctg	gctc
V350256906L3C006R00600179145	chr1	15921	50M	157	16078	15922	16079	V350256906L3C006R00600179145_chr1_15921	301	144	CAAC	CCCC
V350256906L3C006R00600212152	chr1	28379	50M	191	28570	28380	28571	V350256906L3C006R00600212152_chr1_28379	68	39	ACTA	CTTA
V350256906L3C006R00600243600	chr1	631283	50M	169	631452	631284	631453	V350256906L3C006R00600243600_chr1_631283	80	57	ccat	gttg
V350256906L3C006R00600402499	chr1	838303	50M	156	838459	838304	838460	V350256906L3C006R00600402499_chr1_838303	0	12	GGGT	ggag
V350256906L3C006R00600445709	chr1	1117474	50M	168	1117642	1117475	1117643	V350256906L3C006R00600445709_chr1_1117474	23	95	GGGA	GGCA
V350256906L3C006R00600578436	chr1	1118941	50M	173	1119114	1118942	1119115	V350256906L3C006R00600578436_chr1_1118941	10	84	CCAC	ACCC
V350256906L3C006R00600689004	chr1	1179735	50M	161	1179896	1179736	1179897	V350256906L3C006R00600689004_chr1_1179735	33	176	CCTG	CCCG
V350256906L3C006R00600745541	chr1	940775	35M1I14M	198	940973	940776	940974	V350256906L3C006R00600745541_chr1_940775	73	72	CCAG	tgtg
V350256906L3C006R00600757410	chr1	414429	50M	187	414616	414430	414617	V350256906L3C006R00600757410_chr1_414429	46	233	ggcc	cACC
V350256906L3C006R00600915765	chr1	707284	50M	174	707458	707285	707459	V350256906L3C006R00600915765_chr1_707284	20	14	TGTG	TGAG
V350256906L3C006R00601057556	chr1	47705	50M	176	47881	47706	47882	V350256906L3C006R00601057556_chr1_47705	9	47	CACT	AACT
V350256906L3C006R00700068490	chr1	915412	50M	157	915569	915413	915570	V350256906L3C006R00700068490_chr1_915412	49	48	GGTG	CCAC
V350256906L3C006R00700433840	chr1	1315950	50M	181	1316131	1315951	1316132	V350256906L3C006R00700433840_chr1_1315950	38	55	TGGC	GGGC
V350256906L3C006R00700543974	chr1	560594	50M	203	560797	560595	560798	V350256906L3C006R00700543974_chr1_560594	0	0	ggga	taca
V350256906L3C006R00700549824	chr1	1351557	50M	132	1351689	1351558	1351690	V350256906L3C006R00700549824_chr1_1351557	34	52	aatt	gaag
V350256906L3C006R00700636336	chr1	688973	50M	180	689153	688974	689154	V350256906L3C006R00700636336_chr1_688973	61	196	caca	ctgg
V350256906L3C006R00700731619	chr1	798185	50M	178	798363	798186	798364	V350256906L3C006R00700731619_chr1_798185	23	7	ggat	attt
V350256906L3C006R00700850311	chr1	1346704	3S47M	168	1346872	1346705	1346873	V350256906L3C006R00700850311_chr1_1346704	24	25	taac	cccc
V350256906L3C006R00701185704	chr1	84682	50M	203	84885	84683	84886	V350256906L3C006R00701185704_chr1_84682	2	205	taac	ctgt
V350256906L3C006R00701316600	chr1	133553	50M	133	133686	133554	133687	V350256906L3C006R00701316600_chr1_133553	14	63	CCTC	TCCT
V350256906L3C006R00800481999	chr1	1236443	50M	193	1236636	1236444	1236637	V350256906L3C006R00800481999_chr1_1236443	49	34	ggcc	ACCC
V350256906L3C006R00801372652	chr1	1210734	50M	186	1210920	1210735	1210921	V350256906L3C006R00801372652_chr1_1210734	32	218	CAGT	CCCC
V350256906L3C006R00801403706	chr1	392836	50M	175	393011	392837	393012	V350256906L3C006R00801403706_chr1_392836	0	0	ataa	cagc
V350256906L3C006R00900346423	chr1	1089117	50M	174	1089291	1089118	1089292	V350256906L3C006R00900346423_chr1_1089117	266	94	ccaa	AAAT
V350256906L3C006R00900451798	chr1	1175192	50M	177	1175369	1175193	1175370	V350256906L3C006R00900451798_chr1_1175192	0	0	TCCC	CCTC
V350256906L3C006R00900537247	chr1	660059	50M	201	660260	660060	660261	V350256906L3C006R00900537247_chr1_660059	142	117	CACA	CCAG
V350256906L3C006R00901090299	chr1	522273	50M	191	522464	522274	522465	V350256906L3C006R00901090299_chr1_522273	37	81	cggc	ctca
V350256906L3C006R00901309024	chr1	175535	50M	170	175705	175536	175706	V350256906L3C006R00901309024_chr1_175535	0	74	ATCC	agga
V350256906L3C006R01000439910	chr1	856968	50M	173	857141	856969	857142	V350256906L3C006R01000439910_chr1_856968	0	30	AAGC	ACAC
V350256906L3C006R01000592128	chr1	650597	50M	148	650745	650598	650746	V350256906L3C006R01000592128_chr1_650597	65	21	cgta	ctac
V350256906L3C006R01000889007	chr1	773282	50M	200	773482	773283	773483	V350256906L3C006R01000889007_chr1_773282	163	13	acta	acac
V350256906L3C006R01001001614	chr1	650310	50M	182	650492	650311	650493	V350256906L3C006R01001001614_chr1_650310	42	53	tgca	ggcg
V350256906L3C006R01001061951	chr1	808075	50M	188	808263	808076	808264	V350256906L3C006R01001061951_chr1_808075	0	0	TCCT	AGAT
V350256906L3C006R01001183879	chr1	577494	50M	132	577626	577495	577627	V350256906L3C006R01001183879_chr1_577494	68	34	CATC	GGCA
V350256906L3C006R01100856035	chr1	1421852	50M	156	1422008	1421853	1422009	V350256906L3C006R01100856035_chr1_1421852	84	19	CAGG	GGCG
V350256906L3C006R01101271301	chr1	726727	26M24S	226	726953	726728	726954	V350256906L3C006R01101271301_chr1_726727	78	42	atgg	ttcc
V350256906L3C006R01200142027	chr1	252699	50M	151	252850	252700	252851	V350256906L3C006R01200142027_chr1_252699	333	195	GAAA	CGTc
V350256906L3C006R01200195508	chr1	1404233	50M	194	1404427	1404234	1404428	V350256906L3C006R01200195508_chr1_1404233	75	54	CCTC	cagg
V350256906L3C006R01200497889	chr1	951398	50M	185	951583	951399	951584	V350256906L3C006R01200497889_chr1_951398	4	1	ccca	ccat
V350256906L3C006R01200680347	chr1	878187	50M	204	878391	878188	878392	V350256906L3C006R01200680347_chr1_878187	16	23	GCCC	TGGA
V350256906L3C006R01300021955	chr1	133004	50M	202	133206	133005	133207	V350256906L3C006R01300021955_chr1_133004	0	0	CATG	GGGT
V350256906L3C006R01300714192	chr1	104920	50M	156	105076	104921	105077	V350256906L3C006R01300714192_chr1_104920	0	25	tcag	agaa
V350256906L3C006R01300741829	chr1	231490	50M	171	231661	231491	231662	V350256906L3C006R01300741829_chr1_231490	218	353	ggta	agat
V350256906L3C006R01300765348	chr1	973378	50M	152	973530	973379	973531	V350256906L3C006R01300765348_chr1_973378	110	9	CAGT	TGAC
V350256906L3C006R01301049233	chr1	547673	50M	154	547827	547674	547828	V350256906L3C006R01301049233_chr1_547673	166	83	CTCT	CATG
V350256906L3C006R01400738939	chr1	16836	50M	178	17014	16837	17015	V350256906L3C006R01400738939_chr1_16836	33	113	TCCC	CCTG
V350256906L3C006R01400782204	chr1	522077	50M	177	522254	522078	522255	V350256906L3C006R01400782204_chr1_522077	57	56	tact	ctca
V350256906L3C006R01401071017	chr1	466905	50M	152	467057	466906	467058	V350256906L3C006R01401071017_chr1_466905	13	123	CTGT	AAAT
V350256906L3C006R01401336789	chr1	37315	50M	164	37479	37316	37480	V350256906L3C006R01401336789_chr1_37315	64	60	tatt	CCCT
V350256906L3C006R01500219513	chr1	51662	50M	177	51839	51663	51840	V350256906L3C006R01500219513_chr1_51662	64	14	cgag	ggct
V350256906L3C006R01500285223	chr1	1364326	50M	167	1364493	1364327	1364494	V350256906L3C006R01500285223_chr1_1364326	9	7	gcca	actg
V350256906L3C006R01500510922	chr1	1184419	50M	150	1184569	1184420	1184570	V350256906L3C006R01500510922_chr1_1184419	133	283	GAGG	GGAG
V350256906L3C006R01500523053	chr1	47030	50M	194	47224	47031	47225	V350256906L3C006R01500523053_chr1_47030	94	0	actg	GAAT
V350256906L3C006R01500624320	chr1	1168671	50M	152	1168823	1168672	1168824	V350256906L3C006R01500624320_chr1_1168671	58	33	GGAC	GCGC
V350256906L3C006R01500976056	chr1	1198408	50M	213	1198621	1198409	1198622	V350256906L3C006R01500976056_chr1_1198408	85	25	ACTG	GGAT
V350256906L3C006R01501142505	chr1	234193	50M	183	234376	234194	234377	V350256906L3C006R01501142505_chr1_234193	54	67	GTTA	GGCT
V350256906L3C006R01501151850	chr1	1014858	50M	182	1015040	1014859	1015041	V350256906L3C006R01501151850_chr1_1014858	96	9	CTGA	CGCC
V350256906L3C006R01501310101	chr1	55806	50M	173	55979	55807	55980	V350256906L3C006R01501310101_chr1_55806	21	6	GGAC	GAAG
V350256906L3C006R01501351427	chr1	647871	50M	163	648034	647872	648035	V350256906L3C006R01501351427_chr1_647871	52	70	ctgg	ataa
V350256906L3C006R01600120223	chr1	711534	50M	178	711712	711535	711713	V350256906L3C006R01600120223_chr1_711534	20	40	ctgg	gcca
V350256906L3C006R01600144498	chr1	937966	50M	126	938092	937967	938093	V350256906L3C006R01600144498_chr1_937966	28	51	agta	ccag
V350256906L3C006R01600289148	chr1	1017089	50M	204	1017293	1017090	1017294	V350256906L3C006R01600289148_chr1_1017089	18	48	TGCC	CCAC
V350256906L3C006R01600368124	chr1	1204214	50M	191	1204405	1204215	1204406	V350256906L3C006R01600368124_chr1_1204214	50	56	cgcc	CAGA
V350256906L3C006R01600802749	chr1	917245	50M	161	917406	917246	917407	V350256906L3C006R01600802749_chr1_917245	0	25	CCCT	CCCA
V350256906L3C006R01601063025	chr1	1091496	50M	145	1091641	1091497	1091642	V350256906L3C006R01601063025_chr1_1091496	0	73	GCCG	GGAC
V350256906L3C006R01601396902	chr1	1174125	50M	169	1174294	1174126	1174295	V350256906L3C006R01601396902_chr1_1174125	20	12	GCCG	CGGC
V350256906L3C006R01700138591	chr1	164716	50M	101	164817	164717	164818	V350256906L3C006R01700138591_chr1_164716	0	46	ACAT	TCCC
V350256906L3C006R01700162699	chr1	421576	50M	164	421740	421577	421741	V350256906L3C006R01700162699_chr1_421576	47	74	ACAT	gctt
V350256906L3C006R01700775902	chr1	1135352	50M	215	1135567	1135353	1135568	V350256906L3C006R01700775902_chr1_1135352	40	12	CCCG	CCTT
V350256906L3C006R01701119895	chr1	726825	31S19M	145	726970	726826	726971	V350256906L3C006R01701119895_chr1_726825	0	25	gaat	catt
V350256906L3C006R01701280872	chr1	99743	50M	160	99903	99744	99904	V350256906L3C006R01701280872_chr1_99743	14	54	tgtg	tatt
V350256906L3C006R01800216050	chr1	930600	50M	183	930783	930601	930784	V350256906L3C006R01800216050_chr1_930600	43	9	tggg	ctgt
V350256906L3C006R01800770114	chr1	1398314	50M	170	1398484	1398315	1398485	V350256906L3C006R01800770114_chr1_1398314	60	63	CAGG	GGTC
V350256906L3C006R01800900485	chr1	1422034	50M	158	1422192	1422035	1422193	V350256906L3C006R01800900485_chr1_1422034	0	0	TACC	ACCC
V350256906L3C006R01800907944	chr1	581421	50M	168	581589	581422	581590	V350256906L3C006R01800907944_chr1_581421	60	55	tagt	agta
V350256906L3C006R01800976708	chr1	255928	50M	200	256128	255929	256129	V350256906L3C006R01800976708_chr1_255928	0	0	tgAA	tatg
V350256906L3C006R01801186270	chr1	1341471	50M	147	1341618	1341472	1341619	V350256906L3C006R01801186270_chr1_1341471	44	47	cacg	ctgt
V350256906L3C006R01801299459	chr1	365414	50M	145	365559	365415	365560	V350256906L3C006R01801299459_chr1_365414	50	14	TGAA	TACT
V350256906L3C006R01801340887	chr1	376079	50M	157	376236	376080	376237	V350256906L3C006R01801340887_chr1_376079	75	32	ccat	taaa
V350256906L3C006R01900130673	chr1	818419	50M	169	818588	818420	818589	V350256906L3C006R01900130673_chr1_818419	183	190	gcaa	cttc
V350256906L3C006R01900341432	chr1	149260	50M	179	149439	149261	149440	V350256906L3C006R01900341432_chr1_149260	27	118	AAGA	ccca
V350256906L3C006R01900419176	chr1	638463	50M	179	638642	638464	638643	V350256906L3C006R01900419176_chr1_638463	75	81	ccca	ccag
V350256906L3C006R01900706363	chr1	973023	50M	146	973169	973024	973170	V350256906L3C006R01900706363_chr1_973023	1	147	TGGC	GCCA
V350256906L3C006R01900951061	chr1	1373535	50M	174	1373709	1373536	1373710	V350256906L3C006R01900951061_chr1_1373535	53	69	CACC	GGCA
V350256906L3C006R01901244608	chr1	1227470	50M	122	1227592	1227471	1227593	V350256906L3C006R01901244608_chr1_1227470	30	49	GACT	CCCC
V350256906L3C006R01901271191	chr1	47834	50M	177	48011	47835	48012	V350256906L3C006R01901271191_chr1_47834	77	57	CACA	TAGT
V350256906L3C006R02000026482	chr1	658018	50M	155	658173	658019	658174	V350256906L3C006R02000026482_chr1_658018	196	106	AACA	CCCA
V350256906L3C006R02000027305	chr1	1407311	50M	169	1407480	1407312	1407481	V350256906L3C006R02000027305_chr1_1407311	78	10	cggg	ccGC
V350256906L3C006R02000053926	chr1	88385	50M	195	88580	88386	88581	V350256906L3C006R02000053926_chr1_88385	27	9	ccgc	ccac
V350256906L3C006R02000276040	chr1	823441	50M	125	823566	823442	823567	V350256906L3C006R02000276040_chr1_823441	26	52	AGCA	aaaa
V350256906L3C006R02000893175	chr1	423832	50M	169	424001	423833	424002	V350256906L3C006R02000893175_chr1_423832	330	161	aaag	taaa
V350256906L3C006R02000900949	chr1	1431124	50M	192	1431316	1431125	1431317	V350256906L3C006R02000900949_chr1_1431124	83	79	CAGG	GCCT
V350256906L3C006R02001174277	chr1	1031040	50M	175	1031215	1031041	1031216	V350256906L3C006R02001174277_chr1_1031040	10	3	cttt	ccct
V350256906L3C006R02100049795	chr1	799671	50M	176	799847	799672	799848	V350256906L3C006R02100049795_chr1_799671	9	0	CCTC	CCCC
V350256906L3C006R02100821339	chr1	248890	50M	188	249078	248891	249079	V350256906L3C006R02100821339_chr1_248890	16	60	acat	taag
V350256906L3C006R02100857352	chr1	962662	50M	170	962832	962663	962833	V350256906L3C006R02100857352_chr1_962662	19	25	CCTC	GAAG
V350256906L3C006R02101120035	chr1	1255426	50M	154	1255580	1255427	1255581	V350256906L3C006R02101120035_chr1_1255426	8	0	GCAG	TCAC
V350256906L3C006R02101171116	chr1	66002	50M	175	66177	66003	66178	V350256906L3C006R02101171116_chr1_66002	60	88	tttt	aata
V350256906L3C006R02101270304	chr1	549441	50M	179	549620	549442	549621	V350256906L3C006R02101270304_chr1_549441	0	0	CTAA	CACT
V350256906L3C006R02200222916	chr1	139041	50M	161	139202	139042	139203	V350256906L3C006R02200222916_chr1_139041	0	55	CCTG	GCCT
V350256906L3C006R02300357608	chr1	17497	50M	120	17617	17498	17618	V350256906L3C006R02300357608_chr1_17497	26	19	CCCC	ACCG
V350256906L3C006R02300438943	chr1	13909	50M	183	14092	13910	14093	V350256906L3C006R02300438943_chr1_13909	0	23	TAAG	AAGT
V350256906L3C006R02300630021	chr1	115588	50M	208	115796	115589	115797	V350256906L3C006R02300630021_chr1_115588	71	30	caat	tgag
V350256906L3C006R02301000011	chr1	1299276	50M	184	1299460	1299277	1299461	V350256906L3C006R02301000011_chr1_1299276	29	112	cccg	aaaa
V350256906L3C006R02301067309	chr1	921538	50M	187	921725	921539	921726	V350256906L3C006R02301067309_chr1_921538	3	57	cggc	gccg
V350256906L3C006R02301155095	chr1	23263	50M	175	23438	23264	23439	V350256906L3C006R02301155095_chr1_23263	0	133	agag	TCCT
V350256906L3C006R02400754320	chr1	89128	50M	150	89278	89129	89279	V350256906L3C006R02400754320_chr1_89128	2	64	cctg	TGTA
V350256906L3C006R02401098996	chr1	759773	50M	244	760017	759774	760018	V350256906L3C006R02401098996_chr1_759773	0	203	CATT	TGTA
V350256906L3C006R02401276894	chr1	731827	50M	200	732027	731828	732028	V350256906L3C006R02401276894_chr1_731827	74	65	CGTC	tgta
V350256906L3C006R02500198622	chr1	597768	50M	171	597939	597769	597940	V350256906L3C006R02500198622_chr1_597768	17	0	tctt	tgaa
V350256906L3C006R02500329785	chr1	1301531	2S37M2I9M	95	1301626	1301532	1301627	V350256906L3C006R02500329785_chr1_1301531	35	18	gtgg	acac
V350256906L3C006R02500392161	chr1	115706	50M	182	115888	115707	115889	V350256906L3C006R02500392161_chr1_115706	40	15	caca	tgat
V350256906L3C006R02500443869	chr1	598748	50M	172	598920	598749	598921	V350256906L3C006R02500443869_chr1_598748	103	25	tata	gact
V350256906L3C006R02500686543	chr1	118770	50M	145	118915	118771	118916	V350256906L3C006R02500686543_chr1_118770	106	104	agga	tgat
V350256906L3C006R02500786795	chr1	593433	50M	169	593602	593434	593603	V350256906L3C006R02500786795_chr1_593433	31	14	GCAG	TAAT
V350256906L3C006R02501337671	chr1	1101124	50M	124	1101248	1101125	1101249	V350256906L3C006R02501337671_chr1_1101124	0	24	CGGG	CCCG
V350256906L3C006R02600452576	chr1	777264	50M	176	777440	777265	777441	V350256906L3C006R02600452576_chr1_777264	0	22	CCAT	CTTC
V350256906L3C006R02600907214	chr1	1383948	50M	157	1384105	1383949	1384106	V350256906L3C006R02600907214_chr1_1383948	27	68	cagg	CCCA
V350256906L3C006R02600969075	chr1	1196281	50M	145	1196426	1196282	1196427	V350256906L3C006R02600969075_chr1_1196281	53	5	actc	CCCC
V350256906L3C006R02600986590	chr1	160516	50M	177	160693	160517	160694	V350256906L3C006R02600986590_chr1_160516	241	64	TTTA	ACCT
V350256906L3C006R02601130842	chr1	1229426	50M	169	1229595	1229427	1229596	V350256906L3C006R02601130842_chr1_1229426	34	102	ggcg	GCCC
V350256906L3C006R02700358882	chr1	70454	50M	139	70593	70455	70594	V350256906L3C006R02700358882_chr1_70454	1	140	CTTT	agaa
V350256906L3C006R02700631207	chr1	705127	50M	178	705305	705128	705306	V350256906L3C006R02700631207_chr1_705127	88	127	ctaa	acca
V350256906L3C006R02700674239	chr1	550382	50M	175	550557	550383	550558	V350256906L3C006R02700674239_chr1_550382	30	5	catc	TCTG
V350256906L3C006R02700776136	chr1	262177	50M	163	262340	262178	262341	V350256906L3C006R02700776136_chr1_262177	42	62	cagt	agga
V350256906L3C006R02700798402	chr1	630936	50M	185	631121	630937	631122	V350256906L3C006R02700798402_chr1_630936	15	34	CTAC	CTTC
V350256906L3C006R02700969253	chr1	835058	50M	167	835225	835059	835226	V350256906L3C006R02700969253_chr1_835058	60	64	ccat	TCAG
V350256906L3C006R02701162734	chr1	258443	50M	195	258638	258444	258639	V350256906L3C006R02701162734_chr1_258443	44	73	cctg	tgaa
V350256906L3C006R02701282643	chr1	263918	50M	162	264080	263919	264081	V350256906L3C006R02701282643_chr1_263918	80	35	AGGC	tggg
V350256906L3C006R02800090670	chr1	240320	50M	168	240488	240321	240489	V350256906L3C006R02800090670_chr1_240320	291	180	aaag	cagg
V350256906L3C006R02800158192	chr1	1399010	50M	170	1399180	1399011	1399181	V350256906L3C006R02800158192_chr1_1399010	51	45	gggc	gctg
V350256906L3C006R02800434995	chr1	622786	50M	187	622973	622787	622974	V350256906L3C006R02800434995_chr1_622786	269	82	TGCC	CAAG
V350256906L3C006R02800628444	chr1	853323	50M	167	853490	853324	853491	V350256906L3C006R02800628444_chr1_853323	49	34	AGGA	CCCA
V350256906L3C006R02800961844	chr1	73243	50M	155	73398	73244	73399	V350256906L3C006R02800961844_chr1_73243	53	0	cctt	agta
V350256906L3C006R02801012066	chr1	582163	50M	175	582338	582164	582339	V350256906L3C006R02801012066_chr1_582163	122	0	CAAA	CCTC
V350256906L3C006R02900001586	chr1	647530	50M	168	647698	647531	647699	V350256906L3C006R02900001586_chr1_647530	48	91	CTGA	ggag
V350256906L3C006R02900349489	chr1	991038	50M	187	991225	991039	991226	V350256906L3C006R02900349489_chr1_991038	70	57	CTCA	GGAC
V350256906L3C006R02900547262	chr1	18652	50M	162	18814	18653	18815	V350256906L3C006R02900547262_chr1_18652	221	59	CCAG	GACG
V350256906L3C006R03000028392	chr1	94871	50M	152	95023	94872	95024	V350256906L3C006R03000028392_chr1_94871	43	0	ccag	acta
V350256906L3C006R03000106386	chr1	153123	50M	182	153305	153124	153306	V350256906L3C006R03000106386_chr1_153123	395	213	acca	ccct
V350256906L3C006R03000497666	chr1	80399	50M	167	80566	80400	80567	V350256906L3C006R03000497666_chr1_80399	51	24	ggct	tgca
V350256906L3C006R03000929939	chr1	343341	50M	169	343510	343342	343511	V350256906L3C006R03000929939_chr1_343341	307	286	CTAG	gggg
V350256906L3C006R03001030517	chr1	90504	50M	143	90647	90505	90648	V350256906L3C006R03001030517_chr1_90504	79	9	tgtg	AGCA
V350256906L3C006R03001153383	chr1	1353578	50M	175	1353753	1353579	1353754	V350256906L3C006R03001153383_chr1_1353578	76	65	gctg	tggt
V350256906L3C006R03001268276	chr1	54896	50M	144	55040	54897	55041	V350256906L3C006R03001268276_chr1_54896	273	292	ccca	ggct
V350256906L3C006R03100200971	chr1	125432	50M	151	125583	125433	125584	V350256906L3C006R03100200971_chr1_125432	167	318	AGTT	CAAT
V350256906L3C006R03100304249	chr1	773363	50M	159	773522	773364	773523	V350256906L3C006R03100304249_chr1_773363	82	53	gcct	cctc
V350256906L3C006R03100464729	chr1	120623	50M	242	120865	120624	120866	V350256906L3C006R03100464729_chr1_120623	16	0	CCAA	ACCT
V350256906L3C006R03100522314	chr1	685906	50M	188	686094	685907	686095	V350256906L3C006R03100522314_chr1_685906	84	77	tcat	ctga
V350256906L3C006R03100653035	chr1	238933	50M	140	239073	238934	239074	V350256906L3C006R03100653035_chr1_238933	194	54	ggtg	aacg
V350256906L3C006R03100961794	chr1	84374	50M	172	84546	84375	84547	V350256906L3C006R03100961794_chr1_84374	85	41	gtat	cgcc
V350256906L3C006R03101090318	chr1	618310	50M	174	618484	618311	618485	V350256906L3C006R03101090318_chr1_618310	57	78	CCAT	ctat
V350256906L3C006R03200492980	chr1	1083220	50M	181	1083401	1083221	1083402	V350256906L3C006R03200492980_chr1_1083220	38	1	cagg	gggg
V350256906L3C006R03201324838	chr1	1054629	50M	164	1054793	1054630	1054794	V350256906L3C006R03201324838_chr1_1054629	63	48	TGTA	CACC
V350256906L3C006R03201375931	chr1	926592	50M	188	926780	926593	926781	V350256906L3C006R03201375931_chr1_926592	0	161	tcat	agcc
V350256906L3C006R03300370126	chr1	246738	50M	173	246911	246739	246912	V350256906L3C006R03300370126_chr1_246738	55	51	GTGC	TTTG
V350256906L3C006R03300735292	chr1	1185502	50M	244	1185746	1185503	1185747	V350256906L3C006R03300735292_chr1_1185502	60	0	tgac	cctt
V350256906L3C006R03301112284	chr1	959657	50M	257	959914	959658	959915	V350256906L3C006R03301112284_chr1_959657	401	144	GGAC	GTGG
V350256906L3C006R03301138935	chr1	1198823	50M	134	1198957	1198824	1198958	V350256906L3C006R03301138935_chr1_1198823	7	71	GAAT	AAAA
V350256906L3C006R03400038146	chr1	1278474	50M	159	1278633	1278475	1278634	V350256906L3C006R03400038146_chr1_1278474	53	49	CTCA	AGCC
V350256906L3C006R03400284881	chr1	1059191	50M	147	1059338	1059192	1059339	V350256906L3C006R03400284881_chr1_1059191	29	82	caca	tgca
V350256906L3C006R03401135196	chr1	1023832	50M	160	1023992	1023833	1023993	V350256906L3C006R03401135196_chr1_1023832	74	22	CCCC	AAAG
V350256906L3C006R03500510086	chr1	1174426	50M	163	1174589	1174427	1174590	V350256906L3C006R03500510086_chr1_1174426	0	0	CATA	TGGA
V350256906L3C006R03501097496	chr1	570954	50M	184	571138	570955	571139	V350256906L3C006R03501097496_chr1_570954	19	203	agcc	ccat
V350256906L3C006R03501272923	chr1	1038421	50M	192	1038613	1038422	1038614	V350256906L3C006R03501272923_chr1_1038421	143	164	ccat	cgca
V350256906L3C006R03600242660	chr1	998435	50M	178	998613	998436	998614	V350256906L3C006R03600242660_chr1_998435	62	66	ACTG	CCCT
V350256906L3C006R03600364972	chr1	798259	50M	154	798413	798260	798414	V350256906L3C006R03600364972_chr1_798259	51	57	ctaa	attg
V350256906L3C006R03600427698	chr1	1348036	50M	153	1348189	1348037	1348190	V350256906L3C006R03600427698_chr1_1348036	45	198	ttgt	ctat
V350256906L3C006R03600545520	chr1	1392694	50M	202	1392896	1392695	1392897	V350256906L3C006R03600545520_chr1_1392694	39	45	gcca	cacg
V350256906L3C006R03600673676	chr1	1304849	8M2D42M	179	1305028	1304850	1305029	V350256906L3C006R03600673676_chr1_1304849	108	31	AAGG	aaat
V350256906L3C006R03600721743	chr1	945390	50M	183	945573	945391	945574	V350256906L3C006R03600721743_chr1_945390	75	97	cctg	cagc
V350256906L3C006R03601100928	chr1	1362218	50M	132	1362350	1362219	1362351	V350256906L3C006R03601100928_chr1_1362218	124	0	CACG	ATCC
V350256906L3C006R03601187456	chr1	757080	50M	160	757240	757081	757241	V350256906L3C006R03601187456_chr1_757080	27	18	GGCC	TAGA
V350256906L3C006R03601325168	chr1	669655	50M	200	669855	669656	669856	V350256906L3C006R03601325168_chr1_669655	197	29	ggct	agtc
V350256906L3C006R03700008427	chr1	90405	50M	200	90605	90406	90606	V350256906L3C006R03700008427_chr1_90405	178	0	CTGC	TGGG
V350256906L3C006R03700123188	chr1	461185	50M	160	461345	461186	461346	V350256906L3C006R03700123188_chr1_461185	65	225	tggt	ttct
V350256906L3C006R03700189040	chr1	538256	50M	187	538443	538257	538444	V350256906L3C006R03700189040_chr1_538256	0	76	caga	ccac
V350256906L3C006R03700401265	chr1	734086	50M	145	734231	734087	734232	V350256906L3C006R03700401265_chr1_734086	0	3	TGTA	agag
V350256906L3C006R03700875700	chr1	719105	50M	136	719241	719106	719242	V350256906L3C006R03700875700_chr1_719105	34	87	gact	tata
V350256906L3C006R03800367340	chr1	1394143	50M	174	1394317	1394144	1394318	V350256906L3C006R03800367340_chr1_1394143	0	2	ccca	ccat
V350256906L3C006R03800474143	chr1	1335167	50M	178	1335345	1335168	1335346	V350256906L3C006R03800474143_chr1_1335167	29	0	CCCC	AGGC
V350256906L3C006R03800474493	chr1	932928	50M	160	933088	932929	933089	V350256906L3C006R03800474493_chr1_932928	41	64	CCTC	CCCA
V350256906L3C006R03801142858	chr1	533048	50M	172	533220	533049	533221	V350256906L3C006R03801142858_chr1_533048	0	8	gtta	TGAG
V350256906L3C006R03801340238	chr1	74097	50M	165	74262	74098	74263	V350256906L3C006R03801340238_chr1_74097	75	63	ttgg	accc
V350256906L3C006R03900157272	chr1	265719	50M	267	265986	265720	265987	V350256906L3C006R03900157272_chr1_265719	0	41	ATGT	tccc
V350256906L3C006R03900164116	chr1	597820	50M	211	598031	597821	598032	V350256906L3C006R03900164116_chr1_597820	11	0	ccct	acat
V350256906L3C006R03900166509	chr1	234359	50M	186	234545	234360	234546	V350256906L3C006R03900166509_chr1_234359	74	69	CTCA	AGTG
V350256906L3C006R03900386805	chr1	80798	50M	171	80969	80799	80970	V350256906L3C006R03900386805_chr1_80798	63	72	ccag	gctg
V350256906L3C006R03900555545	chr1	639541	50M	160	639701	639542	639702	V350256906L3C006R03900555545_chr1_639541	16	0	GCAT	GTCA
V350256906L3C006R03900750027	chr1	1080333	50M	194	1080527	1080334	1080528	V350256906L3C006R03900750027_chr1_1080333	40	69	AGGA	GGAG
V350256906L3C006R03900809046	chr1	657297	50M	146	657443	657298	657444	V350256906L3C006R03900809046_chr1_657297	61	138	agag	CAGG
V350256906L3C006R03900963587	chr1	892771	50M	143	892914	892772	892915	V350256906L3C006R03900963587_chr1_892771	1	32	CAGG	CGGC
V350256906L3C006R04000089289	chr1	694411	50M	189	694600	694412	694601	V350256906L3C006R04000089289_chr1_694411	83	272	GTGG	ctcc
V350256906L3C006R04000138413	chr1	253271	50M	190	253461	253272	253462	V350256906L3C006R04000138413_chr1_253271	0	0	GGCA	GTCA
V350256906L3C006R04000931326	chr1	545203	50M	201	545404	545204	545405	V350256906L3C006R04000931326_chr1_545203	67	0	AGGC	CATC
V350256906L3C006R04001037289	chr1	1307604	50M	180	1307784	1307605	1307785	V350256906L3C006R04001037289_chr1_1307604	18	5	TGCT	CAGC
V350256906L3C006R04001229627	chr1	1295615	50M	162	1295777	1295616	1295778	V350256906L3C006R04001229627_chr1_1295615	80	51	AGGC	CTCT
V350256906L3C006R04100223929	chr1	689973	50M	168	690141	689974	690142	V350256906L3C006R04100223929_chr1_689973	6	40	cgta	caac
V350256906L3C006R04100246990	chr1	812340	50M	141	812481	812341	812482	V350256906L3C006R04100246990_chr1_812340	327	186	GGGT	TCCC
V350256906L3C006R04100450026	chr1	772639	50M	145	772784	772640	772785	V350256906L3C006R04100450026_chr1_772639	0	17	TAAA	ggta
V350256906L3C006R04100583500	chr1	1144754	50M	158	1144912	1144755	1144913	V350256906L3C006R04100583500_chr1_1144754	59	24	GGGA	aaaa
V350256906L3C006R04100644353	chr1	89579	50M	196	89775	89580	89776	V350256906L3C006R04100644353_chr1_89579	0	33	GAAT	TCAA
V350256906L3C006R04100700756	chr1	949613	50M	139	949752	949614	949753	V350256906L3C006R04100700756_chr1_949613	56	39	CTGG	GGGG
V350256906L3C006R04101198486	chr1	1083360	50M	173	1083533	1083361	1083534	V350256906L3C006R04101198486_chr1_1083360	0	5	ggct	aact
V350256906L3C006R04101270551	chr1	469828	50M	174	470002	469829	470003	V350256906L3C006R04101270551_chr1_469828	205	257	AAAT	gtag
V350256906L3C006R04200215405	chr1	421540	50M	192	421732	421541	421733	V350256906L3C006R04200215405_chr1_421540	70	66	CCAA	cctg
V350256906L3C006R04200359061	chr1	631488	50M	163	631651	631489	631652	V350256906L3C006R04200359061_chr1_631488	60	62	ggtt	TGTT
V350256906L3C006R04200776531	chr1	873588	50M	174	873762	873589	873763	V350256906L3C006R04200776531_chr1_873588	220	46	CAGG	CACC
V350256906L3C006R04201401716	chr1	381231	50M	201	381432	381232	381433	V350256906L3C006R04201401716_chr1_381231	93	205	ccat	catg
V350256906L3C006R04300155002	chr1	94497	50M	189	94686	94498	94687	V350256906L3C006R04300155002_chr1_94497	26	39	CATT	cttt
V350256906L3C006R04300167535	chr1	1145127	50M	150	1145277	1145128	1145278	V350256906L3C006R04300167535_chr1_1145127	42	19	ccca	gacc
V350256906L3C006R04300306821	chr1	814886	50M	230	815116	814887	815117	V350256906L3C006R04300306821_chr1_814886	24	53	ccgt	ctat
V350256906L3C006R04300723789	chr1	1030211	50M	164	1030375	1030212	1030376	V350256906L3C006R04300723789_chr1_1030211	50	68	tgcc	ccac
V350256906L3C006R04300944279	chr1	86125	50M	199	86324	86126	86325	V350256906L3C006R04300944279_chr1_86125	54	64	aatc	tgtt
V350256906L3C006R04301214698	chr1	916006	50M	168	916174	916007	916175	V350256906L3C006R04301214698_chr1_916006	61	64	CCAG	GGCC
V350256906L3C006R04400169725	chr1	678993	50M	191	679184	678994	679185	V350256906L3C006R04400169725_chr1_678993	80	107	CACT	tgtg
V350256906L3C006R04400899468	chr1	266088	50M	152	266240	266089	266241	V350256906L3C006R04400899468_chr1_266088	67	69	ttat	cctg
V350256906L3C006R04401120985	chr1	726620	19S31M	124	726744	726621	726745	V350256906L3C006R04401120985_chr1_726620	0	69	ggaa	attc
V350256906L3C006R04401134170	chr1	610676	50M	169	610845	610677	610846	V350256906L3C006R04401134170_chr1_610676	0	0	CTTT	CTTC
V350256906L3C006R04401342856	chr1	1187167	50M	165	1187332	1187168	1187333	V350256906L3C006R04401342856_chr1_1187167	38	79	ggag	ctgc
V350256906L3C006R04500510530	chr1	109208	50M	145	109353	109209	109354	V350256906L3C006R04500510530_chr1_109208	22	167	TCCA	CTAT
V350256906L3C006R04501236746	chr1	1312537	50M	175	1312712	1312538	1312713	V350256906L3C006R04501236746_chr1_1312537	76	74	CCTT	taaa
V350256906L3C006R04600219450	chr1	415860	50M	165	416025	415861	416026	V350256906L3C006R04600219450_chr1_415860	48	0	TGTA	CAAT
V350256906L3C006R04600654062	chr1	780026	50M	166	780192	780027	780193	V350256906L3C006R04600654062_chr1_780026	53	58	CGCT	TAGA
V350256906L3C006R04601125635	chr1	31457	50M	157	31614	31458	31615	V350256906L3C006R04601125635_chr1_31457	35	64	cctg	ccca
V350256906L3C006R04601293327	chr1	338732	50M	162	338894	338733	338895	V350256906L3C006R04601293327_chr1_338732	86	39	ggcc	TATA
V350256906L3C006R04700285175	chr1	230417	50M	160	230577	230418	230578	V350256906L3C006R04700285175_chr1_230417	54	36	ctga	gcat
V350256906L3C006R04700380243	chr1	78159	50M	170	78329	78160	78330	V350256906L3C006R04700380243_chr1_78159	51	17	caaa	ccca
V350256906L3C006R04700726310	chr1	40600	50M	158	40758	40601	40759	V350256906L3C006R04700726310_chr1_40600	187	171	ccca	tatt
V350256906L3C006R04700728017	chr1	259296	50M	180	259476	259297	259477	V350256906L3C006R04700728017_chr1_259296	36	27	TATG	GGGC
V350256906L3C006R04800339317	chr1	16409	50M	175	16584	16410	16585	V350256906L3C006R04800339317_chr1_16409	164	89	CCCT	CCTG
V350256906L3C006R04800628342	chr1	1165212	50M	185	1165397	1165213	1165398	V350256906L3C006R04800628342_chr1_1165212	80	70	ACCC	CACG
V350256906L3C006R04900043642	chr1	1153038	50M	155	1153193	1153039	1153194	V350256906L3C006R04900043642_chr1_1153038	150	92	CGTT	CCTT
V350256906L3C006R04900400020	chr1	118540	50M	159	118699	118541	118700	V350256906L3C006R04900400020_chr1_118540	76	35	ccac	caca
V350256906L3C006R04900551781	chr1	694564	50M	169	694733	694565	694734	V350256906L3C006R04900551781_chr1_694564	236	205	ctat	ccta
V350256906L3C006R04900573445	chr1	1209544	50M	143	1209687	1209545	1209688	V350256906L3C006R04900573445_chr1_1209544	0	14	CCCG	CGGG
V350256906L3C006R04900655909	chr1	160811	50M	192	161003	160812	161004	V350256906L3C006R04900655909_chr1_160811	35	41	ACTG	GGTT
V350256906L3C006R04900790765	chr1	768970	50M	179	769149	768971	769150	V350256906L3C006R04900790765_chr1_768970	88	55	GGCA	CCTC
V350256906L3C006R04900844044	chr1	939198	50M	99	939297	939199	939298	V350256906L3C006R04900844044_chr1_939198	454	553	CACC	CAAG
V350256906L3C006R04900951188	chr1	89327	50M	171	89498	89328	89499	V350256906L3C006R04900951188_chr1_89327	50	77	gttt	TACC
V350256906L3C006R04901111993	chr1	389623	50M	186	389809	389624	389810	V350256906L3C006R04901111993_chr1_389623	70	72	cata	tgta
V350256906L3C006R04901142204	chr1	1351184	50M	166	1351350	1351185	1351351	V350256906L3C006R04901142204_chr1_1351184	116	61	tcga	tgcc
V350256906L3C006R05000125703	chr1	135642	50M	149	135791	135643	135792	V350256906L3C006R05000125703_chr1_135642	165	16	GCTG	GGCC
V350256906L3C006R05000232323	chr1	458087	50M	155	458242	458088	458243	V350256906L3C006R05000232323_chr1_458087	38	56	ccca	ccag
V350256906L3C006R05000331508	chr1	32641	50M	144	32785	32642	32786	V350256906L3C006R05000331508_chr1_32641	132	60	CCCA	TGGT
V350256906L3C006R05000676325	chr1	1054320	50M	217	1054537	1054321	1054538	V350256906L3C006R05000676325_chr1_1054320	21	0	GTTT	CAAG
V350256906L3C006R05000771930	chr1	1132428	50M	171	1132599	1132429	1132600	V350256906L3C006R05000771930_chr1_1132428	60	44	CCAG	TGGG
V350256906L3C006R05000896758	chr1	79139	50M	179	79318	79140	79319	V350256906L3C006R05000896758_chr1_79139	45	91	ccac	cagt
V350256906L3C006R05001065947	chr1	261956	50M	172	262128	261957	262129	V350256906L3C006R05001065947_chr1_261956	47	57	catg	gaaa
V350256906L3C006R05001171839	chr1	971518	50M	163	971681	971519	971682	V350256906L3C006R05001171839_chr1_971518	29	4	CTTC	CACA
V350256906L3C006R05100375792	chr1	636714	50M	172	636886	636715	636887	V350256906L3C006R05100375792_chr1_636714	30	6	tgcc	gaag
V350256906L3C006R05100542766	chr1	1030716	50M	158	1030874	1030717	1030875	V350256906L3C006R05100542766_chr1_1030716	29	20	gcat	gtta
V350256906L3C006R05100635267	chr1	730035	50M	187	730222	730036	730223	V350256906L3C006R05100635267_chr1_730035	4	16	tctc	TAAG
V350256906L3C006R05100840821	chr1	237157	50M	171	237328	237158	237329	V350256906L3C006R05100840821_chr1_237157	80	66	CACC	tgat
V350256906L3C006R05100884606	chr1	522317	50M	166	522483	522318	522484	V350256906L3C006R05100884606_chr1_522317	0	62	agtt	ccac
V350256906L3C006R05100890174	chr1	1405360	50M	172	1405532	1405361	1405533	V350256906L3C006R05100890174_chr1_1405360	54	36	cccc	acaa
V350256906L3C006R05100915853	chr1	1137561	50M	160	1137721	1137562	1137722	V350256906L3C006R05100915853_chr1_1137561	119	13	gtac	ctgg
V350256906L3C006R05101060251	chr1	833642	50M	175	833817	833643	833818	V350256906L3C006R05101060251_chr1_833642	0	0	acac	cctt
V350256906L3C006R05200539873	chr1	1052142	50M	176	1052318	1052143	1052319	V350256906L3C006R05200539873_chr1_1052142	0	109	GGGC	ACAT
V350256906L3C006R05201111652	chr1	890803	50M	172	890975	890804	890976	V350256906L3C006R05201111652_chr1_890803	61	76	CCGT	CCTG
V350256906L3C006R05201197273	chr1	443216	50M	180	443396	443217	443397	V350256906L3C006R05201197273_chr1_443216	63	49	cgcc	cgcc
V350256906L3C006R05201259102	chr1	1017895	50M	179	1018074	1017896	1018075	V350256906L3C006R05201259102_chr1_1017895	49	18	CACG	TCTC
V350256906L3C006R05201259525	chr1	90868	50M	127	90995	90869	90996	V350256906L3C006R05201259525_chr1_90868	32	60	CAGG	tcct
V350256906L3C006R05300388326	chr1	838586	50M	147	838733	838587	838734	V350256906L3C006R05300388326_chr1_838586	60	53	ccaa	CGAA
V350256906L3C006R05300509724	chr1	1346074	50M	166	1346240	1346075	1346241	V350256906L3C006R05300509724_chr1_1346074	16	34	tgtg	gcca
V350256906L3C006R05300521587	chr1	669280	50M	256	669536	669281	669537	V350256906L3C006R05300521587_chr1_669280	0	78	CTTC	gacc
V350256906L3C006R05300818139	chr1	798130	50M	204	798334	798131	798335	V350256906L3C006R05300818139_chr1_798130	0	0	CAAA	tctc
V350256906L3C006R05301045194	chr1	1292230	50M	169	1292399	1292231	1292400	V350256906L3C006R05301045194_chr1_1292230	121	35	GACC	TCTG
V350256906L3C006R05400061958	chr1	870528	50M	163	870691	870529	870692	V350256906L3C006R05400061958_chr1_870528	154	70	GGAA	ccca
V350256906L3C006R05400531415	chr1	725731	31S19M	227	725958	725732	725959	V350256906L3C006R05400531415_chr1_725731	152	33	ggaa	ccat
V350256906L3C006R05400880613	chr1	725792	40M10S	176	725968	725793	725969	V350256906L3C006R05400880613_chr1_725792	91	43	gaat	ccat
V350256906L3C006R05400971135	chr1	707707	50M	168	707875	707708	707876	V350256906L3C006R05400971135_chr1_707707	73	64	CAAG	CTCA
V350256906L3C006R05500354879	chr1	56488	50M	190	56678	56489	56679	V350256906L3C006R05500354879_chr1_56488	20	7	CTCA	AGGA
V350256906L3C006R05500481004	chr1	766461	50M	171	766632	766462	766633	V350256906L3C006R05500481004_chr1_766461	1	25	TGGA	caat
V350256906L3C006R05500607097	chr1	724927	6S44M	177	725104	724928	725105	V350256906L3C006R05500607097_chr1_724927	0	134	gaat	tcca
V350256906L3C006R05501119343	chr1	114178	50M	153	114331	114179	114332	V350256906L3C006R05501119343_chr1_114178	59	61	CAAC	cagg
V350256906L3C006R05501319704	chr1	15718	50M	149	15867	15719	15868	V350256906L3C006R05501319704_chr1_15718	295	355	CCCG	CGGC
V350256906L3C006R05501396289	chr1	835299	50M	172	835471	835300	835472	V350256906L3C006R05501396289_chr1_835299	0	7	TGGG	GCCT
V350256906L3C006R05600703225	chr1	629108	50M	182	629290	629109	629291	V350256906L3C006R05600703225_chr1_629108	26	0	CGCG	GGCA
V350256906L3C006R05600739302	chr1	1057506	50M	173	1057679	1057507	1057680	V350256906L3C006R05600739302_chr1_1057506	0	88	CCCC	CGGC
V350256906L3C006R05600826132	chr1	861808	50M	129	861937	861809	861938	V350256906L3C006R05600826132_chr1_861808	52	0	ATTT	CAAA
V350256906L3C006R05600827676	chr1	1030784	50M	172	1030956	1030785	1030957	V350256906L3C006R05600827676_chr1_1030784	23	28	aaga	aaga
V350256906L3C006R05601042613	chr1	641372	50M	172	641544	641373	641545	V350256906L3C006R05601042613_chr1_641372	68	6	CCCA	cagg
V350256906L3C006R05601303983	chr1	175109	50M	205	175314	175110	175315	V350256906L3C006R05601303983_chr1_175109	132	185	GCAA	ccat
V350256906L3C006R05601392491	chr1	1165488	50M	186	1165674	1165489	1165675	V350256906L3C006R05601392491_chr1_1165488	0	16	cctt	gcat
V350256906L3C006R05700162798	chr1	233098	50M	216	233314	233099	233315	V350256906L3C006R05700162798_chr1_233098	115	4	AGAA	ACAG
V350256906L3C006R05700169833	chr1	1018258	50M	118	1018376	1018259	1018377	V350256906L3C006R05700169833_chr1_1018258	112	0	GTCT	CGTT
V350256906L3C006R05700511103	chr1	14795	50M	198	14993	14796	14994	V350256906L3C006R05700511103_chr1_14795	202	181	CCCC	CAAG
V350256906L3C006R05700610889	chr1	455419	50M	152	455571	455420	455572	V350256906L3C006R05700610889_chr1_455419	55	36	CGTC	GAAC
V350256906L3C006R05700662100	chr1	136595	50M	129	136724	136596	136725	V350256906L3C006R05700662100_chr1_136595	113	242	AGGG	CCCA
V350256906L3C006R05700727003	chr1	1064096	50M	188	1064284	1064097	1064285	V350256906L3C006R05700727003_chr1_1064096	0	0	CCTG	CCAG
V350256906L3C006R05700767728	chr1	402351	50M	160	402511	402352	402512	V350256906L3C006R05700767728_chr1_402351	113	62	tgct	caga
V350256906L3C006R05700943591	chr1	828147	50M	190	828337	828148	828338	V350256906L3C006R05700943591_chr1_828147	59	65	cctg	atga
V350256906L3C006R05700952329	chr1	705232	50M	172	705404	705233	705405	V350256906L3C006R05700952329_chr1_705232	193	28	ccag	caaa
V350256906L3C006R05701095932	chr1	1416403	4S46M	174	1416577	1416404	1416578	V350256906L3C006R05701095932_chr1_1416403	0	0	CCGG	cgtc
V350256906L3C006R05701183642	chr1	992603	50M	154	992757	992604	992758	V350256906L3C006R05701183642_chr1_992603	50	46	cttg	CCCT
V350256906L3C006R05701238966	chr1	922067	50M	228	922295	922068	922296	V350256906L3C006R05701238966_chr1_922067	35	123	attt	ccag
V350256906L3C006R05800237191	chr1	1154352	50M	174	1154526	1154353	1154527	V350256906L3C006R05800237191_chr1_1154352	81	38	GCAC	ATCA
V350256906L3C006R05800571536	chr1	13996	50M	177	14173	13997	14174	V350256906L3C006R05800571536_chr1_13996	74	15	CCCT	CTAA
V350256906L3C006R05800616839	chr1	559233	50M	171	559404	559234	559405	V350256906L3C006R05800616839_chr1_559233	73	51	TCGA	TGTG
V350256906L3C006R05800627194	chr1	256591	50M	125	256716	256592	256717	V350256906L3C006R05800627194_chr1_256591	80	205	atca	ctct
V350256906L3C006R05800657192	chr1	652329	50M	149	652478	652330	652479	V350256906L3C006R05800657192_chr1_652329	43	45	ataa	caaa
V350256906L3C006R05800789147	chr1	829529	50M	222	829751	829530	829752	V350256906L3C006R05800789147_chr1_829529	48	17	gaat	tgcc
V350256906L3C006R05800889766	chr1	1179108	50M	151	1179259	1179109	1179260	V350256906L3C006R05800889766_chr1_1179108	49	28	TCCC	GACA
V350256906L3C006R05900051642	chr1	1082067	50M	184	1082251	1082068	1082252	V350256906L3C006R05900051642_chr1_1082067	0	0	GGCA	CCCA
V350256906L3C006R05900745339	chr1	232153	50M	198	232351	232154	232352	V350256906L3C006R05900745339_chr1_232153	32	0	gaag	ctta
V350256906L3C006R05900758780	chr1	726840	15S27M8S	214	727054	726841	727055	V350256906L3C006R05900758780_chr1_726840	0	19	gaat	ATTC
V350256906L3C006R05901093547	chr1	925176	50M	175	925351	925177	925352	V350256906L3C006R05901093547_chr1_925176	57	0	ccca	acat
V350256906L3C006R06000783899	chr1	82185	50M	190	82375	82186	82376	V350256906L3C006R06000783899_chr1_82185	0	162	taga	ctgc
V350256906L3C006R06000932888	chr1	1095783	50M	144	1095927	1095784	1095928	V350256906L3C006R06000932888_chr1_1095783	31	0	AGGG	CAGG
V350256906L3C006R06001268035	chr1	1423451	50M	194	1423645	1423452	1423646	V350256906L3C006R06001268035_chr1_1423451	53	42	cagc	taaC
V350256906L3C006R06100152387	chr1	916199	50M	175	916374	916200	916375	V350256906L3C006R06100152387_chr1_916199	50	76	GGCT	CAGG
V350256906L3C006R06100427434	chr1	806921	50M	149	807070	806922	807071	V350256906L3C006R06100427434_chr1_806921	47	29	tgat	catc
V350256906L3C006R06100428710	chr1	765582	50M	177	765759	765583	765760	V350256906L3C006R06100428710_chr1_765582	0	0	ggaa	aaaa
V350256906L3C006R06100789266	chr1	1017943	50M	192	1018135	1017944	1018136	V350256906L3C006R06100789266_chr1_1017943	1	0	ATAG	CCTC
V350256906L3C006R06100795284	chr1	702518	50M	166	702684	702519	702685	V350256906L3C006R06100795284_chr1_702518	6	29	ATTC	GTAT
V350256906L3C006R06101181751	chr1	1281399	50M	183	1281582	1281400	1281583	V350256906L3C006R06101181751_chr1_1281399	28	16	TGGC	TGGG
V350256906L3C006R06200323785	chr1	1427069	50M	168	1427237	1427070	1427238	V350256906L3C006R06200323785_chr1_1427069	18	63	ATGA	CGGC
V350256906L3C006R06200365178	chr1	55506	50M	194	55700	55507	55701	V350256906L3C006R06200365178_chr1_55506	45	55	ccag	CAAT
V350256906L3C006R06200908277	chr1	1094706	50M	145	1094851	1094707	1094852	V350256906L3C006R06200908277_chr1_1094706	20	165	aaaa	TAAT
V350256906L3C006R06200938909	chr1	1268071	50M	164	1268235	1268072	1268236	V350256906L3C006R06200938909_chr1_1268071	25	0	ACCA	GGCC
V350256906L3C006R06300228627	chr1	814688	50M	179	814867	814689	814868	V350256906L3C006R06300228627_chr1_814688	29	5	cctc	agtc
V350256906L3C006R06300538788	chr1	996691	50M	176	996867	996692	996868	V350256906L3C006R06300538788_chr1_996691	69	65	CCAT	CCCA
V350256906L3C006R06301172586	chr1	738844	50M	181	739025	738845	739026	V350256906L3C006R06301172586_chr1_738844	8	68	TCAC	TGCA
V350256906L3C006R06301236482	chr1	552519	50M	178	552697	552520	552698	V350256906L3C006R06301236482_chr1_552519	76	64	tgtg	CTTT
V350256906L3C006R06400361795	chr1	794448	50M	156	794604	794449	794605	V350256906L3C006R06400361795_chr1_794448	71	28	GAAG	TCTA
V350256906L3C006R06400797622	chr1	1081727	50M	180	1081907	1081728	1081908	V350256906L3C006R06400797622_chr1_1081727	0	0	CCTC	CCAA
V350256906L3C006R06401114733	chr1	1151266	50M	188	1151454	1151267	1151455	V350256906L3C006R06401114733_chr1_1151266	13	11	CAGG	CCCT
V350256906L3C006R06401298546	chr1	335091	50M	176	335267	335092	335268	V350256906L3C006R06401298546_chr1_335091	0	0	CTCA	CCCA
V350256906L3C006R06401378952	chr1	743260	50M	134	743394	743261	743395	V350256906L3C006R06401378952_chr1_743260	52	39	AGAA	TGAA
V350256906L3C006R06500288748	chr1	63748	50M	149	63897	63749	63898	V350256906L3C006R06500288748_chr1_63748	53	0	TGGA	CCAA
V350256906L3C006R06500427521	chr1	1355086	50M	143	1355229	1355087	1355230	V350256906L3C006R06500427521_chr1_1355086	0	0	CTGC	TGCT
V350256906L3C006R06501216677	chr1	396693	50M	173	396866	396694	396867	V350256906L3C006R06501216677_chr1_396693	0	3	GAAA	GATA
V350256906L3C006R06600388643	chr1	541223	50M	151	541374	541224	541375	V350256906L3C006R06600388643_chr1_541223	20	6	CCTG	GAGT
V350256906L3C006R06600985708	chr1	348798	50M	152	348950	348799	348951	V350256906L3C006R06600985708_chr1_348798	56	57	CCTT	caca
V350256906L3C006R06700047288	chr1	725632	50M	166	725798	725633	725799	V350256906L3C006R06700047288_chr1_725632	116	85	aact	ccat
V350256906L3C006R06700417481	chr1	522138	50M	150	522288	522139	522289	V350256906L3C006R06700417481_chr1_522138	0	22	tgtt	ccta
V350256906L3C006R06700470782	chr1	1189872	50M	180	1190052	1189873	1190053	V350256906L3C006R06700470782_chr1_1189872	35	49	GGAG	GTCT
V350256906L3C006R06700775160	chr1	132471	50M	180	132651	132472	132652	V350256906L3C006R06700775160_chr1_132471	10	190	CTCT	TCCG
V350256906L3C006R06700854536	chr1	335874	50M	163	336037	335875	336038	V350256906L3C006R06700854536_chr1_335874	144	0	TAAT	GAGT
V350256906L3C006R06700931563	chr1	733993	50M	164	734157	733994	734158	V350256906L3C006R06700931563_chr1_733993	55	43	AACA	ccca
V350256906L3C006R06700973058	chr1	75547	50M	182	75729	75548	75730	V350256906L3C006R06700973058_chr1_75547	121	202	caat	ccct
V350256906L3C006R06701264670	chr1	1089132	50M	168	1089300	1089133	1089301	V350256906L3C006R06701264670_chr1_1089132	253	85	ccat	CTGG
V350256906L3C006R06701302822	chr1	1020817	50M	221	1021038	1020818	1021039	V350256906L3C006R06701302822_chr1_1020817	2	0	CGGC	CCTT
V350256906L3C006R06800036420	chr1	1074298	50M	178	1074476	1074299	1074477	V350256906L3C006R06800036420_chr1_1074298	66	85	GGGA	CCCA
V350256906L3C006R06800075838	chr1	971949	50M	159	972108	971950	972109	V350256906L3C006R06800075838_chr1_971949	53	63	TGGC	GGTG
V350256906L3C006R06800204405	chr1	787602	50M	190	787792	787603	787793	V350256906L3C006R06800204405_chr1_787602	66	49	GAAC	CCAA
V350256906L3C006R06800600575	chr1	707472	50M	161	707633	707473	707634	V350256906L3C006R06800600575_chr1_707472	28	1	CTTG	CCCA
V350256906L3C006R06800952965	chr1	1390513	50M	168	1390681	1390514	1390682	V350256906L3C006R06800952965_chr1_1390513	36	0	cttg	CTGT
V350256906L3C006R06801353164	chr1	724459	50M	191	724650	724460	724651	V350256906L3C006R06801353164_chr1_724459	152	66	cttg	ttcc
V350256906L3C006R06900309717	chr1	1234644	50M	158	1234802	1234645	1234803	V350256906L3C006R06900309717_chr1_1234644	46	72	CCTT	CCAG
V350256906L3C006R06900434649	chr1	1421132	50M	183	1421315	1421133	1421316	V350256906L3C006R06900434649_chr1_1421132	60	58	CCAA	CCTG
V350256906L3C006R06900704942	chr1	32721	50M	149	32870	32722	32871	V350256906L3C006R06900704942_chr1_32721	124	9	AGGA	ccct
V350256906L3C006R06900792292	chr1	99644	50M	154	99798	99645	99799	V350256906L3C006R06900792292_chr1_99644	8	0	CCCA	Tgat
V350256906L3C006R06901063998	chr1	877845	50M	159	878004	877846	878005	V350256906L3C006R06901063998_chr1_877845	13	3	CCTG	CCAG
V350256906L3C006R06901088685	chr1	584548	50M	168	584716	584549	584717	V350256906L3C006R06901088685_chr1_584548	50	85	caaa	ggct
V350256906L3C006R06901280695	chr1	388675	50M	193	388868	388676	388869	V350256906L3C006R06901280695_chr1_388675	74	38	gagg	gaaa
V350256906L3C006R07000229033	chr1	437395	50M	180	437575	437396	437576	V350256906L3C006R07000229033_chr1_437395	6	33	CCAG	CTGA
V350256906L3C006R07000466352	chr1	1216805	50M	163	1216968	1216806	1216969	V350256906L3C006R07000466352_chr1_1216805	72	62	GGTG	CCAG
V350256906L3C006R07001011472	chr1	727765	50M	165	727930	727766	727931	V350256906L3C006R07001011472_chr1_727765	77	64	ccca	acac
V350256906L3C006R07100380437	chr1	237183	50M	247	237430	237184	237431	V350256906L3C006R07100380437_chr1_237183	54	0	CACC	cctc
V350256906L3C006R07101216869	chr1	989377	50M	176	989553	989378	989554	V350256906L3C006R07101216869_chr1_989377	44	54	TGCC	CTTT
V350256906L3C006R07201032156	chr1	1038500	50M	190	1038690	1038501	1038691	V350256906L3C006R07201032156_chr1_1038500	222	87	ggcg	ccta
V350256906L4C001R00100306393	chr1	171195	50M	178	171373	171196	171374	V350256906L4C001R00100306393_chr1_171195	187	9	cctc	CCTC
V350256906L4C001R00100467048	chr1	769408	50M	188	769596	769409	769597	V350256906L4C001R00100467048_chr1_769408	122	310	AGAG	CCAC
V350256906L4C001R00100971479	chr1	46023	50M	172	46195	46024	46196	V350256906L4C001R00100971479_chr1_46023	7	0	ATCA	caag
V350256906L4C001R00100992685	chr1	925103	50M	166	925269	925104	925270	V350256906L4C001R00100992685_chr1_925103	0	56	ccac	caaa
V350256906L4C001R00101091511	chr1	883144	50M	190	883334	883145	883335	V350256906L4C001R00101091511_chr1_883144	9	29	CACC	CATT
V350256906L4C001R00101194309	chr1	589465	50M	191	589656	589466	589657	V350256906L4C001R00101194309_chr1_589465	53	103	aaag	tgct
V350256906L4C001R00101200204	chr1	35301	50M	165	35466	35302	35467	V350256906L4C001R00101200204_chr1_35301	34	70	ccat	tgtt
V350256906L4C001R00200155099	chr1	1306883	50M	175	1307058	1306884	1307059	V350256906L4C001R00200155099_chr1_1306883	64	64	GGCA	aggg
V350256906L4C001R00200753070	chr1	931570	50M	186	931756	931571	931757	V350256906L4C001R00200753070_chr1_931570	0	68	CCAG	CCTG
V350256906L4C001R00200787037	chr1	1367611	50M	206	1367817	1367612	1367818	V350256906L4C001R00200787037_chr1_1367611	35	23	CCCA	GCAG
V350256906L4C001R00201267328	chr1	757801	50M	176	757977	757802	757978	V350256906L4C001R00201267328_chr1_757801	62	0	CTAC	GTGT
V350256906L4C001R00300266777	chr1	726209	26M24S	154	726363	726210	726364	V350256906L4C001R00300266777_chr1_726209	40	48	aatg	attc
V350256906L4C001R00300416454	chr1	1162352	50M	158	1162510	1162353	1162511	V350256906L4C001R00300416454_chr1_1162352	129	184	CCAC	CCTG
V350256906L4C001R00300519188	chr1	756525	50M	170	756695	756526	756696	V350256906L4C001R00300519188_chr1_756525	94	161	AGCT	GGCA
V350256906L4C001R00300534496	chr1	100395	50M	172	100567	100396	100568	V350256906L4C001R00300534496_chr1_100395	69	49	aggt	CCCA
V350256906L4C001R00300603385	chr1	731936	50M	181	732117	731937	732118	V350256906L4C001R00300603385_chr1_731936	0	0	acaa	ttag
V350256906L4C001R00300666484	chr1	425193	50M	167	425360	425194	425361	V350256906L4C001R00300666484_chr1_425193	54	58	CAAA	CCAA
V350256906L4C001R00300929135	chr1	592195	50M	188	592383	592196	592384	V350256906L4C001R00300929135_chr1_592195	21	76	gaag	ccag
V350256906L4C001R00301319776	chr1	838244	50M	161	838405	838245	838406	V350256906L4C001R00301319776_chr1_838244	47	66	AGAC	caaa
V350256906L4C001R00301323724	chr1	1354230	50M	168	1354398	1354231	1354399	V350256906L4C001R00301323724_chr1_1354230	0	13	tcaT	GGGA
V350256906L4C001R00400088896	chr1	1366497	50M	172	1366669	1366498	1366670	V350256906L4C001R00400088896_chr1_1366497	170	0	CCCA	CCAC
V350256906L4C001R00400137534	chr1	873476	50M	173	873649	873477	873650	V350256906L4C001R00400137534_chr1_873476	250	159	CCCC	CCAA
V350256906L4C001R00400377558	chr1	37864	50M	142	38006	37865	38007	V350256906L4C001R00400377558_chr1_37864	257	115	CTGT	CTGA
V350256906L4C001R00400539903	chr1	1217437	50M	164	1217601	1217438	1217602	V350256906L4C001R00400539903_chr1_1217437	38	77	CCAG	cact
V350256906L4C001R00400597200	chr1	1052145	50M	180	1052325	1052146	1052326	V350256906L4C001R00400597200_chr1_1052145	0	102	CTCT	CCTT
V350256906L4C001R00400665798	chr1	462754	50M	205	462959	462755	462960	V350256906L4C001R00400665798_chr1_462754	0	11	AACA	ggaa
V350256906L4C001R00400713944	chr1	699558	50M	186	699744	699559	699745	V350256906L4C001R00400713944_chr1_699558	64	68	CTAG	cccg
V350256906L4C001R00400809018	chr1	814258	50M	183	814441	814259	814442	V350256906L4C001R00400809018_chr1_814258	0	0	CTCA	TTAT
V350256906L4C001R00401065507	chr1	111940	50M	171	112111	111941	112112	V350256906L4C001R00401065507_chr1_111940	54	46	TGTT	ctaa
V350256906L4C001R00401219057	chr1	138482	50M	200	138682	138483	138683	V350256906L4C001R00401219057_chr1_138482	0	0	CAAG	CTGC
V350256906L4C001R00500242135	chr1	1251329	50M	190	1251519	1251330	1251520	V350256906L4C001R00500242135_chr1_1251329	46	236	CAAC	ggct
V350256906L4C001R00500476246	chr1	1094252	50M	174	1094426	1094253	1094427	V350256906L4C001R00500476246_chr1_1094252	66	55	CCCC	ccCC
V350256906L4C001R00500753019	chr1	360880	50M	187	361067	360881	361068	V350256906L4C001R00500753019_chr1_360880	19	16	CCAT	caaa
V350256906L4C001R00501332295	chr1	380208	50M	153	380361	380209	380362	V350256906L4C001R00501332295_chr1_380208	0	129	ccag	taga
V350256906L4C001R00600343880	chr1	322299	50M	153	322452	322300	322453	V350256906L4C001R00600343880_chr1_322299	11	54	cGAC	ccca
V350256906L4C001R00600418282	chr1	1002259	50M	190	1002449	1002260	1002450	V350256906L4C001R00600418282_chr1_1002259	30	20	CCCT	GAGG
V350256906L4C001R00600552659	chr1	747647	50M	138	747785	747648	747786	V350256906L4C001R00600552659_chr1_747647	249	138	caat	ctat
V350256906L4C001R00600552660	chr1	747647	50M	138	747785	747648	747786	V350256906L4C001R00600552660_chr1_747647	249	138	caat	ctat
V350256906L4C001R00600838918	chr1	1141364	50M	174	1141538	1141365	1141539	V350256906L4C001R00600838918_chr1_1141364	60	53	CATC	GGTG
V350256906L4C001R00601279707	chr1	714810	50M	155	714965	714811	714966	V350256906L4C001R00601279707_chr1_714810	149	9	gcat	cagt
V350256906L4C001R00601311068	chr1	175253	50M	172	175425	175254	175426	V350256906L4C001R00601311068_chr1_175253	246	74	gcct	catg
V350256906L4C001R00700410425	chr1	765190	50M	194	765384	765191	765385	V350256906L4C001R00700410425_chr1_765190	119	168	tgga	catc
V350256906L4C001R00700603593	chr1	1349699	50M	161	1349860	1349700	1349861	V350256906L4C001R00700603593_chr1_1349699	36	74	actt	ggtg
V350256906L4C001R00700978316	chr1	58742	50M	139	58881	58743	58882	V350256906L4C001R00700978316_chr1_58742	178	39	CCTA	GTTA
V350256906L4C001R00800261290	chr1	1145518	50M	254	1145772	1145519	1145773	V350256906L4C001R00800261290_chr1_1145518	103	37	GACG	CGGC
V350256906L4C001R00800529228	chr1	83392	50M	201	83593	83393	83594	V350256906L4C001R00800529228_chr1_83392	158	101	acat	ccta
V350256906L4C001R00800576151	chr1	1050471	50M	181	1050652	1050472	1050653	V350256906L4C001R00800576151_chr1_1050471	37	112	ACCA	CCGG
V350256906L4C001R00800633334	chr1	239438	50M	173	239611	239439	239612	V350256906L4C001R00800633334_chr1_239438	87	66	TTAG	ataa
V350256906L4C001R00800720222	chr1	249744	50M	142	249886	249745	249887	V350256906L4C001R00800720222_chr1_249744	0	15	aaag	ccac
V350256906L4C001R00800795575	chr1	740650	50M	167	740817	740651	740818	V350256906L4C001R00800795575_chr1_740650	17	184	AGAT	TGCT
V350256906L4C001R00801287611	chr1	1212858	50M	144	1213002	1212859	1213003	V350256906L4C001R00801287611_chr1_1212858	31	0	caat	cctg
V350256906L4C001R00801289777	chr1	350876	50M	134	351010	350877	351011	V350256906L4C001R00801289777_chr1_350876	24	48	aaac	aggt
V350256906L4C001R00801328325	chr1	30183	50M	181	30364	30184	30365	V350256906L4C001R00801328325_chr1_30183	7	0	ccac	tctt
V350256906L4C001R00900065243	chr1	673155	50M	164	673319	673156	673320	V350256906L4C001R00900065243_chr1_673155	0	55	GACA	ataa
V350256906L4C001R00900271219	chr1	350184	50M	202	350386	350185	350387	V350256906L4C001R00900271219_chr1_350184	14	0	AAGA	AAAT
V350256906L4C001R00900280708	chr1	1284622	50M	132	1284754	1284623	1284755	V350256906L4C001R00900280708_chr1_1284622	0	43	cccg	CGGC
V350256906L4C001R00900314009	chr1	251493	50M	153	251646	251494	251647	V350256906L4C001R00900314009_chr1_251493	44	20	GCTC	CGTT
V350256906L4C001R00900347934	chr1	681587	50M	214	681801	681588	681802	V350256906L4C001R00900347934_chr1_681587	52	69	TGGC	acat
V350256906L4C001R00900482031	chr1	1221083	50M	168	1221251	1221084	1221252	V350256906L4C001R00900482031_chr1_1221083	46	56	CCAG	CCCT
V350256906L4C001R00900515020	chr1	721647	50M	211	721858	721648	721859	V350256906L4C001R00900515020_chr1_721647	47	28	caat	ccag
V350256906L4C001R00901046924	chr1	249151	50M	226	249377	249152	249378	V350256906L4C001R00901046924_chr1_249151	0	0	tgtt	ggtc
V350256906L4C001R01000028522	chr1	423548	50M	167	423715	423549	423716	V350256906L4C001R01000028522_chr1_423548	59	226	cagt	agtt
V350256906L4C001R01000233444	chr1	404376	50M	167	404543	404377	404544	V350256906L4C001R01000233444_chr1_404376	17	184	ccac	CTAA
V350256906L4C001R01000246226	chr1	242563	50M	173	242736	242564	242737	V350256906L4C001R01000246226_chr1_242563	0	25	CCAA	CCAG
V350256906L4C001R01000362086	chr1	265127	50M	168	265295	265128	265296	V350256906L4C001R01000362086_chr1_265127	49	38	tata	tagt
V350256906L4C001R01000729517	chr1	1018766	50M	169	1018935	1018767	1018936	V350256906L4C001R01000729517_chr1_1018766	166	68	AGGT	GCCT
V350256906L4C001R01100510942	chr1	882878	50M	124	883002	882879	883003	V350256906L4C001R01100510942_chr1_882878	29	61	CAGG	CCTT
V350256906L4C001R01101355642	chr1	835477	50M	156	835633	835478	835634	V350256906L4C001R01101355642_chr1_835477	1	111	CCTC	gata
V350256906L4C001R01101393946	chr1	849897	50M	190	850087	849898	850088	V350256906L4C001R01101393946_chr1_849897	0	3	gtgg	ccca
V350256906L4C001R01200310520	chr1	434341	50M	177	434518	434342	434519	V350256906L4C001R01200310520_chr1_434341	62	0	ccag	TAAA
V350256906L4C001R01200514033	chr1	1282762	50M	140	1282902	1282763	1282903	V350256906L4C001R01200514033_chr1_1282762	42	12	CAGG	CCAG
V350256906L4C001R01200609527	chr1	1395896	37M	153	1396049	1395897	1396050	V350256906L4C001R01200609527_chr1_1395896	1	41	CACG	CAGG
V350256906L4C001R01200739012	chr1	813478	50M	199	813677	813479	813678	V350256906L4C001R01200739012_chr1_813478	481	328	CTTT	CTGC
V350256906L4C001R01200819505	chr1	1133206	50M	181	1133387	1133207	1133388	V350256906L4C001R01200819505_chr1_1133206	72	57	GCCT	GGTG
V350256906L4C001R01201257710	chr1	1007926	50M	195	1008121	1007927	1008122	V350256906L4C001R01201257710_chr1_1007926	68	76	CACC	CGTG
V350256906L4C001R01201335194	chr1	345007	50M	152	345159	345008	345160	V350256906L4C001R01201335194_chr1_345007	44	64	tgat	ccag
V350256906L4C001R01300037769	chr1	30969	50M	174	31143	30970	31144	V350256906L4C001R01300037769_chr1_30969	0	0	cacc	GTAT
V350256906L4C001R01300082599	chr1	101994	50M	167	102161	101995	102162	V350256906L4C001R01300082599_chr1_101994	13	5	cttg	agtt
V350256906L4C001R01300553962	chr1	256502	50M	167	256669	256503	256670	V350256906L4C001R01300553962_chr1_256502	0	158	taca	cacc
V350256906L4C001R01300584356	chr1	858752	50M	174	858926	858753	858927	V350256906L4C001R01300584356_chr1_858752	272	114	tgtg	AGTG
V350256906L4C001R01300877961	chr1	55496	50M	163	55659	55497	55660	V350256906L4C001R01300877961_chr1_55496	55	68	ccct	CCCT
V350256906L4C001R01400112819	chr1	851904	50M	168	852072	851905	852073	V350256906L4C001R01400112819_chr1_851904	43	58	TCCA	GGGC
V350256906L4C001R01400294409	chr1	1179483	50M	181	1179664	1179484	1179665	V350256906L4C001R01400294409_chr1_1179483	0	3	CCTC	CCCC
V350256906L4C001R01400542472	chr1	880034	50M	171	880205	880035	880206	V350256906L4C001R01400542472_chr1_880034	0	10	CCAG	TGTA
V350256906L4C001R01400748346	chr1	1318772	50M	258	1319030	1318773	1319031	V350256906L4C001R01400748346_chr1_1318772	9	53	gagg	CCTT
V350256906L4C001R01401337994	chr1	14716	50M	200	14916	14717	14917	V350256906L4C001R01401337994_chr1_14716	123	258	CGTC	CCTT
V350256906L4C001R01500020806	chr1	1181812	50M	168	1181980	1181813	1181981	V350256906L4C001R01500020806_chr1_1181812	8	37	CAGA	GGAC
V350256906L4C001R01500095288	chr1	174053	50M	133	174186	174054	174187	V350256906L4C001R01500095288_chr1_174053	63	27	AGTG	GCCT
V350256906L4C001R01500236534	chr1	422078	50M	138	422216	422079	422217	V350256906L4C001R01500236534_chr1_422078	17	155	cctt	caAC
V350256906L4C001R01500243623	chr1	1370309	50M	174	1370483	1370310	1370484	V350256906L4C001R01500243623_chr1_1370309	62	51	CTCC	AGAG
V350256906L4C001R01500335491	chr1	708114	50M	188	708302	708115	708303	V350256906L4C001R01500335491_chr1_708114	56	36	CCCT	TGGG
V350256906L4C001R01500339900	chr1	703709	50M	134	703843	703710	703844	V350256906L4C001R01500339900_chr1_703709	69	37	ACTA	GACA
V350256906L4C001R01500401628	chr1	718878	50M	166	719044	718879	719045	V350256906L4C001R01500401628_chr1_718878	45	93	TGTG	aggg
V350256906L4C001R01500462819	chr1	1391611	50M	158	1391769	1391612	1391770	V350256906L4C001R01500462819_chr1_1391611	98	34	GCCC	GCAG
V350256906L4C001R01500470034	chr1	773376	50M	177	773553	773377	773554	V350256906L4C001R01500470034_chr1_773376	69	84	caca	cacc
V350256906L4C001R01500999212	chr1	1386286	50M	228	1386514	1386287	1386515	V350256906L4C001R01500999212_chr1_1386286	67	34	CAGA	ggga
V350256906L4C001R01501070985	chr1	676092	50M	172	676264	676093	676265	V350256906L4C001R01501070985_chr1_676092	63	52	CTCC	ccag
V350256906L4C001R01501108450	chr1	1121208	50M	184	1121392	1121209	1121393	V350256906L4C001R01501108450_chr1_1121208	24	29	gcga	ggtc
V350256906L4C001R01501240901	chr1	569109	50M	161	569270	569110	569271	V350256906L4C001R01501240901_chr1_569109	30	74	CCCA	CCCT
V350256906L4C001R01501284529	chr1	1261270	50M	169	1261439	1261271	1261440	V350256906L4C001R01501284529_chr1_1261270	45	40	ACCG	CTCC
V350256906L4C001R01600040720	chr1	825343	50M	171	825514	825344	825515	V350256906L4C001R01600040720_chr1_825343	60	66	ccct	gaat
V350256906L4C001R01600216317	chr1	570812	50M	170	570982	570813	570983	V350256906L4C001R01600216317_chr1_570812	37	47	tagc	cgat
V350256906L4C001R01601008189	chr1	1399396	50M	124	1399520	1399397	1399521	V350256906L4C001R01601008189_chr1_1399396	53	24	ccaa	cacc
V350256906L4C001R01601033260	chr1	167675	50M	158	167833	167676	167834	V350256906L4C001R01601033260_chr1_167675	63	55	tgag	TATT
V350256906L4C001R01700019669	chr1	1088731	50M	217	1088948	1088732	1088949	V350256906L4C001R01700019669_chr1_1088731	67	97	CCAC	ggag
V350256906L4C001R01700125870	chr1	729474	50M	168	729642	729475	729643	V350256906L4C001R01700125870_chr1_729474	41	209	caga	CCCT
V350256906L4C001R01700127384	chr1	1396707	50M	170	1396877	1396708	1396878	V350256906L4C001R01700127384_chr1_1396707	18	76	atag	CGTA
V350256906L4C001R01700134191	chr1	614014	50M	172	614186	614015	614187	V350256906L4C001R01700134191_chr1_614014	63	40	cata	gtct
V350256906L4C001R01700140634	chr1	374490	50M	177	374667	374491	374668	V350256906L4C001R01700140634_chr1_374490	14	191	ggaa	tccc
V350256906L4C001R01700383159	chr1	1388936	50M	170	1389106	1388937	1389107	V350256906L4C001R01700383159_chr1_1388936	71	40	cgaa	ggag
V350256906L4C001R01700505790	chr1	920263	50M	179	920442	920264	920443	V350256906L4C001R01700505790_chr1_920263	55	51	tcta	ctaa
V350256906L4C001R01700566072	chr1	1430639	50M	171	1430810	1430640	1430811	V350256906L4C001R01700566072_chr1_1430639	48	63	GAGC	TGCA
V350256906L4C001R01700844808	chr1	1386213	50M	164	1386377	1386214	1386378	V350256906L4C001R01700844808_chr1_1386213	134	0	CCGG	CCTC
V350256906L4C001R01700856231	chr1	53356	50M	166	53522	53357	53523	V350256906L4C001R01700856231_chr1_53356	90	256	GGAT	TAAA
V350256906L4C001R01701098047	chr1	931598	50M	188	931786	931599	931787	V350256906L4C001R01701098047_chr1_931598	0	98	CCTG	GGGG
V350256906L4C001R01701175389	chr1	1382622	50M	159	1382781	1382623	1382782	V350256906L4C001R01701175389_chr1_1382622	23	54	tggg	ctga
V350256906L4C001R01701278131	chr1	779601	50M	177	779778	779602	779779	V350256906L4C001R01701278131_chr1_779601	40	48	agga	CCAG
V350256906L4C001R01701328142	chr1	612118	50M	184	612302	612119	612303	V350256906L4C001R01701328142_chr1_612118	207	80	ccct	ccca
V350256906L4C001R01800100180	chr1	1131413	50M	187	1131600	1131414	1131601	V350256906L4C001R01800100180_chr1_1131413	114	1	ccca	cctc
V350256906L4C001R01800363789	chr1	1146615	50M	157	1146772	1146616	1146773	V350256906L4C001R01800363789_chr1_1146615	40	53	GAGG	CATG
V350256906L4C001R01800714684	chr1	1361592	50M	164	1361756	1361593	1361757	V350256906L4C001R01800714684_chr1_1361592	9	10	CCCG	CACA
V350256906L4C001R01800769143	chr1	761403	50M	165	761568	761404	761569	V350256906L4C001R01800769143_chr1_761403	57	82	CCCT	TATG
V350256906L4C001R01800769455	chr1	549824	50M	207	550031	549825	550032	V350256906L4C001R01800769455_chr1_549824	9	48	TGAG	CCAG
V350256906L4C001R01900016136	chr1	423543	50M	168	423711	423544	423712	V350256906L4C001R01900016136_chr1_423543	54	222	ggtt	aaaa
V350256906L4C001R01900050183	chr1	1425972	50M	177	1426149	1425973	1426150	V350256906L4C001R01900050183_chr1_1425972	0	2	GGAG	CCCA
V350256906L4C001R01900212972	chr1	645715	50M	182	645897	645716	645898	V350256906L4C001R01900212972_chr1_645715	0	113	ATAA	CATT
V350256906L4C001R01900299514	chr1	368590	50M	169	368759	368591	368760	V350256906L4C001R01900299514_chr1_368590	52	37	TCTC	ACAA
V350256906L4C001R01900708126	chr1	898089	50M	207	898296	898090	898297	V350256906L4C001R01900708126_chr1_898089	0	6	GAAG	ACAG
V350256906L4C001R02000087123	chr1	719351	50M	155	719506	719352	719507	V350256906L4C001R02000087123_chr1_719351	102	0	TGTC	cttt
V350256906L4C001R02000559100	chr1	17422	50M	154	17576	17423	17577	V350256906L4C001R02000559100_chr1_17422	23	60	TGTT	GGGC
V350256906L4C001R02000925611	chr1	656941	50M	168	657109	656942	657110	V350256906L4C001R02000925611_chr1_656941	61	46	gctg	catt
V350256906L4C001R02001141800	chr1	468515	50M	201	468716	468516	468717	V350256906L4C001R02001141800_chr1_468515	84	39	ctat	cccc
V350256906L4C001R02100092229	chr1	1103732	50M	158	1103890	1103733	1103891	V350256906L4C001R02100092229_chr1_1103732	59	49	CTCC	CCCC
V350256906L4C001R02100818233	chr1	1148466	50M	161	1148627	1148467	1148628	V350256906L4C001R02100818233_chr1_1148466	34	108	CCCA	CTGC
V350256906L4C001R02101032632	chr1	323407	50M	160	323567	323408	323568	V350256906L4C001R02101032632_chr1_323407	64	0	cgag	tgcc
V350256906L4C001R02101160482	chr1	1152845	50M	189	1153034	1152846	1153035	V350256906L4C001R02101160482_chr1_1152845	26	146	GCCG	GAAC
V350256906L4C001R02101406909	chr1	84230	50M	166	84396	84231	84397	V350256906L4C001R02101406909_chr1_84230	112	63	tttt	tgaa
V350256906L4C001R02200083307	chr1	118008	50M	167	118175	118009	118176	V350256906L4C001R02200083307_chr1_118008	44	58	gcct	tgga
V350256906L4C001R02200136297	chr1	881794	50M	192	881986	881795	881987	V350256906L4C001R02200136297_chr1_881794	49	42	CTCA	GGGC
V350256906L4C001R02200407549	chr1	107134	50M	173	107307	107135	107308	V350256906L4C001R02200407549_chr1_107134	1	0	CACA	CCAC
V350256906L4C001R02200678790	chr1	971569	50M	158	971727	971570	971728	V350256906L4C001R02200678790_chr1_971569	67	50	GATC	CACT
V350256906L4C001R02201015163	chr1	347166	50M	159	347325	347167	347326	V350256906L4C001R02201015163_chr1_347166	43	75	cgtt	tctc
V350256906L4C001R02201098498	chr1	669529	50M	160	669689	669530	669690	V350256906L4C001R02201098498_chr1_669529	71	195	accg	gact
V350256906L4C001R02300996608	chr1	981129	50M	122	981251	981130	981252	V350256906L4C001R02300996608_chr1_981129	42	0	CCAA	CACA
V350256906L4C001R02301016438	chr1	1054702	50M	147	1054849	1054703	1054850	V350256906L4C001R02301016438_chr1_1054702	0	42	ATTT	aaat
V350256906L4C001R02400076887	chr1	1277917	50M	189	1278106	1277918	1278107	V350256906L4C001R02400076887_chr1_1277917	55	50	CCTC	CAAG
V350256906L4C001R02400210714	chr1	1394744	50M	166	1394910	1394745	1394911	V350256906L4C001R02400210714_chr1_1394744	3	30	GGAT	AGGC
V350256906L4C001R02400402537	chr1	1351480	50M	187	1351667	1351481	1351668	V350256906L4C001R02400402537_chr1_1351480	38	30	caat	ggtg
V350256906L4C001R02400449400	chr1	789997	50M	214	790211	789998	790212	V350256906L4C001R02400449400_chr1_789997	33	49	TCTT	GTGT
V350256906L4C001R02401276657	chr1	731889	50M	170	732059	731890	732060	V350256906L4C001R02401276657_chr1_731889	27	33	AAAC	ttaa
V350256906L4C001R02401375830	chr1	252941	50M	168	253109	252942	253110	V350256906L4C001R02401375830_chr1_252941	104	29	CCTA	TACT
V350256906L4C001R02500055312	chr1	931867	50M	145	932012	931868	932013	V350256906L4C001R02500055312_chr1_931867	179	129	CCCC	CCCA
V350256906L4C001R02500251430	chr1	40125	50M	113	40238	40126	40239	V350256906L4C001R02500251430_chr1_40125	0	31	agag	ccag
V350256906L4C001R02500742281	chr1	1332211	50M	159	1332370	1332212	1332371	V350256906L4C001R02500742281_chr1_1332211	23	21	ctcc	ggat
V350256906L4C001R02500919142	chr1	771949	50M	200	772149	771950	772150	V350256906L4C001R02500919142_chr1_771949	161	17	ccgg	cgct
V350256906L4C001R02500960310	chr1	440519	50M	157	440676	440520	440677	V350256906L4C001R02500960310_chr1_440519	0	126	TCTC	CTCC
V350256906L4C001R02501055169	chr1	808518	50M	180	808698	808519	808699	V350256906L4C001R02501055169_chr1_808518	31	8	CTGT	CCAG
V350256906L4C001R02600568107	chr1	738144	50M	171	738315	738145	738316	V350256906L4C001R02600568107_chr1_738144	95	26	CAAA	CCAG
V350256906L4C001R02600760223	chr1	1099632	50M	204	1099836	1099633	1099837	V350256906L4C001R02600760223_chr1_1099632	54	37	CTGA	AAAA
V350256906L4C001R02600823022	chr1	879086	50M	185	879271	879087	879272	V350256906L4C001R02600823022_chr1_879086	0	38	GGAG	GGTG
V350256906L4C001R02600875613	chr1	581254	50M	144	581398	581255	581399	V350256906L4C001R02600875613_chr1_581254	52	59	Agtg	TCCA
V350256906L4C001R02601335655	chr1	833478	50M	138	833616	833479	833617	V350256906L4C001R02601335655_chr1_833478	43	0	cttt	ctgg
V350256906L4C001R02700601817	chr1	1311625	50M	177	1311802	1311626	1311803	V350256906L4C001R02700601817_chr1_1311625	191	39	AGAC	CGTA
V350256906L4C001R02800235194	chr1	1142436	50M	160	1142596	1142437	1142597	V350256906L4C001R02800235194_chr1_1142436	183	23	GGTG	CGAG
V350256906L4C001R02800537463	chr1	699400	50M	163	699563	699401	699564	V350256906L4C001R02800537463_chr1_699400	66	69	CCCA	CCTA
V350256906L4C001R02800783576	chr1	236911	50M	113	237024	236912	237025	V350256906L4C001R02800783576_chr1_236911	0	84	CTGA	TCCC
V350256906L4C001R02800878593	chr1	379978	50M	180	380158	379979	380159	V350256906L4C001R02800878593_chr1_379978	3	48	tttt	attg
V350256906L4C001R02801234622	chr1	12395	50M	158	12553	12396	12554	V350256906L4C001R02801234622_chr1_12395	64	48	GGGA	CCAT
V350256906L4C001R02900337262	chr1	578880	50M	160	579040	578881	579041	V350256906L4C001R02900337262_chr1_578880	33	66	ACCG	TATT
V350256906L4C001R02900928997	chr1	534604	50M	163	534767	534605	534768	V350256906L4C001R02900928997_chr1_534604	40	26	cctt	agct
V350256906L4C001R02901038327	chr1	1089152	50M	181	1089333	1089153	1089334	V350256906L4C001R02901038327_chr1_1089152	233	52	cagc	ATAC
V350256906L4C001R03000015567	chr1	447181	50M	180	447361	447182	447362	V350256906L4C001R03000015567_chr1_447181	255	170	acat	ccat
V350256906L4C001R03000068612	chr1	1203894	50M	211	1204105	1203895	1204106	V350256906L4C001R03000068612_chr1_1203894	13	0	TGCG	ccct
V350256906L4C001R03000318794	chr1	389827	50M	179	390006	389828	390007	V350256906L4C001R03000318794_chr1_389827	55	73	cagt	ccat
V350256906L4C001R03000403834	chr1	944585	50M	188	944773	944586	944774	V350256906L4C001R03000403834_chr1_944585	2	28	ccca	TGAT
V350256906L4C001R03000453541	chr1	1371218	50M	153	1371371	1371219	1371372	V350256906L4C001R03000453541_chr1_1371218	0	0	gccg	CGCC
V350256906L4C001R03001123755	chr1	1253477	50M	147	1253624	1253478	1253625	V350256906L4C001R03001123755_chr1_1253477	66	40	cctg	ataa
V350256906L4C001R03100394207	chr1	664310	50M	165	664475	664311	664476	V350256906L4C001R03100394207_chr1_664310	128	267	TGAG	TGCC
V350256906L4C001R03100517930	chr1	870351	50M	147	870498	870352	870499	V350256906L4C001R03100517930_chr1_870351	0	124	CAGG	CAAT
V350256906L4C001R03100745207	chr1	1411287	50M	170	1411457	1411288	1411458	V350256906L4C001R03100745207_chr1_1411287	29	8	CCAG	CGGG
V350256906L4C001R03100859956	chr1	441235	50M	163	441398	441236	441399	V350256906L4C001R03100859956_chr1_441235	57	61	GGCC	GATG
V350256906L4C001R03100927444	chr1	263725	50M	229	263954	263726	263955	V350256906L4C001R03100927444_chr1_263725	78	54	tgag	tgag
V350256906L4C001R03200257563	chr1	346779	50M	146	346925	346780	346926	V350256906L4C001R03200257563_chr1_346779	33	69	caag	gcca
V350256906L4C001R03200270844	chr1	1071254	50M	208	1071462	1071255	1071463	V350256906L4C001R03200270844_chr1_1071254	0	170	caaa	CCTG
V350256906L4C001R03200722006	chr1	135536	50M	151	135687	135537	135688	V350256906L4C001R03200722006_chr1_135536	64	120	GGAC	CCCC
V350256906L4C001R03200954206	chr1	874684	50M	163	874847	874685	874848	V350256906L4C001R03200954206_chr1_874684	25	75	CCCA	CCTC
V350256906L4C001R03201071307	chr1	639856	50M	189	640045	639857	640046	V350256906L4C001R03201071307_chr1_639856	2	0	AGTC	CCAG
V350256906L4C001R03201074972	chr1	1176784	50M	182	1176966	1176785	1176967	V350256906L4C001R03201074972_chr1_1176784	38	28	CTGG	TGTT
V350256906L4C001R03201212873	chr1	46544	50M	189	46733	46545	46734	V350256906L4C001R03201212873_chr1_46544	0	171	AGAC	TGTC
V350256906L4C001R03201402678	chr1	937326	50M	168	937494	937327	937495	V350256906L4C001R03201402678_chr1_937326	37	5	CCCC	CCCC
V350256906L4C001R03300174689	chr1	413835	50M	203	414038	413836	414039	V350256906L4C001R03300174689_chr1_413835	31	83	cact	acag
V350256906L4C001R03300188641	chr1	850407	50M	171	850578	850408	850579	V350256906L4C001R03300188641_chr1_850407	74	68	ccag	ggtc
V350256906L4C001R03300358100	chr1	1164448	50M	118	1164566	1164449	1164567	V350256906L4C001R03300358100_chr1_1164448	0	89	CCAG	CGTG
V350256906L4C001R03300375883	chr1	1023868	50M	149	1024017	1023869	1024018	V350256906L4C001R03300375883_chr1_1023868	58	47	CTCC	GGAG
V350256906L4C001R03300741166	chr1	812880	50M	187	813067	812881	813068	V350256906L4C001R03300741166_chr1_812880	7	70	CAGG	GCAT
V350256906L4C001R03301122904	chr1	958341	50M	174	958515	958342	958516	V350256906L4C001R03301122904_chr1_958341	23	7	ATGG	GGAG
V350256906L4C001R03400027479	chr1	174523	50M	136	174659	174524	174660	V350256906L4C001R03400027479_chr1_174523	24	0	ggag	cccg
V350256906L4C001R03400251832	chr1	412137	50M	175	412312	412138	412313	V350256906L4C001R03400251832_chr1_412137	11	19	CCTG	CATG
V350256906L4C001R03400288690	chr1	1419269	50M	163	1419432	1419270	1419433	V350256906L4C001R03400288690_chr1_1419269	41	62	CACC	CTGT
V350256906L4C001R03400656018	chr1	760250	50M	187	760437	760251	760438	V350256906L4C001R03400656018_chr1_760250	0	161	TAAG	CATG
V350256906L4C001R03400873746	chr1	1413195	50M	142	1413337	1413196	1413338	V350256906L4C001R03400873746_chr1_1413195	93	151	tctg	cgag
V350256906L4C001R03400893599	chr1	77984	50M	122	78106	77985	78107	V350256906L4C001R03400893599_chr1_77984	72	0	ccgt	tttt
V350256906L4C001R03500346247	chr1	40272	50M	168	40440	40273	40441	V350256906L4C001R03500346247_chr1_40272	65	27	gtgg	gcca
V350256906L4C001R03500499278	chr1	417766	50M	207	417973	417767	417974	V350256906L4C001R03500499278_chr1_417766	17	25	ccaa	GCTG
V350256906L4C001R03500826728	chr1	395822	50M	145	395967	395823	395968	V350256906L4C001R03500826728_chr1_395822	50	32	accc	TAGA
V350256906L4C001R03500855530	chr1	1281671	50M	169	1281840	1281672	1281841	V350256906L4C001R03500855530_chr1_1281671	27	17	CCCC	CGCC
V350256906L4C001R03500910989	chr1	1378486	50M	221	1378707	1378487	1378708	V350256906L4C001R03500910989_chr1_1378486	88	90	gcta	CTCT
V350256906L4C001R03501014839	chr1	564393	50M	205	564598	564394	564599	V350256906L4C001R03501014839_chr1_564393	33	57	ACAA	ATAT
V350256906L4C001R03501051085	chr1	956012	50M	128	956140	956013	956141	V350256906L4C001R03501051085_chr1_956012	50	55	CGGC	CCGG
V350256906L4C001R03501358087	chr1	68963	50M	171	69134	68964	69135	V350256906L4C001R03501358087_chr1_68963	0	124	AGCA	CCTG
V350256906L4C001R03600029410	chr1	153248	50M	184	153432	153249	153433	V350256906L4C001R03600029410_chr1_153248	270	86	aaac	ccac
V350256906L4C001R03600066311	chr1	65740	50M	182	65922	65741	65923	V350256906L4C001R03600066311_chr1_65740	65	140	TAGA	GGAG
V350256906L4C001R03600100233	chr1	21026	50M	172	21198	21027	21199	V350256906L4C001R03600100233_chr1_21026	58	53	GGTG	CCAC
V350256906L4C001R03600137330	chr1	932259	50M	163	932422	932260	932423	V350256906L4C001R03600137330_chr1_932259	16	41	CAGG	CTAG
V350256906L4C001R03600139781	chr1	1130663	50M	175	1130838	1130664	1130839	V350256906L4C001R03600139781_chr1_1130663	12	0	cacc	agag
V350256906L4C001R03600466747	chr1	113200	50M	145	113345	113201	113346	V350256906L4C001R03600466747_chr1_113200	59	142	TACA	GAAG
V350256906L4C001R03600477179	chr1	651099	50M	154	651253	651100	651254	V350256906L4C001R03600477179_chr1_651099	95	28	ctac	CACA
V350256906L4C001R03600537210	chr1	1386047	50M	207	1386254	1386048	1386255	V350256906L4C001R03600537210_chr1_1386047	7	99	CCCT	CCAC
V350256906L4C001R03601254192	chr1	988570	50M	155	988725	988571	988726	V350256906L4C001R03601254192_chr1_988570	55	41	TGGG	CGAG
V350256906L4C001R03700233194	chr1	629555	50M	177	629732	629556	629733	V350256906L4C001R03700233194_chr1_629555	74	48	CACA	TGCT
V350256906L4C001R03700364661	chr1	561978	50M	165	562143	561979	562144	V350256906L4C001R03700364661_chr1_561978	14	179	gtat	ggag
V350256906L4C001R03700371093	chr1	816523	50M	158	816681	816524	816682	V350256906L4C001R03700371093_chr1_816523	17	127	ttcc	cggg
V350256906L4C001R03700419620	chr1	1112607	50M	165	1112772	1112608	1112773	V350256906L4C001R03700419620_chr1_1112607	1	23	tgca	tgca
V350256906L4C001R03700446481	chr1	726890	50M	156	727046	726891	727047	V350256906L4C001R03700446481_chr1_726890	46	11	gaat	AAAT
V350256906L4C001R03700669344	chr1	847359	50M	171	847530	847360	847531	V350256906L4C001R03700669344_chr1_847359	19	38	caat	TGAA
V350256906L4C001R03701062007	chr1	585860	50M	132	585992	585861	585993	V350256906L4C001R03701062007_chr1_585860	64	22	caCC	tgag
V350256906L4C001R03701087075	chr1	257645	50M	157	257802	257646	257803	V350256906L4C001R03701087075_chr1_257645	73	45	ctcc	CAAA
V350256906L4C001R03800831632	chr1	167145	50M	244	167389	167146	167390	V350256906L4C001R03800831632_chr1_167145	8	11	tatt	caag
V350256906L4C001R03801253800	chr1	636954	50M	170	637124	636955	637125	V350256906L4C001R03801253800_chr1_636954	74	75	taca	tctt
V350256906L4C001R03900399407	chr1	126023	50M	178	126201	126024	126202	V350256906L4C001R03900399407_chr1_126023	0	0	TTTA	tcat
V350256906L4C001R03900538861	chr1	849196	50M	162	849358	849197	849359	V350256906L4C001R03900538861_chr1_849196	6	30	CCAT	TGTC
V350256906L4C001R04000087725	chr1	1349161	50M	200	1349361	1349162	1349362	V350256906L4C001R04000087725_chr1_1349161	7	0	agac	aaaa
V350256906L4C001R04000194925	chr1	1153846	50M	178	1154024	1153847	1154025	V350256906L4C001R04000194925_chr1_1153846	42	38	CCTC	CGTC
V350256906L4C001R04000510596	chr1	1172089	50M	156	1172245	1172090	1172246	V350256906L4C001R04000510596_chr1_1172089	47	26	CCCT	CCTC
V350256906L4C001R04000640201	chr1	157018	50M	158	157176	157019	157177	V350256906L4C001R04000640201_chr1_157018	144	0	ggat	CACA
V350256906L4C001R04000813078	chr1	59536	50M	160	59696	59537	59697	V350256906L4C001R04000813078_chr1_59536	54	214	GTAA	TTAA
V350256906L4C001R04000928532	chr1	1035371	50M	163	1035534	1035372	1035535	V350256906L4C001R04000928532_chr1_1035371	45	60	cccc	caaa
V350256906L4C001R04001201773	chr1	1422408	50M	190	1422598	1422409	1422599	V350256906L4C001R04001201773_chr1_1422408	43	35	CATT	cgcc
V350256906L4C001R04100382980	chr1	389637	50M	167	389804	389638	389805	V350256906L4C001R04100382980_chr1_389637	56	67	tcct	cctg
V350256906L4C001R04100467655	chr1	1382624	50M	187	1382811	1382625	1382812	V350256906L4C001R04100467655_chr1_1382624	21	24	ggac	cgtc
V350256906L4C001R04100616842	chr1	704694	50M	142	704836	704695	704837	V350256906L4C001R04100616842_chr1_704694	122	0	CTCC	ttat
V350256906L4C001R04200578573	chr1	691242	50M	159	691401	691243	691402	V350256906L4C001R04200578573_chr1_691242	0	145	GGca	AGTG
V350256906L4C001R04200877802	chr1	1063849	50M	187	1064036	1063850	1064037	V350256906L4C001R04200877802_chr1_1063849	35	29	CGGC	CTGC
V350256906L4C001R04201021363	chr1	946490	50M	187	946677	946491	946678	V350256906L4C001R04201021363_chr1_946490	63	50	cttg	cggg
V350256906L4C001R04300082283	chr1	725647	26M5I19M	190	725837	725648	725838	V350256906L4C001R04300082283_chr1_725647	131	46	caat	catt
V350256906L4C001R04300193659	chr1	1339034	50M	186	1339220	1339035	1339221	V350256906L4C001R04300193659_chr1_1339034	10	16	CCCA	ATAA
V350256906L4C001R04300235453	chr1	393341	50M	177	393518	393342	393519	V350256906L4C001R04300235453_chr1_393341	15	2	catc	ataa
V350256906L4C001R04300508975	chr1	1131560	50M	120	1131680	1131561	1131681	V350256906L4C001R04300508975_chr1_1131560	0	38	atct	Cgaa
V350256906L4C001R04300797157	chr1	1318748	50M	169	1318917	1318749	1318918	V350256906L4C001R04300797157_chr1_1318748	0	9	ccca	tagt
V350256906L4C001R04301277084	chr1	238274	50M	198	238472	238275	238473	V350256906L4C001R04301277084_chr1_238274	29	23	ccac	tctc
V350256906L4C001R04301293999	chr1	944762	50M	195	944957	944763	944958	V350256906L4C001R04301293999_chr1_944762	17	47	TTAA	cccg
V350256906L4C001R04301365938	chr1	325571	50M	183	325754	325572	325755	V350256906L4C001R04301365938_chr1_325571	72	65	TCCC	TCTG
V350256906L4C001R04400301650	chr1	37964	50M	171	38135	37965	38136	V350256906L4C001R04400301650_chr1_37964	157	0	CCAG	tgtt
V350256906L4C001R04400520939	chr1	724147	39M11S	152	724299	724148	724300	V350256906L4C001R04400520939_chr1_724147	30	0	gaat	tcca
V350256906L4C001R04400529913	chr1	255394	50M	174	255568	255395	255569	V350256906L4C001R04400529913_chr1_255394	68	25	CTGA	CATT
V350256906L4C001R04400569736	chr1	435609	50M	166	435775	435610	435776	V350256906L4C001R04400569736_chr1_435609	41	0	TAGA	AAGT
V350256906L4C001R04400767702	chr1	726831	13S37M	126	726957	726832	726958	V350256906L4C001R04400767702_chr1_726831	0	38	aatg	tcca
V350256906L4C001R04401025197	chr1	1158280	50M	164	1158444	1158281	1158445	V350256906L4C001R04401025197_chr1_1158280	134	0	CCTA	tgca
V350256906L4C001R04401080353	chr1	577118	50M	146	577264	577119	577265	V350256906L4C001R04401080353_chr1_577118	56	6	tatc	agtt
V350256906L4C001R04401131261	chr1	771806	50M	183	771989	771807	771990	V350256906L4C001R04401131261_chr1_771806	304	121	tgcc	aggt
V350256906L4C001R04401403241	chr1	393678	50M	180	393858	393679	393859	V350256906L4C001R04401403241_chr1_393678	0	143	ttca	caag
V350256906L4C001R04500148841	chr1	939195	50M	173	939368	939196	939369	V350256906L4C001R04500148841_chr1_939195	451	531	CCTC	CCCC
V350256906L4C001R04500371249	chr1	1320004	50M	153	1320157	1320005	1320158	V350256906L4C001R04500371249_chr1_1320004	71	41	ctcc	tgcc
V350256906L4C001R04500637947	chr1	1135874	50M	196	1136070	1135875	1136071	V350256906L4C001R04500637947_chr1_1135874	61	113	CCCT	CCTC
V350256906L4C001R04500681475	chr1	380981	50M	214	381195	380982	381196	V350256906L4C001R04500681475_chr1_380981	22	57	catg	ccta
V350256906L4C001R04500728007	chr1	984621	50M	180	984801	984622	984802	V350256906L4C001R04500728007_chr1_984621	0	129	ACAC	CAAA
V350256906L4C001R04500730696	chr1	1121436	50M	193	1121629	1121437	1121630	V350256906L4C001R04500730696_chr1_1121436	0	174	gggt	cgcg
V350256906L4C001R04500737754	chr1	666068	50M	171	666239	666069	666240	V350256906L4C001R04500737754_chr1_666068	41	43	ccag	ccag
V350256906L4C001R04500786926	chr1	938894	50M	192	939086	938895	939087	V350256906L4C001R04500786926_chr1_938894	150	342	gact	CTGT
V350256906L4C001R04501022459	chr1	234586	50M	153	234739	234587	234740	V350256906L4C001R04501022459_chr1_234586	32	41	cctt	ATTT
V350256906L4C001R04501182262	chr1	730412	50M	175	730587	730413	730588	V350256906L4C001R04501182262_chr1_730412	11	47	agag	agcc
V350256906L4C001R04501316826	chr1	725032	50M	141	725173	725033	725174	V350256906L4C001R04501316826_chr1_725032	62	96	gtat	ccat
V350256906L4C001R04501381820	chr1	820677	50M	173	820850	820678	820851	V350256906L4C001R04501381820_chr1_820677	27	0	acct	tgaa
V350256906L4C001R04601120255	chr1	803742	50M	170	803912	803743	803913	V350256906L4C001R04601120255_chr1_803742	51	10	CATT	GAAG
V350256906L4C001R04601125748	chr1	872788	50M	165	872953	872789	872954	V350256906L4C001R04601125748_chr1_872788	15	0	ACCC	GGCT
V350256906L4C001R04700151341	chr1	243950	50M	220	244170	243951	244171	V350256906L4C001R04700151341_chr1_243950	56	38	CATT	gcaa
V350256906L4C001R04700209347	chr1	726925	43M7S	101	727026	726926	727027	V350256906L4C001R04700209347_chr1_726925	70	0	gaat	ccat
V350256906L4C001R04700236611	chr1	462855	50M	166	463021	462856	463022	V350256906L4C001R04700236611_chr1_462855	57	73	acca	ggag
V350256906L4C001R04700252608	chr1	1299887	50M	140	1300027	1299888	1300028	V350256906L4C001R04700252608_chr1_1299887	0	20	GGAA	ccgc
V350256906L4C001R04700422740	chr1	1103299	50M	178	1103477	1103300	1103478	V350256906L4C001R04700422740_chr1_1103299	86	8	CACT	cgct
V350256906L4C001R04700610491	chr1	164456	50M	169	164625	164457	164626	V350256906L4C001R04700610491_chr1_164456	58	68	cgtc	cctt
V350256906L4C001R04700907814	chr1	61743	50M	152	61895	61744	61896	V350256906L4C001R04700907814_chr1_61743	21	111	gata	ggag
V350256906L4C001R04701210721	chr1	107760	50M	265	108025	107761	108026	V350256906L4C001R04701210721_chr1_107760	39	41	agga	cagg
V350256906L4C001R04800272946	chr1	320554	50M	182	320736	320555	320737	V350256906L4C001R04800272946_chr1_320554	95	33	CCAC	gctc
V350256906L4C001R04800376048	chr1	958089	50M	185	958274	958090	958275	V350256906L4C001R04800376048_chr1_958089	3	25	CCTC	CACA
V350256906L4C001R04800850148	chr1	1142706	50M	191	1142897	1142707	1142898	V350256906L4C001R04800850148_chr1_1142706	66	0	CGCA	CCAC
V350256906L4C001R04800880485	chr1	252207	50M	176	252383	252208	252384	V350256906L4C001R04800880485_chr1_252207	33	17	GAAA	AAAG
V350256906L4C001R04800957924	chr1	1085231	50M	172	1085403	1085232	1085404	V350256906L4C001R04800957924_chr1_1085231	63	82	CCCT	ACCT
V350256906L4C001R04801030149	chr1	159335	50M	169	159504	159336	159505	V350256906L4C001R04801030149_chr1_159335	167	173	ACAT	ccac
V350256906L4C001R04801355085	chr1	143511	50M	149	143660	143512	143661	V350256906L4C001R04801355085_chr1_143511	227	78	tata	ctgt
V350256906L4C001R04900032311	chr1	322277	50M	145	322422	322278	322423	V350256906L4C001R04900032311_chr1_322277	33	44	aatt	acca
V350256906L4C001R04900281197	chr1	1175667	50M	179	1175846	1175668	1175847	V350256906L4C001R04900281197_chr1_1175667	74	74	CCAG	CCCC
V350256906L4C001R04900401679	chr1	1026533	50M	118	1026651	1026534	1026652	V350256906L4C001R04900401679_chr1_1026533	0	76	CACT	CCTG
V350256906L4C001R04900411853	chr1	236540	50M	123	236663	236541	236664	V350256906L4C001R04900411853_chr1_236540	17	59	gtag	GGCA
V350256906L4C001R04900434452	chr1	1120936	50M	267	1121203	1120937	1121204	V350256906L4C001R04900434452_chr1_1120936	24	29	TTTT	agAG
V350256906L4C001R04900451131	chr1	70302	50M	177	70479	70303	70480	V350256906L4C001R04900451131_chr1_70302	48	26	CTAA	CGTT
V350256906L4C001R04900586399	chr1	1217730	50M	166	1217896	1217731	1217897	V350256906L4C001R04900586399_chr1_1217730	7	0	TGCT	TACT
V350256906L4C001R04900733311	chr1	628776	50M	171	628947	628777	628948	V350256906L4C001R04900733311_chr1_628776	45	79	aaat	TTTG
V350256906L4C001R04900790266	chr1	618954	50M	161	619115	618955	619116	V350256906L4C001R04900790266_chr1_618954	0	12	caga	atta
V350256906L4C001R04901054276	chr1	886134	46M4S	189	886323	886135	886324	V350256906L4C001R04901054276_chr1_886134	19	22	cccc	CTGG
V350256906L4C001R04901179113	chr1	1114995	50M	164	1115159	1114996	1115160	V350256906L4C001R04901179113_chr1_1114995	16	39	ACCC	GGAG
V350256906L4C001R05000099256	chr1	1046427	50M	175	1046602	1046428	1046603	V350256906L4C001R05000099256_chr1_1046427	13	100	gctc	ATAA
V350256906L4C001R05000171513	chr1	460293	50M	160	460453	460294	460454	V350256906L4C001R05000171513_chr1_460293	33	70	CTCC	ACCC
V350256906L4C001R05000342515	chr1	236700	50M	169	236869	236701	236870	V350256906L4C001R05000342515_chr1_236700	28	34	CCTC	cacg
V350256906L4C001R05000450866	chr1	621158	50M	157	621315	621159	621316	V350256906L4C001R05000450866_chr1_621158	0	28	CCTT	TCAG
V350256906L4C001R05000615232	chr1	1087870	50M	162	1088032	1087871	1088033	V350256906L4C001R05000615232_chr1_1087870	73	48	TCCA	CCCC
V350256906L4C001R05000635255	chr1	607157	50M	208	607365	607158	607366	V350256906L4C001R05000635255_chr1_607157	58	68	ccaa	ctgc
V350256906L4C001R05000853334	chr1	771116	50M	177	771293	771117	771294	V350256906L4C001R05000853334_chr1_771116	66	128	GCCT	GCAT
V350256906L4C001R05000876771	chr1	1262071	50M	156	1262227	1262072	1262228	V350256906L4C001R05000876771_chr1_1262071	41	0	GGGT	TGGC
V350256906L4C001R05000980763	chr1	632490	50M	133	632623	632491	632624	V350256906L4C001R05000980763_chr1_632490	33	66	tgga	gctt
V350256906L4C001R05001062262	chr1	880354	50M	179	880533	880355	880534	V350256906L4C001R05001062262_chr1_880354	23	62	CCCC	CCTC
V350256906L4C001R05001209312	chr1	745430	50M	161	745591	745431	745592	V350256906L4C001R05001209312_chr1_745430	64	63	AATG	CCCT
V350256906L4C001R05100167023	chr1	574747	50M	187	574934	574748	574935	V350256906L4C001R05100167023_chr1_574747	74	51	actc	TTTC
V350256906L4C001R05100268972	chr1	60204	50M	142	60346	60205	60347	V350256906L4C001R05100268972_chr1_60204	63	32	CATG	CATT
V350256906L4C001R05100446457	chr1	873397	50M	160	873557	873398	873558	V350256906L4C001R05100446457_chr1_873397	171	251	GGCC	CATT
V350256906L4C001R05101112609	chr1	377813	50M	167	377980	377814	377981	V350256906L4C001R05101112609_chr1_377813	142	0	ggtc	ccac
V350256906L4C001R05101186386	chr1	1159123	50M	185	1159308	1159124	1159309	V350256906L4C001R05101186386_chr1_1159123	0	3	GGGC	TGCA
V350256906L4C001R05200472419	chr1	1071473	50M	181	1071654	1071474	1071655	V350256906L4C001R05200472419_chr1_1071473	159	0	GCAG	GGCC
V350256906L4C001R05200506322	chr1	781145	50M	169	781314	781146	781315	V350256906L4C001R05200506322_chr1_781145	25	31	CCTT	GACA
V350256906L4C001R05200544690	chr1	438222	50M	177	438399	438223	438400	V350256906L4C001R05200544690_chr1_438222	56	37	CCCG	CCCA
V350256906L4C001R05200832334	chr1	547484	42M8S	173	547657	547485	547658	V350256906L4C001R05200832334_chr1_547484	0	150	cgtg	ACAC
V350256906L4C001R05200932997	chr1	1147569	50M	146	1147715	1147570	1147716	V350256906L4C001R05200932997_chr1_1147569	0	28	GGAG	TGTG
V350256906L4C001R05201125541	chr1	1274051	50M	163	1274214	1274052	1274215	V350256906L4C001R05201125541_chr1_1274051	23	26	CCCC	CCTG
V350256906L4C001R05201229751	chr1	531882	50M	241	532123	531883	532124	V350256906L4C001R05201229751_chr1_531882	218	0	taca	cacg
V350256906L4C001R05201383322	chr1	1237154	50M	174	1237328	1237155	1237329	V350256906L4C001R05201383322_chr1_1237154	38	38	gctG	CGCT
V350256906L4C001R05300105107	chr1	698698	50M	158	698856	698699	698857	V350256906L4C001R05300105107_chr1_698698	10	0	AAAA	TTTA
V350256906L4C001R05300612032	chr1	724808	10S28M12S	208	725016	724809	725017	V350256906L4C001R05300612032_chr1_724808	43	46	aatg	attc
V350256906L4C001R05300652338	chr1	662357	50M	132	662489	662358	662490	V350256906L4C001R05300652338_chr1_662357	24	91	GCAA	CGGT
V350256906L4C001R05300795281	chr1	1222985	50M	178	1223163	1222986	1223164	V350256906L4C001R05300795281_chr1_1222985	36	25	CAGC	CCCC
V350256906L4C001R05300837672	chr1	317766	50M	154	317920	317767	317921	V350256906L4C001R05300837672_chr1_317766	46	84	GCAA	cctc
V350256906L4C001R05300925741	chr1	554307	50M	162	554469	554308	554470	V350256906L4C001R05300925741_chr1_554307	53	52	cctt	CAGG
V350256906L4C001R05300933943	chr1	394168	50M	175	394343	394169	394344	V350256906L4C001R05300933943_chr1_394168	108	135	ccca	ccat
V350256906L4C001R05301000944	chr1	1097730	50M	193	1097923	1097731	1097924	V350256906L4C001R05301000944_chr1_1097730	41	16	CCAA	CCCA
V350256906L4C001R05400256442	chr1	1273199	50M	145	1273344	1273200	1273345	V350256906L4C001R05400256442_chr1_1273199	33	33	GGGG	CCCT
V350256906L4C001R05400338790	chr1	678899	50M	99	678998	678900	678999	V350256906L4C001R05400338790_chr1_678899	0	85	attt	AAGT
V350256906L4C001R05400402137	chr1	142910	50M	175	143085	142911	143086	V350256906L4C001R05400402137_chr1_142910	21	50	TGAT	TTAA
V350256906L4C001R05400467726	chr1	1352248	50M	161	1352409	1352249	1352410	V350256906L4C001R05400467726_chr1_1352248	76	0	cggt	ccag
V350256906L4C001R05400689877	chr1	332172	50M	153	332325	332173	332326	V350256906L4C001R05400689877_chr1_332172	81	31	CACA	CCCT
V350256906L4C001R05400806321	chr1	122831	50M	164	122995	122832	122996	V350256906L4C001R05400806321_chr1_122831	47	72	CTTC	ACAG
V350256906L4C001R05400857929	chr1	623639	50M	171	623810	623640	623811	V350256906L4C001R05400857929_chr1_623639	339	168	TGCA	CAAC
V350256906L4C001R05401015417	chr1	738114	50M	170	738284	738115	738285	V350256906L4C001R05401015417_chr1_738114	125	0	CATG	CCAC
V350256906L4C001R05500041926	chr1	257379	50M	120	257499	257380	257500	V350256906L4C001R05500041926_chr1_257379	0	41	ATAT	acca
V350256906L4C001R05500045133	chr1	803119	50M	172	803291	803120	803292	V350256906L4C001R05500045133_chr1_803119	63	51	CAAC	CCAG
V350256906L4C001R05500165243	chr1	458827	8S42M	264	459091	458828	459092	V350256906L4C001R05500165243_chr1_458827	5	51	aaaa	cttg
V350256906L4C001R05500398000	chr1	379250	50M	177	379427	379251	379428	V350256906L4C001R05500398000_chr1_379250	40	0	CAGG	CCCA
V350256906L4C001R05500439031	chr1	583395	50M	147	583542	583396	583543	V350256906L4C001R05500439031_chr1_583395	21	28	ccag	ccaa
V350256906L4C001R05500722280	chr1	851420	50M	180	851600	851421	851601	V350256906L4C001R05500722280_chr1_851420	11	0	CCTT	CCTG
V350256906L4C001R05501214891	chr1	321961	50M	165	322126	321962	322127	V350256906L4C001R05501214891_chr1_321961	20	36	TGCT	ggga
V350256906L4C001R05501352828	chr1	848969	50M	173	849142	848970	849143	V350256906L4C001R05501352828_chr1_848969	55	60	AGCC	GCCC
V350256906L4C001R05501383316	chr1	1321079	50M	183	1321262	1321080	1321263	V350256906L4C001R05501383316_chr1_1321079	13	3	gaac	cctt
V350256906L4C001R05600182386	chr1	749091	50M	186	749277	749092	749278	V350256906L4C001R05600182386_chr1_749091	8	194	GCTA	ccta
V350256906L4C001R05600246943	chr1	362727	50M	164	362891	362728	362892	V350256906L4C001R05600246943_chr1_362727	28	71	CTGA	CCTA
V350256906L4C001R05600279080	chr1	785606	50M	158	785764	785607	785765	V350256906L4C001R05600279080_chr1_785606	168	10	GTGA	CTAA
V350256906L4C001R05600417941	chr1	118543	50M	191	118734	118544	118735	V350256906L4C001R05600417941_chr1_118543	79	70	ccct	gcaa
V350256906L4C001R05600724847	chr1	36038	50M	142	36180	36039	36181	V350256906L4C001R05600724847_chr1_36038	161	46	CCTT	ATAT
V350256906L4C001R05601026035	chr1	851948	50M	167	852115	851949	852116	V350256906L4C001R05601026035_chr1_851948	0	15	CTCT	TATT
V350256906L4C001R05700133705	chr1	1236604	50M	160	1236764	1236605	1236765	V350256906L4C001R05700133705_chr1_1236604	66	65	ccat	ggag
V350256906L4C001R05700235005	chr1	805369	50M	156	805525	805370	805526	V350256906L4C001R05700235005_chr1_805369	57	51	CCTG	CCGG
V350256906L4C001R05700305930	chr1	359328	50M	211	359539	359329	359540	V350256906L4C001R05700305930_chr1_359328	47	63	AGAG	tctc
V350256906L4C001R05700342746	chr1	231377	50M	174	231551	231378	231552	V350256906L4C001R05700342746_chr1_231377	105	279	gaat	caca
V350256906L4C001R05700670552	chr1	915001	50M	129	915130	915002	915131	V350256906L4C001R05700670552_chr1_915001	54	10	ACCA	ATCT
V350256906L4C001R05700677839	chr1	689601	50M	157	689758	689602	689759	V350256906L4C001R05700677839_chr1_689601	118	37	tgtg	ctcc
V350256906L4C001R05701154772	chr1	77205	50M	190	77395	77206	77396	V350256906L4C001R05701154772_chr1_77205	218	75	ccaa	CCAA
V350256906L4C001R05701222566	chr1	588506	50M	166	588672	588507	588673	V350256906L4C001R05701222566_chr1_588506	72	126	ccta	aaca
V350256906L4C001R05800371648	chr1	1009606	50M	176	1009782	1009607	1009783	V350256906L4C001R05800371648_chr1_1009606	28	0	CTGT	GCCA
V350256906L4C001R05800492603	chr1	10093	50M	152	10245	10094	10246	V350256906L4C001R05800492603_chr1_10093	430	278	accc	gtta
V350256906L4C001R05800551665	chr1	391843	50M	179	392022	391844	392023	V350256906L4C001R05800551665_chr1_391843	225	81	cctc	acaa
V350256906L4C001R05800728676	chr1	987345	50M	198	987543	987346	987544	V350256906L4C001R05800728676_chr1_987345	91	42	TCTC	CGGC
V350256906L4C001R05801070080	chr1	1165917	50M	165	1166082	1165918	1166083	V350256906L4C001R05801070080_chr1_1165917	58	65	tgca	ggat
V350256906L4C001R05900399222	chr1	915392	50M	155	915547	915393	915548	V350256906L4C001R05900399222_chr1_915392	69	26	CAGG	CCCA
V350256906L4C001R05900699154	chr1	1393590	50M	168	1393758	1393591	1393759	V350256906L4C001R05900699154_chr1_1393590	143	37	acct	gctt
V350256906L4C001R05900974519	chr1	927661	50M	169	927830	927662	927831	V350256906L4C001R05900974519_chr1_927661	63	58	ccca	gcct
V350256906L4C001R05901094939	chr1	990070	50M	189	990259	990071	990260	V350256906L4C001R05901094939_chr1_990070	69	64	CCCT	CCTG
V350256906L4C001R05901187141	chr1	466995	50M	174	467169	466996	467170	V350256906L4C001R05901187141_chr1_466995	61	87	TAAT	TGTT
V350256906L4C001R05901187607	chr1	1154293	50M	181	1154474	1154294	1154475	V350256906L4C001R05901187607_chr1_1154293	22	0	CCAG	TCTT
V350256906L4C001R06000158189	chr1	411183	50M	226	411409	411184	411410	V350256906L4C001R06000158189_chr1_411183	0	26	GGAG	GCTG
V350256906L4C001R06000417620	chr1	94341	50M	163	94504	94342	94505	V350256906L4C001R06000417620_chr1_94341	68	33	cctc	CAAA
V350256906L4C001R06000676633	chr1	726825	19S22M9S	142	726967	726826	726968	V350256906L4C001R06000676633_chr1_726825	0	28	gaat	tcca
V350256906L4C001R06001388153	chr1	846244	50M	173	846417	846245	846418	V350256906L4C001R06001388153_chr1_846244	65	58	ACAG	CCCA
V350256906L4C001R06100156755	chr1	652153	50M	157	652310	652154	652311	V350256906L4C001R06100156755_chr1_652153	34	62	AACA	TCCT
V350256906L4C001R06100189036	chr1	875014	50M	192	875206	875015	875207	V350256906L4C001R06100189036_chr1_875014	64	55	CCCC	CCCC
V350256906L4C001R06100651501	chr1	815150	50M	162	815312	815151	815313	V350256906L4C001R06100651501_chr1_815150	19	39	caat	tcat
V350256906L4C001R06100790733	chr1	980875	50M	141	981016	980876	981017	V350256906L4C001R06100790733_chr1_980875	68	33	CGTC	CCAG
V350256906L4C001R06100803789	chr1	1120158	50M	189	1120347	1120159	1120348	V350256906L4C001R06100803789_chr1_1120158	311	122	GGGG	GGGG
V350256906L4C001R06100810149	chr1	626782	50M	161	626943	626783	626944	V350256906L4C001R06100810149_chr1_626782	101	14	CCCA	CATT
V350256906L4C001R06100982097	chr1	115391	50M	160	115551	115392	115552	V350256906L4C001R06100982097_chr1_115391	57	34	tgtg	ACCT
V350256906L4C001R06200085963	chr1	440088	50M	192	440280	440089	440281	V350256906L4C001R06200085963_chr1_440088	55	35	TGGG	ACCA
V350256906L4C001R06200319242	chr1	1029685	50M	193	1029878	1029686	1029879	V350256906L4C001R06200319242_chr1_1029685	17	9	tgag	accc
V350256906L4C001R06200611487	chr1	457810	50M	164	457974	457811	457975	V350256906L4C001R06200611487_chr1_457810	43	0	ccac	caaa
V350256906L4C001R06200706152	chr1	789744	50M	187	789931	789745	789932	V350256906L4C001R06200706152_chr1_789744	82	39	CCAT	CTCC
V350256906L4C001R06200706561	chr1	409496	50M	222	409718	409497	409719	V350256906L4C001R06200706561_chr1_409496	14	0	TGTT	ccaa
V350256906L4C001R06200769952	chr1	897461	50M	159	897620	897462	897621	V350256906L4C001R06200769952_chr1_897461	0	11	cccc	GGGG
V350256906L4C001R06201304190	chr1	249626	50M	172	249798	249627	249799	V350256906L4C001R06201304190_chr1_249626	63	38	ggag	ccaa
V350256906L4C001R06300292559	chr1	408325	50M	165	408490	408326	408491	V350256906L4C001R06300292559_chr1_408325	145	106	GAGC	GAAT
V350256906L4C001R06300410954	chr1	667006	50M	178	667184	667007	667185	V350256906L4C001R06300410954_chr1_667006	109	250	ggct	caac
V350256906L4C001R06300617114	chr1	632587	50M	180	632767	632588	632768	V350256906L4C001R06300617114_chr1_632587	30	137	tttg	cctc
V350256906L4C001R06300719472	chr1	1247957	50M	135	1248092	1247958	1248093	V350256906L4C001R06300719472_chr1_1247957	27	46	TGCC	CCGG
V350256906L4C001R06400020312	chr1	22727	50M	153	22880	22728	22881	V350256906L4C001R06400020312_chr1_22727	72	168	CCCA	CAAG
V350256906L4C001R06400212159	chr1	736955	50M	148	737103	736956	737104	V350256906L4C001R06400212159_chr1_736955	0	128	CCTT	GAAA
V350256906L4C001R06400339457	chr1	253789	50M	151	253940	253790	253941	V350256906L4C001R06400339457_chr1_253789	19	47	GGAT	actg
V350256906L4C001R06400504361	chr1	546079	50M	178	546257	546080	546258	V350256906L4C001R06400504361_chr1_546079	50	228	GCCC	GGCC
V350256906L4C001R06400559787	chr1	1430212	50M	177	1430389	1430213	1430390	V350256906L4C001R06400559787_chr1_1430212	263	136	CACC	CAGG
V350256906L4C001R06400608720	chr1	667002	50M	190	667192	667003	667193	V350256906L4C001R06400608720_chr1_667002	105	242	cctg	ggta
V350256906L4C001R06400697485	chr1	746114	50M	210	746324	746115	746325	V350256906L4C001R06400697485_chr1_746114	24	56	GCTG	CCAC
V350256906L4C001R06400721111	chr1	1348113	50M	165	1348278	1348114	1348279	V350256906L4C001R06400721111_chr1_1348113	122	205	gaga	ctga
V350256906L4C001R06401009464	chr1	1004048	50M	165	1004213	1004049	1004214	V350256906L4C001R06401009464_chr1_1004048	12	100	GGGA	cgcg
V350256906L4C001R06401283118	chr1	943636	50M	160	943796	943637	943797	V350256906L4C001R06401283118_chr1_943636	6	0	GATG	caca
V350256906L4C001R06500137148	chr1	128143	50M	130	128273	128144	128274	V350256906L4C001R06500137148_chr1_128143	15	145	TACT	TTAA
V350256906L4C001R06500266354	chr1	989143	50M	158	989301	989144	989302	V350256906L4C001R06500266354_chr1_989143	66	15	CTGC	ACCA
V350256906L4C001R06500364913	chr1	134997	50M	173	135170	134998	135171	V350256906L4C001R06500364913_chr1_134997	151	153	GCCG	CTCA
V350256906L4C001R06500550709	chr1	1197773	50M	151	1197924	1197774	1197925	V350256906L4C001R06500550709_chr1_1197773	17	0	GGGC	CACT
V350256906L4C001R06500963700	chr1	1025129	50M	172	1025301	1025130	1025302	V350256906L4C001R06500963700_chr1_1025129	42	61	CCTT	CGAG
V350256906L4C001R06501198413	chr1	1197724	50M	170	1197894	1197725	1197895	V350256906L4C001R06501198413_chr1_1197724	5	10	CCCG	GGTT
V350256906L4C001R06501272714	chr1	33355	50M	184	33539	33356	33540	V350256906L4C001R06501272714_chr1_33355	43	2	cata	aaaa
V350256906L4C001R06600128039	chr1	1317803	50M	184	1317987	1317804	1317988	V350256906L4C001R06600128039_chr1_1317803	233	244	CAGA	ACTG
V350256906L4C001R06600201843	chr1	579562	50M	157	579719	579563	579720	V350256906L4C001R06600201843_chr1_579562	8	122	caag	AGGA
V350256906L4C001R06600575991	chr1	1283604	50M	162	1283766	1283605	1283767	V350256906L4C001R06600575991_chr1_1283604	45	80	CCAC	CACT
V350256906L4C001R06600629637	chr1	539944	50M	201	540145	539945	540146	V350256906L4C001R06600629637_chr1_539944	212	11	AGTG	agat
V350256906L4C001R06600717266	chr1	230745	50M	262	231007	230746	231008	V350256906L4C001R06600717266_chr1_230745	27	15	ctcc	cctc
V350256906L4C001R06601365354	chr1	458073	50M	213	458286	458074	458287	V350256906L4C001R06601365354_chr1_458073	52	62	tgca	cctg
V350256906L4C001R06700160806	chr1	262971	50M	212	263183	262972	263184	V350256906L4C001R06700160806_chr1_262971	0	179	caaa	taaa
V350256906L4C001R06700206528	chr1	440743	50M	159	440902	440744	440903	V350256906L4C001R06700206528_chr1_440743	159	0	AAGC	CCCA
V350256906L4C001R06700658375	chr1	1202674	50M	185	1202859	1202675	1202860	V350256906L4C001R06700658375_chr1_1202674	88	74	ACCA	GGAG
V350256906L4C001R06700784424	chr1	37778	50M	171	37949	37779	37950	V350256906L4C001R06700784424_chr1_37778	343	172	ctta	CCCT
V350256906L4C001R06700795496	chr1	974429	50M	152	974581	974430	974582	V350256906L4C001R06700795496_chr1_974429	22	2	ccac	CTCT
V350256906L4C001R06700852605	chr1	1177762	50M	175	1177937	1177763	1177938	V350256906L4C001R06700852605_chr1_1177762	0	5	TCTC	GGCA
V350256906L4C001R06701164418	chr1	16446	50M	162	16608	16447	16609	V350256906L4C001R06701164418_chr1_16446	201	65	GTTT	GGTG
V350256906L4C001R06800514768	chr1	1151689	50M	144	1151833	1151690	1151834	V350256906L4C001R06800514768_chr1_1151689	114	258	CCTC	CCCT
V350256906L4C001R06800882465	chr1	321319	50M	206	321525	321320	321526	V350256906L4C001R06800882465_chr1_321319	18	71	taaa	ACTT
V350256906L4C001R06800905975	chr1	446216	50M	159	446375	446217	446376	V350256906L4C001R06800905975_chr1_446216	51	187	gatt	ccct
V350256906L4C001R06801023982	chr1	772909	50M	165	773074	772910	773075	V350256906L4C001R06801023982_chr1_772909	64	0	tgag	ctga
V350256906L4C001R06801093216	chr1	353788	50M	177	353965	353789	353966	V350256906L4C001R06801093216_chr1_353788	15	0	tgtc	ccag
V350256906L4C001R06801356763	chr1	1422006	50M	170	1422176	1422007	1422177	V350256906L4C001R06801356763_chr1_1422006	21	6	CCAT	CCTG
V350256906L4C001R06900285024	chr1	132075	50M	159	132234	132076	132235	V350256906L4C001R06900285024_chr1_132075	168	9	CAGT	CCAT
V350256906L4C001R06900334652	chr1	46419	50M	162	46581	46420	46582	V350256906L4C001R06900334652_chr1_46419	117	19	gcag	ctgc
V350256906L4C001R06900664150	chr1	1401656	50M	137	1401793	1401657	1401794	V350256906L4C001R06900664150_chr1_1401656	113	73	ggtg	ccca
V350256906L4C001R06900819044	chr1	607735	50M	189	607924	607736	607925	V350256906L4C001R06900819044_chr1_607735	59	47	agca	tgtt
V350256906L4C001R06900823248	chr1	163743	50M	172	163915	163744	163916	V350256906L4C001R06900823248_chr1_163743	22	0	ACCT	tggg
V350256906L4C001R07000106931	chr1	17502	50M	147	17649	17503	17650	V350256906L4C001R07000106931_chr1_17502	31	0	TGGC	GCTC
V350256906L4C001R07000379689	chr1	244466	50M	183	244649	244467	244650	V350256906L4C001R07000379689_chr1_244466	32	59	AGAT	TGGC
V350256906L4C001R07000845168	chr1	1035001	50M	165	1035166	1035002	1035167	V350256906L4C001R07000845168_chr1_1035001	36	58	agaa	tccg
V350256906L4C001R07000929151	chr1	233792	50M	190	233982	233793	233983	V350256906L4C001R07000929151_chr1_233792	54	68	tcag	GAAA
V350256906L4C001R07001055153	chr1	140743	50M	164	140907	140744	140908	V350256906L4C001R07001055153_chr1_140743	20	19	ggat	gaaa
V350256906L4C001R07001171840	chr1	249487	50M	155	249642	249488	249643	V350256906L4C001R07001171840_chr1_249487	42	79	gctt	cacc
V350256906L4C001R07001171853	chr1	1106113	50M	198	1106311	1106114	1106312	V350256906L4C001R07001171853_chr1_1106113	229	31	CCAA	GGCA
V350256906L4C001R07001382634	chr1	1187340	50M	167	1187507	1187341	1187508	V350256906L4C001R07001382634_chr1_1187340	71	68	gtga	cttg
V350256906L4C001R07100231780	chr1	750473	50M	154	750627	750474	750628	V350256906L4C001R07100231780_chr1_750473	0	135	CTGT	ccct
V350256906L4C001R07100348395	chr1	887258	50M	169	887427	887259	887428	V350256906L4C001R07100348395_chr1_887258	86	35	GGGA	CAGC
V350256906L4C001R07100558819	chr1	235137	50M	142	235279	235138	235280	V350256906L4C001R07100558819_chr1_235137	216	74	cttt	cagt
V350256906L4C001R07101056134	chr1	826576	50M	205	826781	826577	826782	V350256906L4C001R07101056134_chr1_826576	50	44	GTGA	ggta
V350256906L4C001R07101274470	chr1	787179	50M	192	787371	787180	787372	V350256906L4C001R07101274470_chr1_787179	5	40	TCAG	CCAA
V350256906L4C001R07101316873	chr1	1037018	50M	169	1037187	1037019	1037188	V350256906L4C001R07101316873_chr1_1037018	17	77	TATC	agcc
V350256906L4C001R07200219292	chr1	1355914	50M	181	1356095	1355915	1356096	V350256906L4C001R07200219292_chr1_1355914	61	71	CCAG	CCCT
V350256906L4C001R07200421744	chr1	122059	50M	179	122238	122060	122239	V350256906L4C001R07200421744_chr1_122059	13	54	ACTA	CATT
V350256906L4C001R07201028715	chr1	134063	50M	169	134232	134064	134233	V350256906L4C001R07201028715_chr1_134063	35	8	TCCt	ggta
V350256906L4C002R00100344128	chr1	726825	23S22M5S	147	726972	726826	726973	V350256906L4C002R00100344128_chr1_726825	0	23	gaat	tcca
V350256906L4C002R00100506855	chr1	903785	50M	179	903964	903786	903965	V350256906L4C002R00100506855_chr1_903785	4	9	CTGG	tagc
V350256906L4C002R00100513299	chr1	231516	50M	205	231721	231517	231722	V350256906L4C002R00100513299_chr1_231516	244	293	ccta	tggc
V350256906L4C002R00100960142	chr1	1159750	50M	191	1159941	1159751	1159942	V350256906L4C002R00100960142_chr1_1159750	96	29	cccg	cacc
V350256906L4C002R00101288148	chr1	1222385	50M	177	1222562	1222386	1222563	V350256906L4C002R00101288148_chr1_1222385	21	18	TCAG	GGTA
V350256906L4C002R00200221999	chr1	744969	50M	178	745147	744970	745148	V350256906L4C002R00200221999_chr1_744969	19	128	ctAT	CCTG
V350256906L4C002R00200666292	chr1	853528	50M	215	853743	853529	853744	V350256906L4C002R00200666292_chr1_853528	72	46	CCAC	CCCA
V350256906L4C002R00200714725	chr1	794055	50M	152	794207	794056	794208	V350256906L4C002R00200714725_chr1_794055	68	47	CGTT	AGGG
V350256906L4C002R00200813171	chr1	1319564	50M	179	1319743	1319565	1319744	V350256906L4C002R00200813171_chr1_1319564	98	277	CTCA	gaga
V350256906L4C002R00300256962	chr1	76106	50M	142	76248	76107	76249	V350256906L4C002R00300256962_chr1_76106	31	26	tgct	ggtt
V350256906L4C002R00300394488	chr1	1365301	50M	158	1365459	1365302	1365460	V350256906L4C002R00300394488_chr1_1365301	0	0	tgag	cgag
V350256906L4C002R00300523125	chr1	574226	50M	167	574393	574227	574394	V350256906L4C002R00300523125_chr1_574226	12	52	gaag	TAAA
V350256906L4C002R00301162908	chr1	230477	50M	191	230668	230478	230669	V350256906L4C002R00301162908_chr1_230477	10	20	caga	atga
V350256906L4C002R00301190477	chr1	1230044	50M	189	1230233	1230045	1230234	V350256906L4C002R00301190477_chr1_1230044	8	8	GGGG	CCCA
V350256906L4C002R00400322911	chr1	647942	50M	175	648117	647943	648118	V350256906L4C002R00400322911_chr1_647942	0	0	CATA	TTCT
V350256906L4C002R00400407396	chr1	97431	50M	180	97611	97432	97612	V350256906L4C002R00400407396_chr1_97431	31	41	GCTA	CCAT
V350256906L4C002R00400421024	chr1	827946	50M	205	828151	827947	828152	V350256906L4C002R00400421024_chr1_827946	62	63	agtc	cagg
V350256906L4C002R00400697208	chr1	323530	50M	150	323680	323531	323681	V350256906L4C002R00400697208_chr1_323530	24	92	cctg	taca
V350256906L4C002R00400770015	chr1	670959	50M	157	671116	670960	671117	V350256906L4C002R00400770015_chr1_670959	55	59	tact	CCAA
V350256906L4C002R00400781511	chr1	122091	50M	144	122235	122092	122236	V350256906L4C002R00400781511_chr1_122091	5	51	TGGA	TAAC
V350256906L4C002R00400844534	chr1	725300	7S36M7S	124	725424	725301	725425	V350256906L4C002R00400844534_chr1_725300	0	64	ccga	tcca
V350256906L4C002R00500252705	chr1	1365382	50M	183	1365565	1365383	1365566	V350256906L4C002R00500252705_chr1_1365382	53	71	agtg	CCAA
V350256906L4C002R00500535012	chr1	1129794	50M	143	1129937	1129795	1129938	V350256906L4C002R00500535012_chr1_1129794	35	79	ttat	ggag
V350256906L4C002R00500674743	chr1	344944	50M	166	345110	344945	345111	V350256906L4C002R00500674743_chr1_344944	57	21	aaat	ttac
V350256906L4C002R00500753511	chr1	989242	50M	156	989398	989243	989399	V350256906L4C002R00500753511_chr1_989242	0	23	CTGG	CCCT
V350256906L4C002R00500898342	chr1	770526	50M	203	770729	770527	770730	V350256906L4C002R00500898342_chr1_770526	2	50	ccac	AAAT
V350256906L4C002R00501171280	chr1	602287	50M	157	602444	602288	602445	V350256906L4C002R00501171280_chr1_602287	82	37	atac	cctg
V350256906L4C002R00600157606	chr1	440813	50M	170	440983	440814	440984	V350256906L4C002R00600157606_chr1_440813	89	46	TGTA	GCCC
V350256906L4C002R00600223748	chr1	1087348	50M	208	1087556	1087349	1087557	V350256906L4C002R00600223748_chr1_1087348	29	7	tatt	gacg
V350256906L4C002R00600304978	chr1	778422	50M	165	778587	778423	778588	V350256906L4C002R00600304978_chr1_778422	70	20	TATG	GATA
V350256906L4C002R00600309983	chr1	428450	50M	152	428602	428451	428603	V350256906L4C002R00600309983_chr1_428450	8	1	ccca	agtg
V350256906L4C002R00600487918	chr1	1084083	50M	174	1084257	1084084	1084258	V350256906L4C002R00600487918_chr1_1084083	45	49	CCTG	CGCA
V350256906L4C002R00600832300	chr1	889663	50M	171	889834	889664	889835	V350256906L4C002R00600832300_chr1_889663	67	76	CCTC	CCAG
V350256906L4C002R00601103482	chr1	459480	50M	174	459654	459481	459655	V350256906L4C002R00601103482_chr1_459480	83	33	CCCT	TCTT
V350256906L4C002R00700104583	chr1	106348	50M	159	106507	106349	106508	V350256906L4C002R00700104583_chr1_106348	120	0	CCTA	ttaa
V350256906L4C002R00700256772	chr1	1383891	50M	160	1384051	1383892	1384052	V350256906L4C002R00700256772_chr1_1383891	73	55	aggt	ccca
V350256906L4C002R00700313529	chr1	825777	2S48M	162	825939	825778	825940	V350256906L4C002R00700313529_chr1_825777	60	222	agac	ACTG
V350256906L4C002R00700831078	chr1	73643	50M	188	73831	73644	73832	V350256906L4C002R00700831078_chr1_73643	33	15	tgtt	ctac
V350256906L4C002R00701196799	chr1	52965	50M	191	53156	52966	53157	V350256906L4C002R00701196799_chr1_52965	81	42	TTTC	CATG
V350256906L4C002R00701324705	chr1	431957	50M	189	432146	431958	432147	V350256906L4C002R00701324705_chr1_431957	23	138	tctg	TGCC
V350256906L4C002R00800230736	chr1	724991	9S31M10S	82	725073	724992	725074	V350256906L4C002R00800230736_chr1_724991	21	103	ggaa	ccat
V350256906L4C002R00800260579	chr1	767308	50M	189	767497	767309	767498	V350256906L4C002R00800260579_chr1_767308	69	68	AAAA	GGCG
V350256906L4C002R00800303071	chr1	861863	50M	111	861974	861864	861975	V350256906L4C002R00800303071_chr1_861863	32	34	GCCA	CCGA
V350256906L4C002R00800583708	chr1	86330	50M	165	86495	86331	86496	V350256906L4C002R00800583708_chr1_86330	70	0	gact	gcaa
V350256906L4C002R00800809738	chr1	662645	50M	171	662816	662646	662817	V350256906L4C002R00800809738_chr1_662645	0	0	CGTG	GTTG
V350256906L4C002R00800904649	chr1	962061	50M	170	962231	962062	962232	V350256906L4C002R00800904649_chr1_962061	42	80	CCCC	CTCC
V350256906L4C002R00801356963	chr1	1359221	50M	169	1359390	1359222	1359391	V350256906L4C002R00801356963_chr1_1359221	44	37	gttt	cgag
V350256906L4C002R00900147415	chr1	786738	50M	166	786904	786739	786905	V350256906L4C002R00900147415_chr1_786738	0	22	GCAG	CAGA
V350256906L4C002R00900157816	chr1	547792	50M	201	547993	547793	547994	V350256906L4C002R00900157816_chr1_547792	118	51	TGTG	ggTT
V350256906L4C002R00900158854	chr1	747979	50M	167	748146	747980	748147	V350256906L4C002R00900158854_chr1_747979	25	5	tgaa	ctca
V350256906L4C002R00900464837	chr1	39366	50M	179	39545	39367	39546	V350256906L4C002R00900464837_chr1_39366	296	218	ttag	caac
V350256906L4C002R00900537756	chr1	339250	50M	192	339442	339251	339443	V350256906L4C002R00900537756_chr1_339250	30	59	ggca	agaa
V350256906L4C002R00901107726	chr1	724927	50M	169	725096	724928	725097	V350256906L4C002R00901107726_chr1_724927	0	126	gaat	attc
V350256906L4C002R00901364780	chr1	150898	50M	167	151065	150899	151066	V350256906L4C002R00901364780_chr1_150898	10	7	ccat	ggct
V350256906L4C002R01000048737	chr1	725067	50M	111	725178	725068	725179	V350256906L4C002R01000048737_chr1_725067	97	91	gaat	cctt
V350256906L4C002R01000105024	chr1	988403	50M	177	988580	988404	988581	V350256906L4C002R01000105024_chr1_988403	68	65	gtgt	CAGA
V350256906L4C002R01000130572	chr1	832464	50M	191	832655	832465	832656	V350256906L4C002R01000130572_chr1_832464	37	41	ggca	ccaa
V350256906L4C002R01000136091	chr1	704946	50M	171	705117	704947	705118	V350256906L4C002R01000136091_chr1_704946	56	78	cagt	caac
V350256906L4C002R01000188626	chr1	777594	50M	189	777783	777595	777784	V350256906L4C002R01000188626_chr1_777594	109	48	CCCA	CAAA
V350256906L4C002R01000244346	chr1	14935	50M	158	15093	14936	15094	V350256906L4C002R01000244346_chr1_14935	239	81	GCTG	ACCG
V350256906L4C002R01000298809	chr1	241288	50M	138	241426	241289	241427	V350256906L4C002R01000298809_chr1_241288	45	46	aagt	CCCT
V350256906L4C002R01000425569	chr1	62646	50M	165	62811	62647	62812	V350256906L4C002R01000425569_chr1_62646	59	94	CTTG	TTAA
V350256906L4C002R01100185418	chr1	1287264	50M	136	1287400	1287265	1287401	V350256906L4C002R01100185418_chr1_1287264	64	40	ATGT	ACCC
V350256906L4C002R01100292387	chr1	724182	50M	146	724328	724183	724329	V350256906L4C002R01100292387_chr1_724182	58	21	gaat	ccac
V350256906L4C002R01100489059	chr1	1227392	50M	198	1227590	1227393	1227591	V350256906L4C002R01100489059_chr1_1227392	44	47	AGCT	CCTG
V350256906L4C002R01100607437	chr1	725893	17S33M	178	726071	725894	726072	V350256906L4C002R01100607437_chr1_725893	0	146	AATG	attc
V350256906L4C002R01100673705	chr1	453246	50M	159	453405	453247	453406	V350256906L4C002R01100673705_chr1_453246	61	74	ccaa	aaaa
V350256906L4C002R01100931147	chr1	723941	50M	162	724103	723942	724104	V350256906L4C002R01100931147_chr1_723941	7	0	GGAC	caat
V350256906L4C002R01101139247	chr1	169563	50M	166	169729	169564	169730	V350256906L4C002R01101139247_chr1_169563	148	6	ggag	GGGG
V350256906L4C002R01101321419	chr1	56598	50M	165	56763	56599	56764	V350256906L4C002R01101321419_chr1_56598	32	27	TGTT	GGTG
V350256906L4C002R01200673323	chr1	122821	50M	178	122999	122822	123000	V350256906L4C002R01200673323_chr1_122821	57	68	CCAC	GCTA
V350256906L4C002R01200752678	chr1	916375	50M	172	916547	916376	916548	V350256906L4C002R01200752678_chr1_916375	77	45	TCAC	ATGG
V350256906L4C002R01200770292	chr1	124811	50M	117	124928	124812	124929	V350256906L4C002R01200770292_chr1_124811	243	126	actc	CCCC
V350256906L4C002R01200793890	chr1	253761	50M	170	253931	253762	253932	V350256906L4C002R01200793890_chr1_253761	47	56	ATAA	gtcc
V350256906L4C002R01200899278	chr1	616912	50M	157	617069	616913	617070	V350256906L4C002R01200899278_chr1_616912	160	167	ctaa	cctt
V350256906L4C002R01200946679	chr1	725078	4S46M	100	725178	725079	725179	V350256906L4C002R01200946679_chr1_725078	108	91	aatg	cctt
V350256906L4C002R01201013796	chr1	327735	50M	172	327907	327736	327908	V350256906L4C002R01201013796_chr1_327735	205	151	GCAG	CAGG
V350256906L4C002R01300031073	chr1	1003832	50M	192	1004024	1003833	1004025	V350256906L4C002R01300031073_chr1_1003832	213	36	CCTT	CGGC
V350256906L4C002R01300139909	chr1	1254259	50M	182	1254441	1254260	1254442	V350256906L4C002R01300139909_chr1_1254259	0	169	CACA	CTTA
V350256906L4C002R01300399937	chr1	726700	20M5I22M3S	239	726939	726701	726940	V350256906L4C002R01300399937_chr1_726700	51	56	gaat	attc
V350256906L4C002R01300444417	chr1	1427450	50M	170	1427620	1427451	1427621	V350256906L4C002R01300444417_chr1_1427450	125	65	cagc	gctg
V350256906L4C002R01300463452	chr1	18061	50M	200	18261	18062	18262	V350256906L4C002R01300463452_chr1_18061	22	58	CCTG	CCAT
V350256906L4C002R01300555668	chr1	54279	50M	176	54455	54280	54456	V350256906L4C002R01300555668_chr1_54279	67	53	TTGA	ATTA
V350256906L4C002R01300769625	chr1	459458	50M	163	459621	459459	459622	V350256906L4C002R01300769625_chr1_459458	105	0	CCCT	AGAA
V350256906L4C002R01300842992	chr1	76383	50M	128	76511	76384	76512	V350256906L4C002R01300842992_chr1_76383	161	201	taga	ttcc
V350256906L4C002R01300907199	chr1	234986	50M	163	235149	234987	235150	V350256906L4C002R01300907199_chr1_234986	115	204	tgaa	gcta
V350256906L4C002R01300939924	chr1	353149	50M	182	353331	353150	353332	V350256906L4C002R01300939924_chr1_353149	98	252	gctt	gcga
V350256906L4C002R01301114486	chr1	918579	50M	172	918751	918580	918752	V350256906L4C002R01301114486_chr1_918579	59	61	CCAG	cgta
V350256906L4C002R01301164686	chr1	329506	50M	215	329721	329507	329722	V350256906L4C002R01301164686_chr1_329506	110	42	CCCC	CAGA
V350256906L4C002R01400043727	chr1	965873	50M	243	966116	965874	966117	V350256906L4C002R01400043727_chr1_965873	28	0	CAGC	caca
V350256906L4C002R01400056016	chr1	37514	50M	190	37704	37515	37705	V350256906L4C002R01400056016_chr1_37514	95	285	CTGA	CAGG
V350256906L4C002R01400316496	chr1	25253	50M	166	25419	25254	25420	V350256906L4C002R01400316496_chr1_25253	42	208	AGAA	GCCT
V350256906L4C002R01400702374	chr1	415899	50M	232	416131	415900	416132	V350256906L4C002R01400702374_chr1_415899	82	22	CAAA	GGTA
V350256906L4C002R01401083437	chr1	1237700	50M	167	1237867	1237701	1237868	V350256906L4C002R01401083437_chr1_1237700	96	161	CCAC	CCCT
V350256906L4C002R01500100990	chr1	1352174	50M	169	1352343	1352175	1352344	V350256906L4C002R01500100990_chr1_1352174	7	0	tgta	ctcc
V350256906L4C002R01500173286	chr1	1249228	50M	149	1249377	1249229	1249378	V350256906L4C002R01500173286_chr1_1249228	53	7	GCTT	GGGT
V350256906L4C002R01500491024	chr1	1181750	50M	149	1181899	1181751	1181900	V350256906L4C002R01500491024_chr1_1181750	68	36	CTCA	CCAA
V350256906L4C002R01500870112	chr1	789196	50M	181	789377	789197	789378	V350256906L4C002R01500870112_chr1_789196	84	262	CATG	TATG
V350256906L4C002R01501226268	chr1	990976	50M	195	991171	990977	991172	V350256906L4C002R01501226268_chr1_990976	8	3	CCCT	GCTC
V350256906L4C002R01600176466	chr1	1184376	50M	155	1184531	1184377	1184532	V350256906L4C002R01600176466_chr1_1184376	90	245	CGCC	CCCG
V350256906L4C002R01600494013	chr1	89945	50M	179	90124	89946	90125	V350256906L4C002R01600494013_chr1_89945	117	4	gata	CCAG
V350256906L4C002R01600890651	chr1	561698	50M	158	561856	561699	561857	V350256906L4C002R01600890651_chr1_561698	21	38	CCTC	CCCA
V350256906L4C002R01700001545	chr1	333019	50M	179	333198	333020	333199	V350256906L4C002R01700001545_chr1_333019	34	42	ggtg	cctg
V350256906L4C002R01700162816	chr1	92925	50M	144	93069	92926	93070	V350256906L4C002R01700162816_chr1_92925	66	51	GTCT	CAAT
V350256906L4C002R01700171746	chr1	1026800	50M	157	1026957	1026801	1026958	V350256906L4C002R01700171746_chr1_1026800	119	0	CTCC	CCCT
V350256906L4C002R01700790669	chr1	666593	50M	186	666779	666594	666780	V350256906L4C002R01700790669_chr1_666593	238	52	gcca	CCTT
V350256906L4C002R01700831803	chr1	21216	50M	173	21389	21217	21390	V350256906L4C002R01700831803_chr1_21216	71	62	TGCC	CCAG
V350256906L4C002R01700951063	chr1	1248385	50M	172	1248557	1248386	1248558	V350256906L4C002R01700951063_chr1_1248385	0	6	CTGC	TGAG
V350256906L4C002R01800501204	chr1	78934	50M	183	79117	78935	79118	V350256906L4C002R01800501204_chr1_78934	19	23	ggtc	cctc
V350256906L4C002R01800566775	chr1	847369	50M	171	847540	847370	847541	V350256906L4C002R01800566775_chr1_847369	9	28	acac	GGGC
V350256906L4C002R01800789993	chr1	1350461	50M	166	1350627	1350462	1350628	V350256906L4C002R01800789993_chr1_1350461	40	51	agtc	gacg
V350256906L4C002R01801007561	chr1	149467	50M	160	149627	149468	149628	V350256906L4C002R01801007561_chr1_149467	146	91	cagg	ggct
V350256906L4C002R01801088735	chr1	549617	50M	176	549793	549618	549794	V350256906L4C002R01801088735_chr1_549617	2	40	GTGG	CATG
V350256906L4C002R01900469059	chr1	593541	50M	163	593704	593542	593705	V350256906L4C002R01900469059_chr1_593541	3	25	TAAA	TCAG
V350256906L4C002R01900536315	chr1	746337	50M	165	746502	746338	746503	V350256906L4C002R01900536315_chr1_746337	69	44	GGTG	CAGT
V350256906L4C002R01901150375	chr1	106624	50M	170	106794	106625	106795	V350256906L4C002R01901150375_chr1_106624	34	38	CCCC	TACT
V350256906L4C002R02000044486	chr1	1052780	50M	185	1052965	1052781	1052966	V350256906L4C002R02000044486_chr1_1052780	0	2	GTCT	ACAC
V350256906L4C002R02000123270	chr1	147722	50M	203	147925	147723	147926	V350256906L4C002R02000123270_chr1_147722	133	42	tggt	actg
V350256906L4C002R02000291183	chr1	431389	50M	138	431527	431390	431528	V350256906L4C002R02000291183_chr1_431389	18	68	CCTC	ccag
V350256906L4C002R02000328804	chr1	1102336	50M	179	1102515	1102337	1102516	V350256906L4C002R02000328804_chr1_1102336	237	184	GCTG	CCAG
V350256906L4C002R02000967550	chr1	1296770	50M	169	1296939	1296771	1296940	V350256906L4C002R02000967550_chr1_1296770	71	59	caGC	GCAG
V350256906L4C002R02101017417	chr1	773778	50M	163	773941	773779	773942	V350256906L4C002R02101017417_chr1_773778	67	54	ggat	ctcc
V350256906L4C002R02101035982	chr1	702525	50M	150	702675	702526	702676	V350256906L4C002R02101035982_chr1_702525	0	38	AGCA	GCAG
V350256906L4C002R02101159945	chr1	726675	50M	142	726817	726676	726818	V350256906L4C002R02101159945_chr1_726675	26	0	ggaa	tcca
V350256906L4C002R02101230879	chr1	972637	50M	141	972778	972638	972779	V350256906L4C002R02101230879_chr1_972637	67	0	CCTC	ACGA
V350256906L4C002R02101253924	chr1	176851	50M	172	177023	176852	177024	V350256906L4C002R02101253924_chr1_176851	66	80	CCTA	ACCA
V350256906L4C002R02101315956	chr1	591291	50M	167	591458	591292	591459	V350256906L4C002R02101315956_chr1_591291	59	94	caaa	agta
V350256906L4C002R02200028793	chr1	393705	50M	169	393874	393706	393875	V350256906L4C002R02200028793_chr1_393705	26	127	agaa	tgtg
V350256906L4C002R02200072535	chr1	873140	50M	167	873307	873141	873308	V350256906L4C002R02200072535_chr1_873140	57	81	CCGT	AATT
V350256906L4C002R02200140380	chr1	597029	50M	181	597210	597030	597211	V350256906L4C002R02200140380_chr1_597029	55	45	gaat	AAGA
V350256906L4C002R02200360934	chr1	685550	50M	160	685710	685551	685711	V350256906L4C002R02200360934_chr1_685550	37	36	GTCT	CAAT
V350256906L4C002R02200558582	chr1	724941	23S27M	161	725102	724942	725103	V350256906L4C002R02200558582_chr1_724941	0	132	ggaa	catt
V350256906L4C002R02200817127	chr1	857837	50M	181	858018	857838	858019	V350256906L4C002R02200817127_chr1_857837	68	63	AGGC	CTGG
V350256906L4C002R02200849388	chr1	1391176	50M	148	1391324	1391177	1391325	V350256906L4C002R02200849388_chr1_1391176	29	53	CCTG	CCCA
V350256906L4C002R02200971776	chr1	562439	50M	202	562641	562440	562642	V350256906L4C002R02200971776_chr1_562439	84	66	tatg	TCCT
V350256906L4C002R02201063549	chr1	1093901	50M	161	1094062	1093902	1094063	V350256906L4C002R02201063549_chr1_1093901	59	62	CTGG	GGAA
V350256906L4C002R02300088285	chr1	807371	50M	171	807542	807372	807543	V350256906L4C002R02300088285_chr1_807371	0	0	TGTA	TATT
V350256906L4C002R02300436600	chr1	1001844	50M	172	1002016	1001845	1002017	V350256906L4C002R02300436600_chr1_1001844	62	65	gcct	TGTT
V350256906L4C002R02300573957	chr1	724529	18S21M11S	163	724692	724530	724693	V350256906L4C002R02300573957_chr1_724529	187	24	atgg	catt
V350256906L4C002R02300736164	chr1	700289	50M	171	700460	700290	700461	V350256906L4C002R02300736164_chr1_700289	31	120	cact	ctgg
V350256906L4C002R02301195937	chr1	1292662	50M	158	1292820	1292663	1292821	V350256906L4C002R02301195937_chr1_1292662	59	74	ggac	gcac
V350256906L4C002R02301232979	chr1	729811	50M	211	730022	729812	730023	V350256906L4C002R02301232979_chr1_729811	161	0	CCTG	tgca
V350256906L4C002R02400050350	chr1	45345	50M	249	45594	45346	45595	V350256906L4C002R02400050350_chr1_45345	202	0	gatg	taca
V350256906L4C002R02400062352	chr1	104795	50M	165	104960	104796	104961	V350256906L4C002R02400062352_chr1_104795	60	27	taat	acat
V350256906L4C002R02400320609	chr1	794477	50M	176	794653	794478	794654	V350256906L4C002R02400320609_chr1_794477	42	57	TGAG	CATC
V350256906L4C002R02400566221	chr1	675310	50M	271	675581	675311	675582	V350256906L4C002R02400566221_chr1_675310	50	0	TGAC	ccca
V350256906L4C002R02401033286	chr1	686793	50M	159	686952	686794	686953	V350256906L4C002R02401033286_chr1_686793	15	29	tctt	gcct
V350256906L4C002R02500162556	chr1	610257	50M	180	610437	610258	610438	V350256906L4C002R02500162556_chr1_610257	55	51	CTAG	ATGG
V350256906L4C002R02500277336	chr1	681992	50M	182	682174	681993	682175	V350256906L4C002R02500277336_chr1_681992	74	88	tcaa	ggat
V350256906L4C002R02500280118	chr1	37575	50M	174	37749	37576	37750	V350256906L4C002R02500280118_chr1_37575	156	330	ACCC	ccca
V350256906L4C002R02500489612	chr1	244230	50M	138	244368	244231	244369	V350256906L4C002R02500489612_chr1_244230	0	30	gagc	tgtg
V350256906L4C002R02500553970	chr1	338833	50M	166	338999	338834	339000	V350256906L4C002R02500553970_chr1_338833	0	144	TAGC	tcca
V350256906L4C002R02500911239	chr1	325878	50M	221	326099	325879	326100	V350256906L4C002R02500911239_chr1_325878	17	58	CCCA	CATG
V350256906L4C002R02501030050	chr1	381539	50M	200	381739	381540	381740	V350256906L4C002R02501030050_chr1_381539	98	65	aatg	atct
V350256906L4C002R02600008364	chr1	865996	50M	158	866154	865997	866155	V350256906L4C002R02600008364_chr1_865996	72	47	GCTA	TCCC
V350256906L4C002R02600022272	chr1	1061140	50M	133	1061273	1061141	1061274	V350256906L4C002R02600022272_chr1_1061140	123	0	CCCA	CCTG
V350256906L4C002R02600931364	chr1	231752	50M	165	231917	231753	231918	V350256906L4C002R02600931364_chr1_231752	262	97	agga	ttga
V350256906L4C002R02600949781	chr1	1040450	50M	153	1040603	1040451	1040604	V350256906L4C002R02600949781_chr1_1040450	4	3	ataa	GAAA
V350256906L4C002R02601222605	chr1	99061	48M2S	157	99218	99062	99219	V350256906L4C002R02601222605_chr1_99061	0	0	cttt	gctg
V350256906L4C002R02700833500	chr1	600418	50M	177	600595	600419	600596	V350256906L4C002R02700833500_chr1_600418	36	30	ttac	aaaa
V350256906L4C002R02700880943	chr1	443822	50M	109	443931	443823	443932	V350256906L4C002R02700880943_chr1_443822	49	26	GCTT	TGGA
V350256906L4C002R02700919304	chr1	150043	50M	168	150211	150044	150212	V350256906L4C002R02700919304_chr1_150043	24	75	CAAC	cact
V350256906L4C002R02800127618	chr1	1350566	50M	176	1350742	1350567	1350743	V350256906L4C002R02800127618_chr1_1350566	35	22	gcta	cctg
V350256906L4C002R02800429572	chr1	871703	50M	161	871864	871704	871865	V350256906L4C002R02800429572_chr1_871703	54	78	CCTA	CCTT
V350256906L4C002R02800604776	chr1	137227	50M	184	137411	137228	137412	V350256906L4C002R02800604776_chr1_137227	0	0	GCAA	CCCC
V350256906L4C002R02800685610	chr1	1329208	50M	183	1329391	1329209	1329392	V350256906L4C002R02800685610_chr1_1329208	9	0	CAGA	ggga
V350256906L4C002R02800911572	chr1	232281	50M	176	232457	232282	232458	V350256906L4C002R02800911572_chr1_232281	54	40	aatg	caga
V350256906L4C002R02801239937	chr1	342529	50M	188	342717	342530	342718	V350256906L4C002R02801239937_chr1_342529	69	130	TTGC	GTAA
V350256906L4C002R02801257413	chr1	250053	50M	134	250187	250054	250188	V350256906L4C002R02801257413_chr1_250053	33	68	ccag	gccg
V350256906L4C002R02801342724	chr1	113785	50M	159	113944	113786	113945	V350256906L4C002R02801342724_chr1_113785	76	21	cttg	ctgt
V350256906L4C002R02900442646	chr1	233770	50M	144	233914	233771	233915	V350256906L4C002R02900442646_chr1_233770	32	0	tcta	TTTT
V350256906L4C002R02900603193	chr1	1062459	50M	181	1062640	1062460	1062641	V350256906L4C002R02900603193_chr1_1062459	44	66	cctg	CGGC
V350256906L4C002R02901088878	chr1	681146	50M	127	681273	681147	681274	V350256906L4C002R02901088878_chr1_681146	45	22	CCCT	ATGT
V350256906L4C002R02901129054	chr1	158377	50M	142	158519	158378	158520	V350256906L4C002R02901129054_chr1_158377	104	246	TTGA	TGCG
V350256906L4C002R02901191829	chr1	1205574	50M	226	1205800	1205575	1205801	V350256906L4C002R02901191829_chr1_1205574	52	25	tata	GGGT
V350256906L4C002R02901302692	chr1	111704	50M	195	111899	111705	111900	V350256906L4C002R02901302692_chr1_111704	57	66	TGGG	ACTT
V350256906L4C002R03000154721	chr1	396622	50M	181	396803	396623	396804	V350256906L4C002R03000154721_chr1_396622	44	66	GCAA	CTTA
V350256906L4C002R03000172284	chr1	253407	50M	164	253571	253408	253572	V350256906L4C002R03000172284_chr1_253407	8	29	CACT	TATT
V350256906L4C002R03000236642	chr1	1078462	50M	169	1078631	1078463	1078632	V350256906L4C002R03000236642_chr1_1078462	0	0	CCCC	CCCC
V350256906L4C002R03000347690	chr1	1141588	50M	198	1141786	1141589	1141787	V350256906L4C002R03000347690_chr1_1141588	35	4	CCGC	GCTG
V350256906L4C002R03000494804	chr1	688186	50M	163	688349	688187	688350	V350256906L4C002R03000494804_chr1_688186	0	117	ctat	acag
V350256906L4C002R03000723154	chr1	1032229	50M	190	1032419	1032230	1032420	V350256906L4C002R03000723154_chr1_1032229	38	26	caag	tgcc
V350256906L4C002R03000764328	chr1	133406	50M	120	133526	133407	133527	V350256906L4C002R03000764328_chr1_133406	37	41	CCCA	CCCA
V350256906L4C002R03000911159	chr1	434442	50M	170	434612	434443	434613	V350256906L4C002R03000911159_chr1_434442	46	85	cctg	CCCA
V350256906L4C002R03000915866	chr1	772897	50M	160	773057	772898	773058	V350256906L4C002R03000915866_chr1_772897	52	0	ggaa	tacc
V350256906L4C002R03000925904	chr1	1172671	50M	192	1172863	1172672	1172864	V350256906L4C002R03000925904_chr1_1172671	0	0	AGTG	TCTG
V350256906L4C002R03100544782	chr1	781660	50M	188	781848	781661	781849	V350256906L4C002R03100544782_chr1_781660	68	71	ggcc	catt
V350256906L4C002R03100968010	chr1	361888	50M	187	362075	361889	362076	V350256906L4C002R03100968010_chr1_361888	85	55	TTAT	ACTA
V350256906L4C002R03101037535	chr1	157932	50M	168	158100	157933	158101	V350256906L4C002R03101037535_chr1_157932	0	0	TGGA	CTGT
V350256906L4C002R03101108186	chr1	783105	50M	166	783271	783106	783272	V350256906L4C002R03101108186_chr1_783105	77	14	CTGC	tgtg
V350256906L4C002R03101280861	chr1	875806	50M	156	875962	875807	875963	V350256906L4C002R03101280861_chr1_875806	93	80	GCAC	AGGC
V350256906L4C002R03200248056	chr1	1159761	50M	141	1159902	1159762	1159903	V350256906L4C002R03200248056_chr1_1159761	85	0	gcga	gatc
V350256906L4C002R03200396305	chr1	339984	50M	154	340138	339985	340139	V350256906L4C002R03200396305_chr1_339984	52	59	ACTG	acta
V350256906L4C002R03200444343	chr1	243930	50M	180	244110	243931	244111	V350256906L4C002R03200444343_chr1_243930	36	39	CTGA	GCTT
V350256906L4C002R03200544984	chr1	85448	50M	160	85608	85449	85609	V350256906L4C002R03200544984_chr1_85448	169	9	aaag	ctca
V350256906L4C002R03200578517	chr1	838811	50M	173	838984	838812	838985	V350256906L4C002R03200578517_chr1_838811	9	17	ccct	tctc
V350256906L4C002R03200913466	chr1	846275	50M	165	846440	846276	846441	V350256906L4C002R03200913466_chr1_846275	53	81	CAGG	CACT
V350256906L4C002R03300072088	chr1	1299054	50M	152	1299206	1299055	1299207	V350256906L4C002R03300072088_chr1_1299054	43	16	cact	caag
V350256906L4C002R03300395291	chr1	720533	50M	181	720714	720534	720715	V350256906L4C002R03300395291_chr1_720533	65	66	catc	taat
V350256906L4C002R03300483900	chr1	978458	50M	169	978627	978459	978628	V350256906L4C002R03300483900_chr1_978458	26	70	CCCT	GGCC
V350256906L4C002R03300637824	chr1	110098	50M	145	110243	110099	110244	V350256906L4C002R03300637824_chr1_110098	47	70	caaa	tatg
V350256906L4C002R03300665293	chr1	673678	50M	177	673855	673679	673856	V350256906L4C002R03300665293_chr1_673678	5	46	ACTA	tggg
V350256906L4C002R03300952439	chr1	1292996	50M	191	1293187	1292997	1293188	V350256906L4C002R03300952439_chr1_1292996	136	15	ggcc	ggca
V350256906L4C002R03301087223	chr1	728484	50M	143	728627	728485	728628	V350256906L4C002R03301087223_chr1_728484	191	295	tggt	aaca
V350256906L4C002R03400332472	chr1	465279	50M	159	465438	465280	465439	V350256906L4C002R03400332472_chr1_465279	0	0	CCAG	TGTA
V350256906L4C002R03400367599	chr1	387283	50M	167	387450	387284	387451	V350256906L4C002R03400367599_chr1_387283	5	172	gcct	cctg
V350256906L4C002R03400542662	chr1	135429	50M	176	135605	135430	135606	V350256906L4C002R03400542662_chr1_135429	8	133	GGCC	CCTC
V350256906L4C002R03400766157	chr1	726324	46M4S	184	726508	726325	726509	V350256906L4C002R03400766157_chr1_726324	33	31	gaat	tcca
V350256906L4C002R03500137981	chr1	891312	50M	179	891491	891313	891492	V350256906L4C002R03500137981_chr1_891312	145	0	TCCT	GTCA
V350256906L4C002R03500429307	chr1	1144970	50M	179	1145149	1144971	1145150	V350256906L4C002R03500429307_chr1_1144970	66	64	agtg	ccta
V350256906L4C002R03500592168	chr1	81993	50M	191	82184	81994	82185	V350256906L4C002R03500592168_chr1_81993	0	0	ggaa	ggaa
V350256906L4C002R03500933631	chr1	562267	50M	175	562442	562268	562443	V350256906L4C002R03500933631_chr1_562267	256	81	ccac	ataa
V350256906L4C002R03501022363	chr1	1347888	50M	146	1348034	1347889	1348035	V350256906L4C002R03501022363_chr1_1347888	62	43	caaa	aggt
V350256906L4C002R03501122427	chr1	1265970	50M	184	1266154	1265971	1266155	V350256906L4C002R03501122427_chr1_1265970	33	28	GAGC	CTGG
V350256906L4C002R03600024578	chr1	649776	50M	161	649937	649777	649938	V350256906L4C002R03600024578_chr1_649776	36	39	CCTA	CAAC
V350256906L4C002R03600041276	chr1	30152	50M	161	30313	30153	30314	V350256906L4C002R03600041276_chr1_30152	38	39	agac	GCCA
V350256906L4C002R03600129752	chr1	1184227	50M	165	1184392	1184228	1184393	V350256906L4C002R03600129752_chr1_1184227	0	106	GGCT	CCCG
V350256906L4C002R03600493444	chr1	917243	50M	219	917462	917244	917463	V350256906L4C002R03600493444_chr1_917243	0	0	CGCC	CGGC
V350256906L4C002R03600600391	chr1	1312859	50M	180	1313039	1312860	1313040	V350256906L4C002R03600600391_chr1_1312859	32	12	ccaa	ccac
V350256906L4C002R03600637586	chr1	724206	4S29M17S	173	724379	724207	724380	V350256906L4C002R03600637586_chr1_724206	34	72	cgaa	tcca
V350256906L4C002R03601388678	chr1	1103697	50M	168	1103865	1103698	1103866	V350256906L4C002R03601388678_chr1_1103697	51	24	CCCA	CGGG
V350256906L4C002R03700649746	chr1	1134433	50M	165	1134598	1134434	1134599	V350256906L4C002R03700649746_chr1_1134433	0	10	CCAG	CCCA
V350256906L4C002R03700768422	chr1	1086566	50M	184	1086750	1086567	1086751	V350256906L4C002R03700768422_chr1_1086566	25	47	CCGA	AGCG
V350256906L4C002R03701073388	chr1	12269	50M	148	12417	12270	12418	V350256906L4C002R03701073388_chr1_12269	9	42	GCCG	CTGA
V350256906L4C002R03701298356	chr1	926003	50M	179	926182	926004	926183	V350256906L4C002R03701298356_chr1_926003	46	48	atgt	cttg
V350256906L4C002R03800335576	chr1	1318044	50M	111	1318155	1318045	1318156	V350256906L4C002R03800335576_chr1_1318044	187	76	CCCC	CCTC
V350256906L4C002R03800516918	chr1	870905	50M	162	871067	870906	871068	V350256906L4C002R03800516918_chr1_870905	59	70	GACC	TGTG
V350256906L4C002R03800813759	chr1	377755	50M	151	377906	377756	377907	V350256906L4C002R03800813759_chr1_377755	200	49	gcct	aagt
V350256906L4C002R03800848180	chr1	965773	50M	122	965895	965774	965896	V350256906L4C002R03800848180_chr1_965773	128	6	gcag	CATG
V350256906L4C002R03800949386	chr1	157297	50M	157	157454	157298	157455	V350256906L4C002R03800949386_chr1_157297	0	91	ctaa	ccac
V350256906L4C002R03801019446	chr1	778581	50M	172	778753	778582	778754	V350256906L4C002R03801019446_chr1_778581	14	0	ACTA	CCCC
V350256906L4C002R03900793985	chr1	726405	25S19M6S	191	726596	726406	726597	V350256906L4C002R03900793985_chr1_726405	6	4	aatg	catt
V350256906L4C002R03900838490	chr1	132951	50M	184	133135	132952	133136	V350256906L4C002R03900838490_chr1_132951	0	29	CTGA	CTGT
V350256906L4C002R03900924451	chr1	126977	50M	164	127141	126978	127142	V350256906L4C002R03900924451_chr1_126977	26	0	gaaa	aaaa
V350256906L4C002R03901180453	chr1	239175	50M	144	239319	239176	239320	V350256906L4C002R03901180453_chr1_239175	15	0	AGTG	TAAG
V350256906L4C002R03901210946	chr1	71554	50M	168	71722	71555	71723	V350256906L4C002R03901210946_chr1_71554	0	0	aatt	GTAG
V350256906L4C002R04000279152	chr1	737187	50M	195	737382	737188	737383	V350256906L4C002R04000279152_chr1_737187	212	114	GGGG	CCTG
V350256906L4C002R04000308337	chr1	1125765	50M	186	1125951	1125766	1125952	V350256906L4C002R04000308337_chr1_1125765	64	72	tcct	cctt
V350256906L4C002R04000353104	chr1	351150	50M	180	351330	351151	351331	V350256906L4C002R04000353104_chr1_351150	0	157	acaa	ACCT
V350256906L4C002R04000549156	chr1	163963	50M	165	164128	163964	164129	V350256906L4C002R04000549156_chr1_163963	0	41	ctac	ccga
V350256906L4C002R04000700953	chr1	421008	50M	199	421207	421009	421208	V350256906L4C002R04000700953_chr1_421008	31	29	GAGG	ACCT
V350256906L4C002R04000712922	chr1	1123621	50M	148	1123769	1123622	1123770	V350256906L4C002R04000712922_chr1_1123621	55	13	gatt	ccca
V350256906L4C002R04000829333	chr1	1316340	50M	170	1316510	1316341	1316511	V350256906L4C002R04000829333_chr1_1316340	74	244	CCCC	CCCA
V350256906L4C002R04001339195	chr1	908736	50M	163	908899	908737	908900	V350256906L4C002R04001339195_chr1_908736	129	161	GCCT	CCAG
V350256906L4C002R04100813880	chr1	687873	50M	154	688027	687874	688028	V350256906L4C002R04100813880_chr1_687873	49	54	tccc	caag
V350256906L4C002R04200595297	chr1	26759	50M	152	26911	26760	26912	V350256906L4C002R04200595297_chr1_26759	83	42	ggaa	agta
V350256906L4C002R04300788973	chr1	821496	50M	153	821649	821497	821650	V350256906L4C002R04300788973_chr1_821496	19	43	tgac	cccg
V350256906L4C002R04300847918	chr1	1162443	50M	165	1162608	1162444	1162609	V350256906L4C002R04300847918_chr1_1162443	220	86	CCAG	GCAG
V350256906L4C002R04301017752	chr1	1035208	31M2I17M	174	1035382	1035209	1035383	V350256906L4C002R04301017752_chr1_1035208	16	34	tgat	ggga
V350256906L4C002R04301121373	chr1	671168	50M	165	671333	671169	671334	V350256906L4C002R04301121373_chr1_671168	111	68	GAGA	TGTC
V350256906L4C002R04301263495	chr1	1223723	50M	137	1223860	1223724	1223861	V350256906L4C002R04301263495_chr1_1223723	6	0	cgtc	cggg
V350256906L4C002R04400276065	chr1	1398825	50M	152	1398977	1398826	1398978	V350256906L4C002R04400276065_chr1_1398825	91	18	CCTT	GGTC
V350256906L4C002R04400375671	chr1	88378	50M	179	88557	88379	88558	V350256906L4C002R04400375671_chr1_88378	34	32	ccca	agga
V350256906L4C002R04400414829	chr1	1431532	50M	108	1431640	1431533	1431641	V350256906L4C002R04400414829_chr1_1431532	29	30	TGTG	GACG
V350256906L4C002R04400582359	chr1	852743	50M	144	852887	852744	852888	V350256906L4C002R04400582359_chr1_852743	133	0	TTCT	TCTG
V350256906L4C002R04400918333	chr1	246719	50M	159	246878	246720	246879	V350256906L4C002R04400918333_chr1_246719	73	51	CCAT	AGGT
V350256906L4C002R04401370976	chr1	1390656	50M	203	1390859	1390657	1390860	V350256906L4C002R04401370976_chr1_1390656	0	15	AAAA	GGAG
V350256906L4C002R04501048641	chr1	988703	50M	160	988863	988704	988864	V350256906L4C002R04501048641_chr1_988703	19	174	GGTG	CCCG
V350256906L4C002R04501275142	chr1	1264497	50M	187	1264684	1264498	1264685	V350256906L4C002R04501275142_chr1_1264497	56	48	GGTC	GTCC
V350256906L4C002R04600800473	chr1	828539	50M	180	828719	828540	828720	V350256906L4C002R04600800473_chr1_828539	56	74	aaca	actg
V350256906L4C002R04601138593	chr1	1350192	50M	171	1350363	1350193	1350364	V350256906L4C002R04601138593_chr1_1350192	24	8	ggtg	cagt
V350256906L4C002R04601147848	chr1	115945	50M	220	116165	115946	116166	V350256906L4C002R04601147848_chr1_115945	0	39	ttac	cgtt
V350256906L4C002R04601282413	chr1	841125	50M	159	841284	841126	841285	V350256906L4C002R04601282413_chr1_841125	0	35	cact	GGTC
V350256906L4C002R04700016125	chr1	567478	50M	123	567601	567479	567602	V350256906L4C002R04700016125_chr1_567478	260	226	CTAG	TGAT
V350256906L4C002R04700156176	chr1	127652	50M	196	127848	127653	127849	V350256906L4C002R04700156176_chr1_127652	163	0	tcca	ccca
V350256906L4C002R04700747173	chr1	1330240	50M	150	1330390	1330241	1330391	V350256906L4C002R04700747173_chr1_1330240	46	75	catt	ggca
V350256906L4C002R04700915017	chr1	871634	50M	132	871766	871635	871767	V350256906L4C002R04700915017_chr1_871634	64	0	CCTG	CCCC
V350256906L4C002R04701034472	chr1	1052829	50M	174	1053003	1052830	1053004	V350256906L4C002R04701034472_chr1_1052829	29	40	CCCT	CAAA
V350256906L4C002R04800235452	chr1	770387	50M	93	770480	770388	770481	V350256906L4C002R04800235452_chr1_770387	81	0	CCAC	agag
V350256906L4C002R04800428595	chr1	52806	50M	151	52957	52807	52958	V350256906L4C002R04800428595_chr1_52806	11	89	TGCC	CTCT
V350256906L4C002R04800613638	chr1	48702	50M	153	48855	48703	48856	V350256906L4C002R04800613638_chr1_48702	0	2	gaca	tctg
V350256906L4C002R04800874795	chr1	834115	50M	174	834289	834116	834290	V350256906L4C002R04800874795_chr1_834115	64	69	AAAC	CTTC
V350256906L4C002R04801377936	chr1	1201663	50M	171	1201834	1201664	1201835	V350256906L4C002R04801377936_chr1_1201663	15	33	TCTT	ccct
V350256906L4C002R04900473398	chr1	1316083	50M	144	1316227	1316084	1316228	V350256906L4C002R04900473398_chr1_1316083	7	12	CCTG	CCTC
V350256906L4C002R04900537321	chr1	228227	50M	175	228402	228228	228403	V350256906L4C002R04900537321_chr1_228227	127	47	TAAG	CCCT
V350256906L4C002R04900748324	chr1	644197	50M	179	644376	644198	644377	V350256906L4C002R04900748324_chr1_644197	54	42	aaag	ggca
V350256906L4C002R04901062051	chr1	439338	50M	180	439518	439339	439519	V350256906L4C002R04901062051_chr1_439338	29	0	CCCC	ACAC
V350256906L4C002R04901111643	chr1	650230	50M	183	650413	650231	650414	V350256906L4C002R04901111643_chr1_650230	0	0	catc	tata
V350256906L4C002R04901239736	chr1	540089	50M	152	540241	540090	540242	V350256906L4C002R04901239736_chr1_540089	67	48	tcac	tctt
V350256906L4C002R04901365001	chr1	1404205	50M	165	1404370	1404206	1404371	V350256906L4C002R04901365001_chr1_1404205	47	0	CGTG	gccC
V350256906L4C002R05000633027	chr1	67267	50M	177	67444	67268	67445	V350256906L4C002R05000633027_chr1_67267	69	57	CCAC	TGCT
V350256906L4C002R05001103793	chr1	1359012	50M	168	1359180	1359013	1359181	V350256906L4C002R05001103793_chr1_1359012	89	65	ccat	aaaa
V350256906L4C002R05001353241	chr1	831868	50M	160	832028	831869	832029	V350256906L4C002R05001353241_chr1_831868	0	18	acca	catg
V350256906L4C002R05100192880	chr1	118935	50M	160	119095	118936	119096	V350256906L4C002R05100192880_chr1_118935	84	49	tgta	tcat
V350256906L4C002R05100246819	chr1	80210	50M	158	80368	80211	80369	V350256906L4C002R05100246819_chr1_80210	43	20	tggg	tcta
V350256906L4C002R05100440827	chr1	333947	50M	160	334107	333948	334108	V350256906L4C002R05100440827_chr1_333947	31	74	ggaa	TGAC
V350256906L4C002R05100726419	chr1	51616	50M	156	51772	51617	51773	V350256906L4C002R05100726419_chr1_51616	18	0	cagc	gcct
V350256906L4C002R05100792037	chr1	1222016	50M	165	1222181	1222017	1222182	V350256906L4C002R05100792037_chr1_1222016	54	43	TCTG	AGCA
V350256906L4C002R05100838559	chr1	658388	50M	198	658586	658389	658587	V350256906L4C002R05100838559_chr1_658388	71	33	CCAG	GAAG
V350256906L4C002R05100921083	chr1	161362	50M	184	161546	161363	161547	V350256906L4C002R05100921083_chr1_161362	92	24	tatt	agat
V350256906L4C002R05200325280	chr1	1365480	50M	187	1365667	1365481	1365668	V350256906L4C002R05200325280_chr1_1365480	0	14	ctct	aaag
V350256906L4C002R05201075488	chr1	34736	50M	170	34906	34737	34907	V350256906L4C002R05201075488_chr1_34736	94	58	aatt	gaca
V350256906L4C002R05201180107	chr1	334549	50M	161	334710	334550	334711	V350256906L4C002R05201180107_chr1_334549	7	140	gacc	ggag
V350256906L4C002R05201275870	chr1	901313	50M	180	901493	901314	901494	V350256906L4C002R05201275870_chr1_901313	54	70	CGAG	ACCG
V350256906L4C002R05300026606	chr1	12865	50M	149	13014	12866	13015	V350256906L4C002R05300026606_chr1_12865	144	0	TGCG	CCAG
V350256906L4C002R05300368308	chr1	10083	8M1D42M	161	10244	10084	10245	V350256906L4C002R05300368308_chr1_10083	440	279	ccta	ttag
V350256906L4C002R05300520368	chr1	1247616	50M	176	1247792	1247617	1247793	V350256906L4C002R05300520368_chr1_1247616	0	0	GGCT	GGAG
V350256906L4C002R05300557606	chr1	427825	50M	168	427993	427826	427994	V350256906L4C002R05300557606_chr1_427825	131	19	GAGC	ccag
V350256906L4C002R05300559411	chr1	726825	24S22M4S	147	726972	726826	726973	V350256906L4C002R05300559411_chr1_726825	0	23	gaat	tcca
V350256906L4C002R05300886959	chr1	136023	50M	162	136185	136024	136186	V350256906L4C002R05300886959_chr1_136023	16	61	CCCA	GGAG
V350256906L4C002R05300888114	chr1	1330495	50M	182	1330677	1330496	1330678	V350256906L4C002R05300888114_chr1_1330495	0	0	TAAA	CTGA
V350256906L4C002R05301090258	chr1	915767	50M	168	915935	915768	915936	V350256906L4C002R05301090258_chr1_915767	59	13	CAGG	CCCC
V350256906L4C002R05400221322	chr1	621129	50M	160	621289	621130	621290	V350256906L4C002R05400221322_chr1_621129	21	54	GCAT	GTTC
V350256906L4C002R05400763833	chr1	1276962	12M4I34M	155	1277117	1276963	1277118	V350256906L4C002R05400763833_chr1_1276962	71	48	CACC	CCAC
V350256906L4C002R05400851601	chr1	576215	50M	176	576391	576216	576392	V350256906L4C002R05400851601_chr1_576215	82	250	tatt	tgaa
V350256906L4C002R05401089483	chr1	14263	50M	157	14420	14264	14421	V350256906L4C002R05401089483_chr1_14263	46	65	CCTC	AAGA
V350256906L4C002R05401124887	chr1	1203649	50M	148	1203797	1203650	1203798	V350256906L4C002R05401124887_chr1_1203649	48	52	CCAA	GCCC
V350256906L4C002R05500011737	chr1	578579	50M	153	578732	578580	578733	V350256906L4C002R05500011737_chr1_578579	4	15	CACA	TGGC
V350256906L4C002R05500132996	chr1	547608	50M	143	547751	547609	547752	V350256906L4C002R05500132996_chr1_547608	101	159	CGGT	TCTC
V350256906L4C002R05500215191	chr1	1279483	50M	177	1279660	1279484	1279661	V350256906L4C002R05500215191_chr1_1279483	35	43	GCAG	GGTG
V350256906L4C002R05500373303	chr1	21896	50M	165	22061	21897	22062	V350256906L4C002R05500373303_chr1_21896	129	0	CCTC	ggca
V350256906L4C002R05500965799	chr1	1149845	50M	177	1150022	1149846	1150023	V350256906L4C002R05500965799_chr1_1149845	67	63	GGAC	cctg
V350256906L4C002R05500988877	chr1	688584	50M	172	688756	688585	688757	V350256906L4C002R05500988877_chr1_688584	234	62	taca	acat
V350256906L4C002R05600484209	chr1	961875	50M	203	962078	961876	962079	V350256906L4C002R05600484209_chr1_961875	52	25	CTGA	CTTC
V350256906L4C002R05600607013	chr1	1267647	50M	232	1267879	1267648	1267880	V350256906L4C002R05600607013_chr1_1267647	76	135	CCCC	CAAG
V350256906L4C002R05600969535	chr1	725047	9S33M8S	122	725169	725048	725170	V350256906L4C002R05600969535_chr1_725047	77	100	gaat	tcca
V350256906L4C002R05601184847	chr1	14136	50M	175	14311	14137	14312	V350256906L4C002R05601184847_chr1_14136	0	0	CCAA	CAGT
V350256906L4C002R05601213131	chr1	1199269	50M	200	1199469	1199270	1199470	V350256906L4C002R05601213131_chr1_1199269	0	15	ggct	GCTG
V350256906L4C002R05700175197	chr1	874243	50M	178	874421	874244	874422	V350256906L4C002R05700175197_chr1_874243	49	27	AGGC	CCTG
V350256906L4C002R05700400219	chr1	1038898	50M	122	1039020	1038899	1039021	V350256906L4C002R05700400219_chr1_1038898	0	81	tgtc	agaa
V350256906L4C002R05700519216	chr1	700884	50M	166	701050	700885	701051	V350256906L4C002R05700519216_chr1_700884	50	97	ggct	ctgg
V350256906L4C002R05700573213	chr1	734847	50M	164	735011	734848	735012	V350256906L4C002R05700573213_chr1_734847	49	27	ATCT	agag
V350256906L4C002R05700920883	chr1	1318065	50M	184	1318249	1318066	1318250	V350256906L4C002R05700920883_chr1_1318065	166	0	ACAA	tgaa
V350256906L4C002R05701004234	chr1	59373	50M	174	59547	59374	59548	V350256906L4C002R05701004234_chr1_59373	68	65	TTTT	TACA
V350256906L4C002R05800195183	chr1	572832	50M	167	572999	572833	573000	V350256906L4C002R05800195183_chr1_572832	45	71	GGCC	ATGC
V350256906L4C002R05800584126	chr1	1324335	50M	178	1324513	1324336	1324514	V350256906L4C002R05800584126_chr1_1324335	95	59	atcc	ccaa
V350256906L4C002R05801087056	chr1	1230027	50M	168	1230195	1230028	1230196	V350256906L4C002R05801087056_chr1_1230027	25	46	CAGG	CTGA
V350256906L4C002R05801146277	chr1	828687	50M	110	828797	828688	828798	V350256906L4C002R05801146277_chr1_828687	43	0	ccac	ccct
V350256906L4C002R05900268658	chr1	1356793	50M	165	1356958	1356794	1356959	V350256906L4C002R05900268658_chr1_1356793	52	60	CTCC	CCTT
V350256906L4C002R05900684593	chr1	717429	50M	167	717596	717430	717597	V350256906L4C002R05900684593_chr1_717429	0	0	GATA	CTGT
V350256906L4C002R05900887709	chr1	1181889	50M	184	1182073	1181890	1182074	V350256906L4C002R05900887709_chr1_1181889	26	4	CGTA	CCAT
V350256906L4C002R05900940225	chr1	1131719	50M	181	1131900	1131720	1131901	V350256906L4C002R05900940225_chr1_1131719	9	51	caag	CCCT
V350256906L4C002R05901012745	chr1	917545	50M	152	917697	917546	917698	V350256906L4C002R05901012745_chr1_917545	57	0	CCAC	CGTC
V350256906L4C002R06000097861	chr1	1037967	50M	189	1038156	1037968	1038157	V350256906L4C002R06000097861_chr1_1037967	56	45	gcca	ccca
V350256906L4C002R06000333657	chr1	400549	50M	177	400726	400550	400727	V350256906L4C002R06000333657_chr1_400549	216	148	ccca	aaat
V350256906L4C002R06000763199	chr1	332203	50M	171	332374	332204	332375	V350256906L4C002R06000763199_chr1_332203	56	80	CGGG	acaa
V350256906L4C002R06000835987	chr1	1106414	50M	184	1106598	1106415	1106599	V350256906L4C002R06000835987_chr1_1106414	33	54	AACC	CCCC
V350256906L4C002R06100232567	chr1	853629	50M	173	853802	853630	853803	V350256906L4C002R06100232567_chr1_853629	0	0	CACC	CCCA
V350256906L4C002R06100512649	chr1	904170	50M	120	904290	904171	904291	V350256906L4C002R06100512649_chr1_904170	18	24	ggac	CCCC
V350256906L4C002R06100537857	chr1	522780	50M	154	522934	522781	522935	V350256906L4C002R06100537857_chr1_522780	52	14	tggt	cctg
V350256906L4C002R06100569639	chr1	1336269	50M	174	1336443	1336270	1336444	V350256906L4C002R06100569639_chr1_1336269	48	2	GACA	ACTG
V350256906L4C002R06100592775	chr1	573272	50M	161	573433	573273	573434	V350256906L4C002R06100592775_chr1_573272	0	5	gtaa	CCTA
V350256906L4C002R06100908160	chr1	144959	50M	176	145135	144960	145136	V350256906L4C002R06100908160_chr1_144959	425	249	caac	ccac
V350256906L4C002R06101122583	chr1	260697	50M	152	260849	260698	260850	V350256906L4C002R06101122583_chr1_260697	72	57	caca	CCTT
V350256906L4C002R06200459731	chr1	1169202	50M	184	1169386	1169203	1169387	V350256906L4C002R06200459731_chr1_1169202	60	42	CCCG	CCGG
V350256906L4C002R06200528429	chr1	930134	50M	169	930303	930135	930304	V350256906L4C002R06200528429_chr1_930134	0	15	gcct	CAAC
V350256906L4C002R06200548251	chr1	1397470	50M	207	1397677	1397471	1397678	V350256906L4C002R06200548251_chr1_1397470	12	0	CGCC	AAAA
V350256906L4C002R06201049392	chr1	883576	50M	156	883732	883577	883733	V350256906L4C002R06201049392_chr1_883576	64	58	CCAG	CCCT
V350256906L4C002R06201148902	chr1	471204	50M	151	471355	471205	471356	V350256906L4C002R06201148902_chr1_471204	0	145	GGAT	TACA
V350256906L4C002R06300132471	chr1	1249166	50M	159	1249325	1249167	1249326	V350256906L4C002R06300132471_chr1_1249166	0	1	CTCA	CTGA
V350256906L4C002R06300475395	chr1	610510	50M	170	610680	610511	610681	V350256906L4C002R06300475395_chr1_610510	0	0	AACC	AAAG
V350256906L4C002R06300571633	chr1	930891	50M	147	931038	930892	931039	V350256906L4C002R06300571633_chr1_930891	22	64	ttTT	CCCT
V350256906L4C002R06300621216	chr1	579810	50M	159	579969	579811	579970	V350256906L4C002R06300621216_chr1_579810	186	27	TCCT	GGAT
V350256906L4C002R06300976325	chr1	694100	50M	177	694277	694101	694278	V350256906L4C002R06300976325_chr1_694100	0	0	tgtg	TGAA
V350256906L4C002R06301182252	chr1	1198037	50M	200	1198237	1198038	1198238	V350256906L4C002R06301182252_chr1_1198037	38	4	TGCT	CTTC
V350256906L4C002R06400147969	chr1	663687	50M	161	663848	663688	663849	V350256906L4C002R06400147969_chr1_663687	56	55	GGAG	CAGG
V350256906L4C002R06400234646	chr1	1304114	50M	208	1304322	1304115	1304323	V350256906L4C002R06400234646_chr1_1304114	98	29	ttaa	cctc
V350256906L4C002R06400257061	chr1	384277	50M	163	384440	384278	384441	V350256906L4C002R06400257061_chr1_384277	2	165	ggtt	cgtg
V350256906L4C002R06400327656	chr1	1213464	50M	157	1213621	1213465	1213622	V350256906L4C002R06400327656_chr1_1213464	163	6	agat	gacg
V350256906L4C002R06400403287	chr1	1123511	50M	162	1123673	1123512	1123674	V350256906L4C002R06400403287_chr1_1123511	9	56	ggca	tgaa
V350256906L4C002R06400492209	chr1	1294285	50M	168	1294453	1294286	1294454	V350256906L4C002R06400492209_chr1_1294285	0	0	CCCA	CGGG
V350256906L4C002R06400518286	chr1	1346344	50M	172	1346516	1346345	1346517	V350256906L4C002R06400518286_chr1_1346344	45	47	ccag	caag
V350256906L4C002R06400877013	chr1	1328495	50M	142	1328637	1328496	1328638	V350256906L4C002R06400877013_chr1_1328495	36	43	GCCA	TATA
V350256906L4C002R06500238655	chr1	1142168	50M	208	1142376	1142169	1142377	V350256906L4C002R06500238655_chr1_1142168	0	205	CTAT	CCCC
V350256906L4C002R06500289767	chr1	583904	50M	150	584054	583905	584055	V350256906L4C002R06500289767_chr1_583904	266	123	CCCA	CAGG
V350256906L4C002R06500298766	chr1	865475	50M	124	865599	865476	865600	V350256906L4C002R06500298766_chr1_865475	0	61	ctcc	CCTT
V350256906L4C002R06500560643	chr1	126445	50M	173	126618	126446	126619	V350256906L4C002R06500560643_chr1_126445	101	60	tttc	tgtt
V350256906L4C002R06501001913	chr1	1301324	50M	222	1301546	1301325	1301547	V350256906L4C002R06501001913_chr1_1301324	0	50	TGAT	actc
V350256906L4C002R06501357523	chr1	52243	50M	169	52412	52244	52413	V350256906L4C002R06501357523_chr1_52243	15	184	CCGC	CTGA
V350256906L4C002R06600367046	chr1	37922	50M	226	38148	37923	38149	V350256906L4C002R06600367046_chr1_37922	199	0	GGTC	cctc
V350256906L4C002R06600493167	chr1	168287	50M	180	168467	168288	168468	V350256906L4C002R06600493167_chr1_168287	0	0	AGAA	CACA
V350256906L4C002R06600906657	chr1	905017	27M2D23M	185	905202	905018	905203	V350256906L4C002R06600906657_chr1_905017	52	48	tgta	tcca
V350256906L4C002R06601323913	chr1	264869	50M	158	265027	264870	265028	V350256906L4C002R06601323913_chr1_264869	87	0	gctt	acat
V350256906L4C002R06601374007	chr1	251970	50M	169	252139	251971	252140	V350256906L4C002R06601374007_chr1_251970	16	101	tcta	CTAA
V350256906L4C002R06700118504	chr1	536799	50M	188	536987	536800	536988	V350256906L4C002R06700118504_chr1_536799	408	596	cact	cgtg
V350256906L4C002R06700485896	chr1	722751	50M	176	722927	722752	722928	V350256906L4C002R06700485896_chr1_722751	29	48	agcc	gggt
V350256906L4C002R06700641380	chr1	1067346	50M	114	1067460	1067347	1067461	V350256906L4C002R06700641380_chr1_1067346	92	0	TGAA	TTGT
V350256906L4C002R06700664675	chr1	1405498	50M	167	1405665	1405499	1405666	V350256906L4C002R06700664675_chr1_1405498	2	0	cccg	caaa
V350256906L4C002R06700999596	chr1	113256	50M	189	113445	113257	113446	V350256906L4C002R06700999596_chr1_113256	115	42	ACAT	TAGC
V350256906L4C002R06701269114	chr1	726304	46M4S	192	726496	726305	726497	V350256906L4C002R06701269114_chr1_726304	13	19	gaat	catt
V350256906L4C002R06800042465	chr1	564722	50M	175	564897	564723	564898	V350256906L4C002R06800042465_chr1_564722	0	0	TATG	cgat
V350256906L4C002R06800317339	chr1	636639	50M	173	636812	636640	636813	V350256906L4C002R06800317339_chr1_636639	19	37	atga	aaag
V350256906L4C002R06801397290	chr1	1198805	50M	166	1198971	1198806	1198972	V350256906L4C002R06801397290_chr1_1198805	25	76	GCAA	TGTT
V350256906L4C002R06900221710	chr1	789310	50M	174	789484	789311	789485	V350256906L4C002R06900221710_chr1_789310	198	155	GGAA	TGCT
V350256906L4C002R06900240930	chr1	536283	50M	167	536450	536284	536451	V350256906L4C002R06900240930_chr1_536283	42	59	ACCT	TGAT
V350256906L4C002R06900296825	chr1	368362	50M	194	368556	368363	368557	V350256906L4C002R06900296825_chr1_368362	6	18	AGGC	CTTT
V350256906L4C002R06900475608	chr1	632438	50M	178	632616	632439	632617	V350256906L4C002R06900475608_chr1_632438	67	59	ggta	tagg
V350256906L4C002R06900587499	chr1	1313238	50M	160	1313398	1313239	1313399	V350256906L4C002R06900587499_chr1_1313238	30	2	tatt	CCTG
V350256906L4C002R06900773675	chr1	1400179	50M	149	1400328	1400180	1400329	V350256906L4C002R06900773675_chr1_1400179	24	52	attt	caac
V350256906L4C002R06900779004	chr1	760363	50M	166	760529	760364	760530	V350256906L4C002R06900779004_chr1_760363	87	158	CTCT	CCCA
V350256906L4C002R06901086096	chr1	421455	50M	178	421633	421456	421634	V350256906L4C002R06901086096_chr1_421455	0	0	CCTA	TCAG
V350256906L4C002R06901138728	chr1	125281	50M	202	125483	125282	125484	V350256906L4C002R06901138728_chr1_125281	16	218	CCCA	GGTA
V350256906L4C002R06901224808	chr1	809999	50M	185	810184	810000	810185	V350256906L4C002R06901224808_chr1_809999	39	93	ACAA	CAGA
V350256906L4C002R06901294895	chr1	126826	50M	193	127019	126827	127020	V350256906L4C002R06901294895_chr1_126826	50	68	aaat	TCAG
V350256906L4C002R07000121320	chr1	869089	33M1I16M	166	869255	869090	869256	V350256906L4C002R07000121320_chr1_869089	100	266	CTTA	ATCC
V350256906L4C002R07000316443	chr1	1309124	50M	164	1309288	1309125	1309289	V350256906L4C002R07000316443_chr1_1309124	32	45	CTGA	TGCA
V350256906L4C002R07000425824	chr1	724951	26M24S	147	725098	724952	725099	V350256906L4C002R07000425824_chr1_724951	0	128	ggaa	ccat
V350256906L4C002R07000568894	chr1	84967	50M	145	85112	84968	85113	V350256906L4C002R07000568894_chr1_84967	257	112	aatg	ctta
V350256906L4C002R07000600443	chr1	943913	50M	174	944087	943914	944088	V350256906L4C002R07000600443_chr1_943913	100	47	ttct	ctaa
V350256906L4C002R07000913872	chr1	1160168	50M	194	1160362	1160169	1160363	V350256906L4C002R07000913872_chr1_1160168	62	77	cctg	CCCC
V350256906L4C002R07001402121	chr1	76106	50M	153	76259	76107	76260	V350256906L4C002R07001402121_chr1_76106	31	37	tgct	ggct
V350256906L4C002R07100226189	chr1	598871	50M	165	599036	598872	599037	V350256906L4C002R07100226189_chr1_598871	0	60	accc	taga
V350256906L4C002R07100472222	chr1	1157303	50M	119	1157422	1157304	1157423	V350256906L4C002R07100472222_chr1_1157303	42	44	ctgg	TACA
V350256906L4C002R07100532488	chr1	108745	50M	201	108946	108746	108947	V350256906L4C002R07100532488_chr1_108745	112	46	GGAT	CTGA
V350256906L4C002R07100652374	chr1	386284	50M	154	386438	386285	386439	V350256906L4C002R07100652374_chr1_386284	372	364	cacg	ggta
V350256906L4C002R07100813253	chr1	643587	50M	175	643762	643588	643763	V350256906L4C002R07100813253_chr1_643587	44	73	gaag	gcgc
V350256906L4C002R07100843538	chr1	1268395	50M	180	1268575	1268396	1268576	V350256906L4C002R07100843538_chr1_1268395	0	5	AGCT	CCCA
V350256906L4C002R07101099664	chr1	19708	50M	162	19870	19709	19871	V350256906L4C002R07101099664_chr1_19708	0	72	GGTA	GGGT
V350256906L4C002R07101103098	chr1	1280301	50M	164	1280465	1280302	1280466	V350256906L4C002R07101103098_chr1_1280301	28	37	CCCC	AGCC
V350256906L4C002R07101310130	chr1	55167	50M	173	55340	55168	55341	V350256906L4C002R07101310130_chr1_55167	165	0	atca	ttac
V350256906L4C002R07200091674	chr1	443635	50M	172	443807	443636	443808	V350256906L4C002R07200091674_chr1_443635	54	64	GGAT	AACA
V350256906L4C002R07200144092	chr1	907910	50M	200	908110	907911	908111	V350256906L4C002R07200144092_chr1_907910	33	60	ctga	cagt
V350256906L4C002R07200145672	chr1	717291	50M	171	717462	717292	717463	V350256906L4C002R07200145672_chr1_717291	32	11	CAGA	TCCA
V350256906L4C002R07200194646	chr1	1009250	50M	179	1009429	1009251	1009430	V350256906L4C002R07200194646_chr1_1009250	57	42	CCAG	CCAC
V350256906L4C002R07200337004	chr1	706022	50M	154	706176	706023	706177	V350256906L4C002R07200337004_chr1_706022	0	41	CCTT	CCTT
V350256906L4C002R07200743927	chr1	108369	50M	236	108605	108370	108606	V350256906L4C002R07200743927_chr1_108369	55	0	cagg	tgat
V350256906L4C002R07200885577	chr1	835962	50M	205	836167	835963	836168	V350256906L4C002R07200885577_chr1_835962	57	91	ccaa	caat
V350256906L4C003R00100041148	chr1	1378240	50M	161	1378401	1378241	1378402	V350256906L4C003R00100041148_chr1_1378240	27	3	ACCA	cagt
V350256906L4C003R00100118973	chr1	150064	50M	188	150252	150065	150253	V350256906L4C003R00100118973_chr1_150064	3	56	CTCA	tgag
V350256906L4C003R00100476244	chr1	1099440	50M	172	1099612	1099441	1099613	V350256906L4C003R00100476244_chr1_1099440	55	60	ACCT	CTCC
V350256906L4C003R00100476275	chr1	11916	50M	130	12046	11917	12047	V350256906L4C003R00100476275_chr1_11916	0	30	TGTA	CCTG
V350256906L4C003R00101014992	chr1	1396285	50M	159	1396444	1396286	1396445	V350256906L4C003R00101014992_chr1_1396285	95	32	CAGA	CCAC
V350256906L4C003R00101284320	chr1	670085	50M	167	670252	670086	670253	V350256906L4C003R00101284320_chr1_670085	0	0	ccCA	TCTT
V350256906L4C003R00200279674	chr1	1413558	50M	213	1413771	1413559	1413772	V350256906L4C003R00200279674_chr1_1413558	24	63	gtag	CACA
V350256906L4C003R00200279675	chr1	1413558	50M	213	1413771	1413559	1413772	V350256906L4C003R00200279675_chr1_1413558	24	63	gtag	CACA
V350256906L4C003R00200427049	chr1	725789	38M12S	146	725935	725790	725936	V350256906L4C003R00200427049_chr1_725789	94	10	ctcg	ttcg
V350256906L4C003R00200499928	chr1	1030202	50M	157	1030359	1030203	1030360	V350256906L4C003R00200499928_chr1_1030202	59	52	agaa	gtct
V350256906L4C003R00201139533	chr1	73727	50M	178	73905	73728	73906	V350256906L4C003R00201139533_chr1_73727	60	36	gatg	acta
V350256906L4C003R00300110440	chr1	666559	50M	195	666754	666560	666755	V350256906L4C003R00300110440_chr1_666559	226	77	TTTT	CCCA
V350256906L4C003R00300172779	chr1	469363	50M	158	469521	469364	469522	V350256906L4C003R00300172779_chr1_469363	24	38	ttac	CCCA
V350256906L4C003R00300179091	chr1	724982	6S39M5S	169	725151	724983	725152	V350256906L4C003R00300179091_chr1_724982	12	118	gaat	agtc
V350256906L4C003R00300456543	chr1	978879	50M	169	979048	978880	979049	V350256906L4C003R00300456543_chr1_978879	72	0	GAGG	CACT
V350256906L4C003R00300472596	chr1	586566	50M	171	586737	586567	586738	V350256906L4C003R00300472596_chr1_586566	63	70	catc	ctaa
V350256906L4C003R00300569898	chr1	847791	50M	152	847943	847792	847944	V350256906L4C003R00300569898_chr1_847791	2	0	CATA	cctt
V350256906L4C003R00300635842	chr1	971415	50M	182	971597	971416	971598	V350256906L4C003R00300635842_chr1_971415	38	39	GGGG	ATCC
V350256906L4C003R00301068341	chr1	1417104	50M	162	1417266	1417105	1417267	V350256906L4C003R00301068341_chr1_1417104	0	17	TCAA	TGGA
V350256906L4C003R00301209704	chr1	748871	50M	175	749046	748872	749047	V350256906L4C003R00301209704_chr1_748871	0	1	CATT	GACT
V350256906L4C003R00301228414	chr1	1295742	50M	133	1295875	1295743	1295876	V350256906L4C003R00301228414_chr1_1295742	16	1	CCCT	CAGA
V350256906L4C003R00400040381	chr1	991910	50M	112	992022	991911	992023	V350256906L4C003R00400040381_chr1_991910	0	47	cctg	agag
V350256906L4C003R00400503089	chr1	784504	50M	175	784679	784505	784680	V350256906L4C003R00400503089_chr1_784504	58	33	GCAG	CCTA
V350256906L4C003R00400780988	chr1	1397218	50M	178	1397396	1397219	1397397	V350256906L4C003R00400780988_chr1_1397218	44	32	TGGA	CCTC
V350256906L4C003R00400972684	chr1	737246	50M	172	737418	737247	737419	V350256906L4C003R00400972684_chr1_737246	250	78	AGAG	TGAT
V350256906L4C003R00401058504	chr1	42210	46M3S	188	42398	42211	42399	V350256906L4C003R00401058504_chr1_42210	338	150	ccca	gatc
V350256906L4C003R00500236251	chr1	1389510	50M	213	1389723	1389511	1389724	V350256906L4C003R00500236251_chr1_1389510	40	63	GGCC	GCAG
V350256906L4C003R00500385095	chr1	726188	4S46M	164	726352	726189	726353	V350256906L4C003R00500385095_chr1_726188	61	59	gaat	ttcc
V350256906L4C003R00500506979	chr1	1383020	50M	158	1383178	1383021	1383179	V350256906L4C003R00500506979_chr1_1383020	0	35	cagg	aatg
V350256906L4C003R00500738549	chr1	1201411	50M	156	1201567	1201412	1201568	V350256906L4C003R00500738549_chr1_1201411	74	12	CCCC	CCCA
V350256906L4C003R00500812991	chr1	579945	50M	150	580095	579946	580096	V350256906L4C003R00500812991_chr1_579945	51	56	GCTT	TGTC
V350256906L4C003R00500904265	chr1	466137	50M	164	466301	466138	466302	V350256906L4C003R00500904265_chr1_466137	18	15	caaa	ctca
V350256906L4C003R00600179410	chr1	651810	50M	198	652008	651811	652009	V350256906L4C003R00600179410_chr1_651810	0	179	AGCT	AAGA
V350256906L4C003R00600656837	chr1	1221283	50M	215	1221498	1221284	1221499	V350256906L4C003R00600656837_chr1_1221283	41	19	TGCT	CGTC
V350256906L4C003R00600682426	chr1	855988	50M	168	856156	855989	856157	V350256906L4C003R00600682426_chr1_855988	23	39	TCTT	CCAA
V350256906L4C003R00600781912	chr1	816252	50M	227	816479	816253	816480	V350256906L4C003R00600781912_chr1_816252	0	37	agta	accc
V350256906L4C003R00601398438	chr1	888701	50M	154	888855	888702	888856	V350256906L4C003R00601398438_chr1_888701	60	59	CAGC	CAAG
V350256906L4C003R00700049963	chr1	1197007	25M1D25M	155	1197162	1197008	1197163	V350256906L4C003R00700049963_chr1_1197007	3	4	TGTC	ccag
V350256906L4C003R00700110532	chr1	139460	50M	121	139581	139461	139582	V350256906L4C003R00700110532_chr1_139460	166	45	AACT	CGCA
V350256906L4C003R00700249982	chr1	257617	50M	133	257750	257618	257751	V350256906L4C003R00700249982_chr1_257617	45	0	taca	CAAT
V350256906L4C003R00700311943	chr1	251110	50M	186	251296	251111	251297	V350256906L4C003R00700311943_chr1_251110	66	37	taat	ccat
V350256906L4C003R00700803331	chr1	38938	50M	173	39111	38939	39112	V350256906L4C003R00700803331_chr1_38938	51	41	ggaa	tctg
V350256906L4C003R00700866740	chr1	787983	50M	171	788154	787984	788155	V350256906L4C003R00700866740_chr1_787983	57	55	CTTT	CCCA
V350256906L4C003R00701070160	chr1	777565	50M	186	777751	777566	777752	V350256906L4C003R00701070160_chr1_777565	81	16	GAAA	TCCG
V350256906L4C003R00701170743	chr1	942093	50M	210	942303	942094	942304	V350256906L4C003R00701170743_chr1_942093	102	71	GACC	CTTG
V350256906L4C003R00800039639	chr1	249058	50M	165	249223	249059	249224	V350256906L4C003R00800039639_chr1_249058	80	33	ccaa	gcca
V350256906L4C003R00800291339	chr1	871448	50M	176	871624	871449	871625	V350256906L4C003R00800291339_chr1_871448	48	54	GACA	GGCG
V350256906L4C003R00800406937	chr1	116452	50M	174	116626	116453	116627	V350256906L4C003R00800406937_chr1_116452	0	0	gttt	ccac
V350256906L4C003R00800770689	chr1	988168	50M	147	988315	988169	988316	V350256906L4C003R00800770689_chr1_988168	129	0	ccat	ccca
V350256906L4C003R00800984690	chr1	159198	50M	153	159351	159199	159352	V350256906L4C003R00800984690_chr1_159198	30	183	GGAA	CTTC
V350256906L4C003R00801072643	chr1	263191	50M	204	263395	263192	263396	V350256906L4C003R00801072643_chr1_263191	171	0	tgac	taac
V350256906L4C003R00801205776	chr1	1175511	50M	186	1175697	1175512	1175698	V350256906L4C003R00801205776_chr1_1175511	39	44	CCCC	CCTT
V350256906L4C003R00801282290	chr1	162139	50M	170	162309	162140	162310	V350256906L4C003R00801282290_chr1_162139	48	55	ataa	ccct
V350256906L4C003R00801395612	chr1	95597	50M	163	95760	95598	95761	V350256906L4C003R00801395612_chr1_95597	157	0	CCAT	CTCA
V350256906L4C003R00900429979	chr1	147433	50M	178	147611	147434	147612	V350256906L4C003R00900429979_chr1_147433	99	244	Tcaa	catt
V350256906L4C003R00901078963	chr1	1133029	50M	158	1133187	1133030	1133188	V350256906L4C003R00901078963_chr1_1133029	46	53	CGCC	CTGT
V350256906L4C003R00901176606	chr1	1284988	50M	124	1285112	1284989	1285113	V350256906L4C003R00901176606_chr1_1284988	18	63	GGGC	CCCC
V350256906L4C003R01000071487	chr1	547274	50M	219	547493	547275	547494	V350256906L4C003R01000071487_chr1_547274	142	0	CCCG	tcac
V350256906L4C003R01000237551	chr1	928185	50M	173	928358	928186	928359	V350256906L4C003R01000237551_chr1_928185	46	62	TGGA	TGGA
V350256906L4C003R01000769693	chr1	1187703	50M	178	1187881	1187704	1187882	V350256906L4C003R01000769693_chr1_1187703	57	66	ccag	ccta
V350256906L4C003R01000780049	chr1	681453	50M	227	681680	681454	681681	V350256906L4C003R01000780049_chr1_681453	26	0	atcc	gcca
V350256906L4C003R01000845906	chr1	724971	29S21M	131	725102	724972	725103	V350256906L4C003R01000845906_chr1_724971	1	132	gaaa	catt
V350256906L4C003R01000857650	chr1	1425591	50M	169	1425760	1425592	1425761	V350256906L4C003R01000857650_chr1_1425591	13	22	CTCA	AGTC
V350256906L4C003R01000920242	chr1	565693	50M	183	565876	565694	565877	V350256906L4C003R01000920242_chr1_565693	38	29	CCAC	TGAT
V350256906L4C003R01100098094	chr1	1001704	50M	151	1001855	1001705	1001856	V350256906L4C003R01100098094_chr1_1001704	11	51	atat	ggtg
V350256906L4C003R01100294279	chr1	82297	50M	162	82459	82298	82460	V350256906L4C003R01100294279_chr1_82297	84	191	aaca	cttg
V350256906L4C003R01100468744	chr1	1263923	50M	181	1264104	1263924	1264105	V350256906L4C003R01100468744_chr1_1263923	55	42	AGGC	GATG
V350256906L4C003R01200205005	chr1	10545	50M	182	10727	10546	10728	V350256906L4C003R01200205005_chr1_10545	0	180	aatc	cgcg
V350256906L4C003R01200401124	chr1	134968	50M	153	135121	134969	135122	V350256906L4C003R01200401124_chr1_134968	122	202	AAGA	CCCC
V350256906L4C003R01200976959	chr1	925035	50M	165	925200	925036	925201	V350256906L4C003R01200976959_chr1_925035	58	81	ccct	tgac
V350256906L4C003R01201313236	chr1	164997	50M	185	165182	164998	165183	V350256906L4C003R01201313236_chr1_164997	61	74	CCCA	ccta
V350256906L4C003R01300123050	chr1	525246	50M	172	525418	525247	525419	V350256906L4C003R01300123050_chr1_525246	55	76	ttct	tcag
V350256906L4C003R01300300383	chr1	1121743	50M	128	1121871	1121744	1121872	V350256906L4C003R01300300383_chr1_1121743	189	61	acag	agca
V350256906L4C003R01300734585	chr1	1017737	50M	185	1017922	1017738	1017923	V350256906L4C003R01300734585_chr1_1017737	5	22	CCCT	AGAA
V350256906L4C003R01300750370	chr1	756920	50M	152	757072	756921	757073	V350256906L4C003R01300750370_chr1_756920	7	19	CACT	AGTG
V350256906L4C003R01400670644	chr1	113784	50M	175	113959	113785	113960	V350256906L4C003R01400670644_chr1_113784	75	36	actt	gtaa
V350256906L4C003R01400972668	chr1	913521	50M	187	913708	913522	913709	V350256906L4C003R01400972668_chr1_913521	26	132	CCTG	CGGG
V350256906L4C003R01401089407	chr1	1046052	50M	173	1046225	1046053	1046226	V350256906L4C003R01401089407_chr1_1046052	20	36	GTTC	CGCA
V350256906L4C003R01401210048	chr1	227920	50M	148	228068	227921	228069	V350256906L4C003R01401210048_chr1_227920	75	16	cctc	tatt
V350256906L4C003R01401337686	chr1	252921	50M	173	253094	252922	253095	V350256906L4C003R01401337686_chr1_252921	124	14	TAAA	TCTC
V350256906L4C003R01401405194	chr1	1351137	50M	180	1351317	1351138	1351318	V350256906L4C003R01401405194_chr1_1351137	69	94	ctca	tgcg
V350256906L4C003R01500064464	chr1	1148960	50M	167	1149127	1148961	1149128	V350256906L4C003R01500064464_chr1_1148960	83	55	CCCC	CGGT
V350256906L4C003R01501102227	chr1	1262891	50M	199	1263090	1262892	1263091	V350256906L4C003R01501102227_chr1_1262891	0	0	CGCA	GACA
V350256906L4C003R01600283846	chr1	1025090	50M	227	1025317	1025091	1025318	V350256906L4C003R01600283846_chr1_1025090	81	45	TCTC	AATC
V350256906L4C003R01600360877	chr1	616767	50M	166	616933	616768	616934	V350256906L4C003R01600360877_chr1_616767	15	181	ggca	ctgc
V350256906L4C003R01600418773	chr1	729199	50M	161	729360	729200	729361	V350256906L4C003R01600418773_chr1_729199	0	42	cttg	tcag
V350256906L4C003R01600464681	chr1	767146	50M	175	767321	767147	767322	V350256906L4C003R01600464681_chr1_767146	50	72	GATG	GGGA
V350256906L4C003R01600883838	chr1	883738	50M	176	883914	883739	883915	V350256906L4C003R01600883838_chr1_883738	64	49	GGGC	TCCT
V350256906L4C003R01600886377	chr1	136791	50M	176	136967	136792	136968	V350256906L4C003R01600886377_chr1_136791	309	193	GGGG	CCAC
V350256906L4C003R01601072661	chr1	1117302	50M	141	1117443	1117303	1117444	V350256906L4C003R01601072661_chr1_1117302	9	54	CCAC	CCAC
V350256906L4C003R01601244076	chr1	895276	50M	244	895520	895277	895521	V350256906L4C003R01601244076_chr1_895276	47	0	CCCG	CTCC
V350256906L4C003R01700271066	chr1	56343	50M	172	56515	56344	56516	V350256906L4C003R01700271066_chr1_56343	0	0	CACA	CATG
V350256906L4C003R01700414387	chr1	1245353	50M	175	1245528	1245354	1245529	V350256906L4C003R01700414387_chr1_1245353	57	53	CCTG	CCAG
V350256906L4C003R01700666225	chr1	148680	50M	168	148848	148681	148849	V350256906L4C003R01700666225_chr1_148680	38	68	tgca	cctc
V350256906L4C003R01700738738	chr1	748922	50M	196	749118	748923	749119	V350256906L4C003R01700738738_chr1_748922	21	35	CCCT	AGTT
V350256906L4C003R01700914778	chr1	246572	50M	176	246748	246573	246749	V350256906L4C003R01700914778_chr1_246572	30	45	ataa	TGTG
V350256906L4C003R01800348354	chr1	1105863	50M	155	1106018	1105864	1106019	V350256906L4C003R01800348354_chr1_1105863	120	275	ccct	TCCC
V350256906L4C003R01800574484	chr1	1124351	50M	159	1124510	1124352	1124511	V350256906L4C003R01800574484_chr1_1124351	0	13	taaa	cata
V350256906L4C003R01800711539	chr1	925047	50M	168	925215	925048	925216	V350256906L4C003R01800711539_chr1_925047	46	96	aaga	catg
V350256906L4C003R01801173774	chr1	718063	50M	151	718214	718064	718215	V350256906L4C003R01801173774_chr1_718063	69	95	gtta	gtac
V350256906L4C003R01801249561	chr1	634491	50M	166	634657	634492	634658	V350256906L4C003R01801249561_chr1_634491	0	60	taaa	ctgg
V350256906L4C003R01900012246	chr1	96822	50M	149	96971	96823	96972	V350256906L4C003R01900012246_chr1_96822	0	38	GACT	GCTT
V350256906L4C003R01900098602	chr1	124247	50M	183	124430	124248	124431	V350256906L4C003R01900098602_chr1_124247	0	0	caat	AAGG
V350256906L4C003R01900123245	chr1	1312439	50M	163	1312602	1312440	1312603	V350256906L4C003R01900123245_chr1_1312439	32	11	CCCA	TCAT
V350256906L4C003R01900504842	chr1	850215	50M	174	850389	850216	850390	V350256906L4C003R01900504842_chr1_850215	69	66	ctat	ctca
V350256906L4C003R01900682829	chr1	75325	50M	201	75526	75326	75527	V350256906L4C003R01900682829_chr1_75325	55	100	caat	tgtt
V350256906L4C003R01900813866	chr1	726315	50M	192	726507	726316	726508	V350256906L4C003R01900813866_chr1_726315	24	30	aatg	ccat
V350256906L4C003R01900888116	chr1	784923	50M	175	785098	784924	785099	V350256906L4C003R01900888116_chr1_784923	57	72	CTCT	cctt
V350256906L4C003R01900889029	chr1	893960	50M	155	894115	893961	894116	V350256906L4C003R01900889029_chr1_893960	46	58	ccct	ggga
V350256906L4C003R02000386278	chr1	800102	50M	194	800296	800103	800297	V350256906L4C003R02000386278_chr1_800102	54	54	CTAA	TGCC
V350256906L4C003R02000495487	chr1	345110	50M	185	345295	345111	345296	V350256906L4C003R02000495487_chr1_345110	21	15	caaa	agat
V350256906L4C003R02000504863	chr1	1398712	50M	172	1398884	1398713	1398885	V350256906L4C003R02000504863_chr1_1398712	137	32	CCCT	cagc
V350256906L4C003R02000883914	chr1	347584	50M	170	347754	347585	347755	V350256906L4C003R02000883914_chr1_347584	35	29	CTGG	tgaa
V350256906L4C003R02001019163	chr1	930841	50M	131	930972	930842	930973	V350256906L4C003R02001019163_chr1_930841	67	0	aaag	GGGT
V350256906L4C003R02001244983	chr1	893236	50M	166	893402	893237	893403	V350256906L4C003R02001244983_chr1_893236	72	51	ccct	cctc
V350256906L4C003R02100018016	chr1	608183	50M	198	608381	608184	608382	V350256906L4C003R02100018016_chr1_608183	119	176	acat	caat
V350256906L4C003R02100085544	chr1	1429039	50M	182	1429221	1429040	1429222	V350256906L4C003R02100085544_chr1_1429039	39	37	tgtc	cctc
V350256906L4C003R02100208256	chr1	367129	50M	203	367332	367130	367333	V350256906L4C003R02100208256_chr1_367129	283	80	ACCC	CCTC
V350256906L4C003R02100972602	chr1	670188	50M	178	670366	670189	670367	V350256906L4C003R02100972602_chr1_670188	50	63	CATC	gcct
V350256906L4C003R02101222197	chr1	1133413	50M	168	1133581	1133414	1133582	V350256906L4C003R02101222197_chr1_1133413	72	63	CCCC	GGGC
V350256906L4C003R02101265079	chr1	937256	50M	167	937423	937257	937424	V350256906L4C003R02101265079_chr1_937256	0	76	CTCT	CCCA
V350256906L4C003R02101343259	chr1	33841	50M	169	34010	33842	34011	V350256906L4C003R02101343259_chr1_33841	66	74	gcaa	acta
V350256906L4C003R02200126756	chr1	34658	50M	209	34867	34659	34868	V350256906L4C003R02200126756_chr1_34658	16	97	caaa	atgt
V350256906L4C003R02200278999	chr1	245125	50M	176	245301	245126	245302	V350256906L4C003R02200278999_chr1_245125	209	33	GTAA	GCAC
V350256906L4C003R02200451460	chr1	20701	50M	163	20864	20702	20865	V350256906L4C003R02200451460_chr1_20701	14	13	GGCA	CTCT
V350256906L4C003R02200673415	chr1	683389	50M	186	683575	683390	683576	V350256906L4C003R02200673415_chr1_683389	92	0	tatg	tctc
V350256906L4C003R02200683934	chr1	855511	50M	168	855679	855512	855680	V350256906L4C003R02200683934_chr1_855511	0	0	TGTG	TGTG
V350256906L4C003R02200892420	chr1	846764	50M	121	846885	846765	846886	V350256906L4C003R02200892420_chr1_846764	0	105	TGCT	CTTT
V350256906L4C003R02201222025	chr1	1429144	50M	155	1429299	1429145	1429300	V350256906L4C003R02201222025_chr1_1429144	0	23	gaat	ccct
V350256906L4C003R02201273082	chr1	888314	50M	155	888469	888315	888470	V350256906L4C003R02201273082_chr1_888314	46	38	CCCC	TGCC
V350256906L4C003R02300489438	chr1	1158648	50M	169	1158817	1158649	1158818	V350256906L4C003R02300489438_chr1_1158648	13	182	CGTT	AGAG
V350256906L4C003R02300544448	chr1	978502	50M	107	978609	978503	978610	V350256906L4C003R02300544448_chr1_978502	0	77	GTTC	CACA
V350256906L4C003R02301022001	chr1	953426	50M	158	953584	953427	953585	V350256906L4C003R02301022001_chr1_953426	13	171	gccg	tgtc
V350256906L4C003R02400046772	chr1	775323	50M	168	775491	775324	775492	V350256906L4C003R02400046772_chr1_775323	44	51	ggaa	taca
V350256906L4C003R02400376803	chr1	1236380	50M	171	1236551	1236381	1236552	V350256906L4C003R02400376803_chr1_1236380	51	23	cagg	tgag
V350256906L4C003R02400392010	chr1	851033	50M	187	851220	851034	851221	V350256906L4C003R02400392010_chr1_851033	0	0	AGGG	CGca
V350256906L4C003R02400422452	chr1	438198	50M	158	438356	438199	438357	V350256906L4C003R02400422452_chr1_438198	50	32	CCCC	GGCC
V350256906L4C003R02400570267	chr1	597948	50M	162	598110	597949	598111	V350256906L4C003R02400570267_chr1_597948	0	40	gacc	tcat
V350256906L4C003R02400988248	chr1	50826	50M	165	50991	50827	50992	V350256906L4C003R02400988248_chr1_50826	0	34	ACAA	CATT
V350256906L4C003R02401033212	chr1	765947	50M	150	766097	765948	766098	V350256906L4C003R02401033212_chr1_765947	10	107	ccta	catg
V350256906L4C003R02401063866	chr1	452399	50M	152	452551	452400	452552	V350256906L4C003R02401063866_chr1_452399	0	0	CCCT	CCAC
V350256906L4C003R02500396817	chr1	827926	50M	252	828178	827927	828179	V350256906L4C003R02500396817_chr1_827926	42	50	ctga	ggca
V350256906L4C003R02500422333	chr1	418822	50M	188	419010	418823	419011	V350256906L4C003R02500422333_chr1_418822	0	0	cctg	agtg
V350256906L4C003R02500711239	chr1	921441	37M1D13M	173	921614	921442	921615	V350256906L4C003R02500711239_chr1_921441	61	79	ccct	cctg
V350256906L4C003R02501224665	chr1	63948	50M	182	64130	63949	64131	V350256906L4C003R02501224665_chr1_63948	26	53	CCAT	AAAG
V350256906L4C003R02600150358	chr1	992774	50M	135	992909	992775	992910	V350256906L4C003R02600150358_chr1_992774	63	0	GGCC	cccg
V350256906L4C003R02600303236	chr1	853792	50M	176	853968	853793	853969	V350256906L4C003R02600303236_chr1_853792	0	15	CACG	TGAC
V350256906L4C003R02600702770	chr1	1409165	50M	158	1409323	1409166	1409324	V350256906L4C003R02600702770_chr1_1409165	32	51	cacc	AGGA
V350256906L4C003R02601149812	chr1	1118136	50M	174	1118310	1118137	1118311	V350256906L4C003R02601149812_chr1_1118136	17	58	ccaa	AGAT
V350256906L4C003R02700115578	chr1	65108	50M	152	65260	65109	65261	V350256906L4C003R02700115578_chr1_65108	0	139	CTAT	GGTG
V350256906L4C003R02700174927	chr1	1297161	50M	204	1297365	1297162	1297366	V350256906L4C003R02700174927_chr1_1297161	62	41	CCTA	CTTG
V350256906L4C003R02700192925	chr1	748611	50M	177	748788	748612	748789	V350256906L4C003R02700192925_chr1_748611	66	68	TTAA	TTTG
V350256906L4C003R02700257762	chr1	696246	50M	179	696425	696247	696426	V350256906L4C003R02700257762_chr1_696246	18	4	CCAT	TACT
V350256906L4C003R02700263401	chr1	113974	50M	165	114139	113975	114140	V350256906L4C003R02700263401_chr1_113974	51	20	acct	CTTA
V350256906L4C003R02700278453	chr1	99500	50M	177	99677	99501	99678	V350256906L4C003R02700278453_chr1_99500	69	41	ACAC	TGAC
V350256906L4C003R02700369296	chr1	617481	50M	153	617634	617482	617635	V350256906L4C003R02700369296_chr1_617481	32	17	actc	ggtg
V350256906L4C003R02700435119	chr1	625853	50M	181	626034	625854	626035	V350256906L4C003R02700435119_chr1_625853	47	55	TATG	tgca
V350256906L4C003R02700716400	chr1	37835	50M	168	38003	37836	38004	V350256906L4C003R02700716400_chr1_37835	286	118	cgtt	AGGG
V350256906L4C003R02701033854	chr1	130740	50M	165	130905	130741	130906	V350256906L4C003R02701033854_chr1_130740	64	29	aaaa	agtg
V350256906L4C003R02701068831	chr1	1261074	50M	127	1261201	1261075	1261202	V350256906L4C003R02701068831_chr1_1261074	57	34	CCAG	CCCA
V350256906L4C003R02701267172	chr1	721832	50M	158	721990	721833	721991	V350256906L4C003R02701267172_chr1_721832	54	59	ccaa	atga
V350256906L4C003R02800128530	chr1	521447	50M	271	521718	521448	521719	V350256906L4C003R02800128530_chr1_521447	356	85	ATTC	CTGG
V350256906L4C003R02800268051	chr1	455070	50M	163	455233	455071	455234	V350256906L4C003R02800268051_chr1_455070	29	116	CCCA	AAGC
V350256906L4C003R02800772606	chr1	58377	50M	196	58573	58378	58574	V350256906L4C003R02800772606_chr1_58377	0	173	AGAG	CTTT
V350256906L4C003R02900241226	chr1	994554	50M	168	994722	994555	994723	V350256906L4C003R02900241226_chr1_994554	0	9	CCAG	CCTG
V350256906L4C003R02900254326	chr1	864636	50M	153	864789	864637	864790	V350256906L4C003R02900254326_chr1_864636	0	22	CAGC	CCAG
V350256906L4C003R02901078812	chr1	1263504	50M	197	1263701	1263505	1263702	V350256906L4C003R02901078812_chr1_1263504	50	88	GCGA	CCAC
V350256906L4C003R03000038081	chr1	116829	50M	134	116963	116830	116964	V350256906L4C003R03000038081_chr1_116829	31	82	ctcc	aaca
V350256906L4C003R03000076192	chr1	766619	50M	164	766783	766620	766784	V350256906L4C003R03000076192_chr1_766619	38	48	cctt	CCTG
V350256906L4C003R03000082346	chr1	34527	50M	156	34683	34528	34684	V350256906L4C003R03000082346_chr1_34527	55	41	aggg	cctg
V350256906L4C003R03000125462	chr1	258094	50M	132	258226	258095	258227	V350256906L4C003R03000125462_chr1_258094	2	59	AGCA	gccc
V350256906L4C003R03000153263	chr1	1317152	50M	189	1317341	1317153	1317342	V350256906L4C003R03000153263_chr1_1317152	11	134	CACA	CCAG
V350256906L4C003R03000157292	chr1	1312738	50M	260	1312998	1312739	1312999	V350256906L4C003R03000157292_chr1_1312738	70	0	agtg	ctgg
V350256906L4C003R03000312413	chr1	15428	50M	150	15578	15429	15579	V350256906L4C003R03000312413_chr1_15428	5	155	GGCA	AGCT
V350256906L4C003R03000624808	chr1	350492	50M	166	350658	350493	350659	V350256906L4C003R03000624808_chr1_350492	75	56	catt	AAGG
V350256906L4C003R03000625437	chr1	158242	50M	158	158400	158243	158401	V350256906L4C003R03000625437_chr1_158242	0	127	ggtg	GAAA
V350256906L4C003R03001320797	chr1	1402982	50M	156	1403138	1402983	1403139	V350256906L4C003R03001320797_chr1_1402982	60	70	GGAG	CCCA
V350256906L4C003R03100135315	chr1	330884	50M	172	331056	330885	331057	V350256906L4C003R03100135315_chr1_330884	33	188	CCCC	CCCA
V350256906L4C003R03100409832	chr1	129303	50M	174	129477	129304	129478	V350256906L4C003R03100409832_chr1_129303	23	120	AAAC	ggtt
V350256906L4C003R03100502204	chr1	97122	50M	164	97286	97123	97287	V350256906L4C003R03100502204_chr1_97122	58	65	CTTC	TGTA
V350256906L4C003R03100749653	chr1	150462	50M	159	150621	150463	150622	V350256906L4C003R03100749653_chr1_150462	0	56	attt	CCAA
V350256906L4C003R03101118834	chr1	1215577	50M	155	1215732	1215578	1215733	V350256906L4C003R03101118834_chr1_1215577	243	88	gctt	cctg
V350256906L4C003R03200584094	chr1	1288045	50M	181	1288226	1288046	1288227	V350256906L4C003R03200584094_chr1_1288045	16	25	TTTC	TAGG
V350256906L4C003R03200705441	chr1	1126912	50M	163	1127075	1126913	1127076	V350256906L4C003R03200705441_chr1_1126912	0	10	atcc	ccct
V350256906L4C003R03200733086	chr1	1226672	50M	165	1226837	1226673	1226838	V350256906L4C003R03200733086_chr1_1226672	63	53	CCTG	GCCT
V350256906L4C003R03201050778	chr1	245034	50M	259	245293	245035	245294	V350256906L4C003R03201050778_chr1_245034	300	41	GGCA	CTCT
V350256906L4C003R03201073111	chr1	113118	50M	179	113297	113119	113298	V350256906L4C003R03201073111_chr1_113118	0	156	CTTA	ACCT
V350256906L4C003R03201240750	chr1	977213	50M	206	977419	977214	977420	V350256906L4C003R03201240750_chr1_977213	80	53	CCAG	GGTG
V350256906L4C003R03201305508	chr1	1343708	50M	175	1343883	1343709	1343884	V350256906L4C003R03201305508_chr1_1343708	0	150	TCGA	ggtg
V350256906L4C003R03300072824	chr1	74782	50M	195	74977	74783	74978	V350256906L4C003R03300072824_chr1_74782	343	148	ccca	tcta
V350256906L4C003R03300170298	chr1	667414	50M	182	667596	667415	667597	V350256906L4C003R03300170298_chr1_667414	20	0	ctag	tgag
V350256906L4C003R03300498149	chr1	1325609	50M	143	1325752	1325610	1325753	V350256906L4C003R03300498149_chr1_1325609	51	41	CCCA	GTTG
V350256906L4C003R03300778706	chr1	959173	50M	169	959342	959174	959343	V350256906L4C003R03300778706_chr1_959173	154	323	CCAG	CCCC
V350256906L4C003R03301248847	chr1	256286	50M	176	256462	256287	256463	V350256906L4C003R03301248847_chr1_256286	147	0	cccc	cgtt
V350256906L4C003R03301311202	chr1	1238212	50M	161	1238373	1238213	1238374	V350256906L4C003R03301311202_chr1_1238212	55	48	CCCC	CCCA
V350256906L4C003R03301383049	chr1	954485	50M	173	954658	954486	954659	V350256906L4C003R03301383049_chr1_954485	21	6	ctgc	CCTT
V350256906L4C003R03400341316	chr1	163330	50M	164	163494	163331	163495	V350256906L4C003R03400341316_chr1_163330	50	10	TATT	TAGC
V350256906L4C003R03400448116	chr1	46294	50M	164	46458	46295	46459	V350256906L4C003R03400448116_chr1_46294	30	78	CACT	cttt
V350256906L4C003R03400730466	chr1	994265	50M	166	994431	994266	994432	V350256906L4C003R03400730466_chr1_994265	69	87	CCGA	CCCC
V350256906L4C003R03400867053	chr1	350901	50M	174	351075	350902	351076	V350256906L4C003R03400867053_chr1_350901	0	40	taaa	tgta
V350256906L4C003R03401041693	chr1	659512	50M	179	659691	659513	659692	V350256906L4C003R03401041693_chr1_659512	40	11	GGAC	CAGA
V350256906L4C003R03401285844	chr1	737582	50M	165	737747	737583	737748	V350256906L4C003R03401285844_chr1_737582	16	9	CCCA	CCTG
V350256906L4C003R03401338551	chr1	20126	50M	171	20297	20127	20298	V350256906L4C003R03401338551_chr1_20126	195	24	ccgc	accc
V350256906L4C003R03500122980	chr1	236084	50M	172	236256	236085	236257	V350256906L4C003R03500122980_chr1_236084	44	12	TAAA	CAGT
V350256906L4C003R03500146772	chr1	799387	50M	177	799564	799388	799565	V350256906L4C003R03500146772_chr1_799387	61	68	CTGT	CCTG
V350256906L4C003R03500204782	chr1	55504	50M	179	55683	55505	55684	V350256906L4C003R03500204782_chr1_55504	47	72	ctcc	CTGG
V350256906L4C003R03500299176	chr1	37055	50M	168	37223	37056	37224	V350256906L4C003R03500299176_chr1_37055	21	26	ccca	ccag
V350256906L4C003R03500768518	chr1	153842	50M	179	154021	153843	154022	V350256906L4C003R03500768518_chr1_153842	23	74	ccta	caga
V350256906L4C003R03500803301	chr1	129613	50M	203	129816	129614	129817	V350256906L4C003R03500803301_chr1_129613	256	61	tgat	taca
V350256906L4C003R03501063941	chr1	67326	50M	161	67487	67327	67488	V350256906L4C003R03501063941_chr1_67326	11	14	CTTT	TACA
V350256906L4C003R03501099275	chr1	1251861	50M	169	1252030	1251862	1252031	V350256906L4C003R03501099275_chr1_1251861	53	71	cagt	cccg
V350256906L4C003R03501212147	chr1	648810	50M	178	648988	648811	648989	V350256906L4C003R03501212147_chr1_648810	99	217	CAAT	CAAA
V350256906L4C003R03600413884	chr1	554878	50M	175	555053	554879	555054	V350256906L4C003R03600413884_chr1_554878	68	77	CAGC	CCTG
V350256906L4C003R03600499662	chr1	1125954	50M	162	1126116	1125955	1126117	V350256906L4C003R03600499662_chr1_1125954	69	30	cgtg	agca
V350256906L4C003R03600715493	chr1	1110493	50M	176	1110669	1110494	1110670	V350256906L4C003R03600715493_chr1_1110493	55	53	ctaa	CAGA
V350256906L4C003R03600985843	chr1	171166	50M	176	171342	171167	171343	V350256906L4C003R03600985843_chr1_171166	216	40	cctg	AAGA
V350256906L4C003R03601198131	chr1	56610	50M	180	56790	56611	56791	V350256906L4C003R03601198131_chr1_56610	44	54	TCAA	AGAA
V350256906L4C003R03700201542	chr1	247684	50M	166	247850	247685	247851	V350256906L4C003R03700201542_chr1_247684	0	0	CCAG	ggct
V350256906L4C003R03700314384	chr1	1102941	50M	172	1103113	1102942	1103114	V350256906L4C003R03700314384_chr1_1102941	45	70	CGTG	ACTG
V350256906L4C003R03700360700	chr1	742660	50M	204	742864	742661	742865	V350256906L4C003R03700360700_chr1_742660	40	78	CACC	CCCA
V350256906L4C003R03700440527	chr1	132994	50M	152	133146	132995	133147	V350256906L4C003R03700440527_chr1_132994	0	40	ACCC	GGCT
V350256906L4C003R03700452049	chr1	1038592	50M	111	1038703	1038593	1038704	V350256906L4C003R03700452049_chr1_1038592	185	74	cggc	aatt
V350256906L4C003R03700687067	chr1	825890	50M	175	826065	825891	826066	V350256906L4C003R03700687067_chr1_825890	173	202	CCAC	ccag
V350256906L4C003R03700998102	chr1	555393	50M	162	555555	555394	555556	V350256906L4C003R03700998102_chr1_555393	9	0	tgga	AGCA
V350256906L4C003R03800112789	chr1	800120	50M	164	800284	800121	800285	V350256906L4C003R03800112789_chr1_800120	66	42	GGAC	CACT
V350256906L4C003R03800517079	chr1	1103924	50M	163	1104087	1103925	1104088	V350256906L4C003R03800517079_chr1_1103924	73	44	CTCA	CAGC
V350256906L4C003R03800569435	chr1	856506	50M	170	856676	856507	856677	V350256906L4C003R03800569435_chr1_856506	34	27	CCCA	TGCC
V350256906L4C003R03800650508	chr1	170540	50M	178	170718	170541	170719	V350256906L4C003R03800650508_chr1_170540	512	664	AGGA	CTGC
V350256906L4C003R03800653396	chr1	726199	50M	174	726373	726200	726374	V350256906L4C003R03800653396_chr1_726199	50	38	actc	cttt
V350256906L4C003R03800734950	chr1	709416	50M	178	709594	709417	709595	V350256906L4C003R03800734950_chr1_709416	5	142	TTTA	CCCG
V350256906L4C003R03801225384	chr1	879051	50M	160	879211	879052	879212	V350256906L4C003R03801225384_chr1_879051	3	0	CTGA	ACCT
V350256906L4C003R03900497729	chr1	67098	50M	206	67304	67099	67305	V350256906L4C003R03900497729_chr1_67098	44	33	CTAT	TAAA
V350256906L4C003R04000044019	chr1	410215	50M	216	410431	410216	410432	V350256906L4C003R04000044019_chr1_410215	103	319	CCCT	GCCA
V350256906L4C003R04000997292	chr1	1199296	50M	174	1199470	1199297	1199471	V350256906L4C003R04000997292_chr1_1199296	25	16	cagg	AGCT
V350256906L4C003R04001025317	chr1	1277103	50M	185	1277288	1277104	1277289	V350256906L4C003R04001025317_chr1_1277103	34	97	GCTG	GCCA
V350256906L4C003R04001354272	chr1	1026486	50M	159	1026645	1026487	1026646	V350256906L4C003R04001354272_chr1_1026486	43	70	CCCA	CAGG
V350256906L4C003R04100155633	chr1	421455	50M	205	421660	421456	421661	V350256906L4C003R04100155633_chr1_421455	0	0	CCTA	AGAT
V350256906L4C003R04100684182	chr1	696616	50M	196	696812	696617	696813	V350256906L4C003R04100684182_chr1_696616	148	106	CAGG	CTAG
V350256906L4C003R04100728533	chr1	730090	50M	187	730277	730091	730278	V350256906L4C003R04100728533_chr1_730090	59	63	tgat	TGGC
V350256906L4C003R04100762864	chr1	111468	50M	174	111642	111469	111643	V350256906L4C003R04100762864_chr1_111468	22	0	CCTA	TAAC
V350256906L4C003R04101263960	chr1	813114	50M	198	813312	813115	813313	V350256906L4C003R04101263960_chr1_813114	117	315	CCCC	GCTT
V350256906L4C003R04200475510	chr1	1423424	50M	178	1423602	1423425	1423603	V350256906L4C003R04200475510_chr1_1423424	80	47	tcct	catt
V350256906L4C003R04200653263	chr1	102995	50M	169	103164	102996	103165	V350256906L4C003R04200653263_chr1_102995	120	46	cgcc	cctg
V350256906L4C003R04201015179	chr1	698178	50M	157	698335	698179	698336	V350256906L4C003R04201015179_chr1_698178	61	37	ggga	tgta
V350256906L4C003R04300411186	chr1	879560	50M	166	879726	879561	879727	V350256906L4C003R04300411186_chr1_879560	72	69	CACA	TCTG
V350256906L4C003R04300696550	chr1	243803	48M2S	167	243970	243804	243971	V350256906L4C003R04300696550_chr1_243803	59	67	ATAC	CAAT
V350256906L4C003R04300957095	chr1	348710	50M	168	348878	348711	348879	V350256906L4C003R04300957095_chr1_348710	144	0	AGTC	ccaa
V350256906L4C003R04301309357	chr1	385636	50M	163	385799	385637	385800	V350256906L4C003R04301309357_chr1_385636	96	12	gccc	cacc
V350256906L4C003R04301323329	chr1	69631	50M	169	69800	69632	69801	V350256906L4C003R04301323329_chr1_69631	42	102	GCCT	TGTG
V350256906L4C003R04301363800	chr1	688933	50M	185	689118	688934	689119	V350256906L4C003R04301363800_chr1_688933	21	206	accc	cctt
V350256906L4C003R04400333459	chr1	576088	50M	171	576259	576089	576260	V350256906L4C003R04400333459_chr1_576088	23	126	cccc	ccct
V350256906L4C003R04400427296	chr1	53154	50M	160	53314	53155	53315	V350256906L4C003R04400427296_chr1_53154	40	48	TGTT	CGTT
V350256906L4C003R04400453866	chr1	462375	50M	173	462548	462376	462549	V350256906L4C003R04400453866_chr1_462375	272	122	gtct	CCCC
V350256906L4C003R04500064904	chr1	1392798	50M	156	1392954	1392799	1392955	V350256906L4C003R04500064904_chr1_1392798	20	43	cccc	ccca
V350256906L4C003R04500165171	chr1	1139844	50M	187	1140031	1139845	1140032	V350256906L4C003R04500165171_chr1_1139844	40	44	CTGG	CCCA
V350256906L4C003R04500452826	chr1	1226372	50M	166	1226538	1226373	1226539	V350256906L4C003R04500452826_chr1_1226372	0	0	CCTC	AGGG
V350256906L4C003R04500454524	chr1	763586	50M	168	763754	763587	763755	V350256906L4C003R04500454524_chr1_763586	15	46	TAAA	CCAG
V350256906L4C003R04500854176	chr1	384678	50M	147	384825	384679	384826	V350256906L4C003R04500854176_chr1_384678	221	74	cctg	cgtg
V350256906L4C003R04500928395	chr1	90414	50M	164	90578	90415	90579	V350256906L4C003R04500928395_chr1_90414	169	5	CCTG	Gccc
V350256906L4C003R04501135399	chr1	1140845	50M	166	1141011	1140846	1141012	V350256906L4C003R04501135399_chr1_1140845	18	19	CAGT	AGCC
V350256906L4C003R04600485949	chr1	903904	50M	149	904053	903905	904054	V350256906L4C003R04600485949_chr1_903904	16	58	gccc	ctgt
V350256906L4C003R04601096024	chr1	809299	50M	174	809473	809300	809474	V350256906L4C003R04601096024_chr1_809299	0	0	CCCG	CCCG
V350256906L4C003R04601131082	chr1	1303796	50M	188	1303984	1303797	1303985	V350256906L4C003R04601131082_chr1_1303796	0	145	TGTA	agct
V350256906L4C003R04601196101	chr1	672594	50M	157	672751	672595	672752	V350256906L4C003R04601196101_chr1_672594	31	86	TCCC	tacc
V350256906L4C003R04700181740	chr1	111042	50M	170	111212	111043	111213	V350256906L4C003R04700181740_chr1_111042	0	27	gtta	ttgt
V350256906L4C003R04700548970	chr1	128717	50M	168	128885	128718	128886	V350256906L4C003R04700548970_chr1_128717	11	26	ccca	ggtg
V350256906L4C003R04701260889	chr1	244741	50M	172	244913	244742	244914	V350256906L4C003R04701260889_chr1_244741	151	323	CCTC	ACAG
V350256906L4C003R04800414202	chr1	730349	50M	189	730538	730350	730539	V350256906L4C003R04800414202_chr1_730349	0	0	TATT	gctt
V350256906L4C003R04800486048	chr1	155056	50M	182	155238	155057	155239	V350256906L4C003R04800486048_chr1_155056	167	241	gaaa	ccca
V350256906L4C003R04800544649	chr1	1324905	50M	179	1325084	1324906	1325085	V350256906L4C003R04800544649_chr1_1324905	79	54	CCTG	acag
V350256906L4C003R04800605141	chr1	137247	50M	164	137411	137248	137412	V350256906L4C003R04800605141_chr1_137247	16	0	CTCT	CCCC
V350256906L4C003R04800615846	chr1	1419788	50M	176	1419964	1419789	1419965	V350256906L4C003R04800615846_chr1_1419788	47	43	cctg	aggc
V350256906L4C003R04800869688	chr1	857644	50M	160	857804	857645	857805	V350256906L4C003R04800869688_chr1_857644	67	51	AGTC	TGAT
V350256906L4C003R04801033231	chr1	846054	50M	188	846242	846055	846243	V350256906L4C003R04801033231_chr1_846054	100	63	GGCG	ATTG
V350256906L4C003R04801194373	chr1	831543	50M	182	831725	831544	831726	V350256906L4C003R04801194373_chr1_831543	20	119	cagt	aaga
V350256906L4C003R04801209988	chr1	753048	50M	206	753254	753049	753255	V350256906L4C003R04801209988_chr1_753048	181	95	GCTG	CCTT
V350256906L4C003R04801262527	chr1	152433	50M	145	152578	152434	152579	V350256906L4C003R04801262527_chr1_152433	586	731	ccag	ccaa
V350256906L4C003R04900196152	chr1	1011432	50M	191	1011623	1011433	1011624	V350256906L4C003R04900196152_chr1_1011432	158	0	CTGA	CCCG
V350256906L4C003R04900264208	chr1	235590	50M	165	235755	235591	235756	V350256906L4C003R04900264208_chr1_235590	186	73	CTAG	TCCT
V350256906L4C003R04900454478	chr1	434673	50M	197	434870	434674	434871	V350256906L4C003R04900454478_chr1_434673	45	70	CCTA	ACCC
V350256906L4C003R04900471892	chr1	1018703	50M	110	1018813	1018704	1018814	V350256906L4C003R04900471892_chr1_1018703	103	190	caag	GGCC
V350256906L4C003R04900586815	chr1	114410	50M	180	114590	114411	114591	V350256906L4C003R04900586815_chr1_114410	75	74	agct	tgct
V350256906L4C003R04900664543	chr1	450882	50M	185	451067	450883	451068	V350256906L4C003R04900664543_chr1_450882	116	64	ctgt	gtta
V350256906L4C003R04900791666	chr1	827458	50M	149	827607	827459	827608	V350256906L4C003R04900791666_chr1_827458	17	54	tgag	ccta
V350256906L4C003R05000027260	chr1	464192	50M	167	464359	464193	464360	V350256906L4C003R05000027260_chr1_464192	0	131	GCAC	GTCC
V350256906L4C003R05000373161	chr1	1162440	50M	180	1162620	1162441	1162621	V350256906L4C003R05000373161_chr1_1162440	217	74	CCTC	CAAG
V350256906L4C003R05000463487	chr1	1107702	50M	155	1107857	1107703	1107858	V350256906L4C003R05000463487_chr1_1107702	156	1	ctga	CCTT
V350256906L4C003R05000476303	chr1	435686	50M	171	435857	435687	435858	V350256906L4C003R05000476303_chr1_435686	32	75	CATA	ccag
V350256906L4C003R05001121191	chr1	1016487	50M	179	1016666	1016488	1016667	V350256906L4C003R05001121191_chr1_1016487	0	9	AGAG	CGTG
V350256906L4C003R05001377566	chr1	1097543	50M	178	1097721	1097544	1097722	V350256906L4C003R05001377566_chr1_1097543	22	50	CCCT	GGGA
V350256906L4C003R05100261042	chr1	978323	50M	144	978467	978324	978468	V350256906L4C003R05100261042_chr1_978323	0	17	GGGC	GAGA
V350256906L4C003R05100466205	chr1	105805	50M	188	105993	105806	105994	V350256906L4C003R05100466205_chr1_105805	65	30	TGGC	CACC
V350256906L4C003R05100677100	chr1	724627	50M	198	724825	724628	724826	V350256906L4C003R05100677100_chr1_724627	89	60	gaat	ttcc
V350256906L4C003R05100683190	chr1	1429345	50M	165	1429510	1429346	1429511	V350256906L4C003R05100683190_chr1_1429345	0	4	ccaa	GGGA
V350256906L4C003R05100730593	chr1	1106135	50M	147	1106282	1106136	1106283	V350256906L4C003R05100730593_chr1_1106135	207	60	AGCA	CAGG
V350256906L4C003R05101137819	chr1	809708	50M	138	809846	809709	809847	V350256906L4C003R05101137819_chr1_809708	13	15	TGCT	AAAA
V350256906L4C003R05101306156	chr1	1312572	50M	158	1312730	1312573	1312731	V350256906L4C003R05101306156_chr1_1312572	41	78	GAAG	ccaa
V350256906L4C003R05101319654	chr1	404374	50M	181	404555	404375	404556	V350256906L4C003R05101319654_chr1_404374	15	196	cccc	TGTT
V350256906L4C003R05200016643	chr1	1030007	50M	152	1030159	1030008	1030160	V350256906L4C003R05200016643_chr1_1030007	63	42	cctg	ttca
V350256906L4C003R05200602017	chr1	837248	50M	168	837416	837249	837417	V350256906L4C003R05200602017_chr1_837248	12	82	AGGA	CTAA
V350256906L4C003R05201019663	chr1	1138755	50M	184	1138939	1138756	1138940	V350256906L4C003R05201019663_chr1_1138755	18	0	CCCA	ccag
V350256906L4C003R05201159812	chr1	779542	50M	188	779730	779543	779731	V350256906L4C003R05201159812_chr1_779542	0	0	gagg	AGGt
V350256906L4C003R05201223973	chr1	44926	50M	167	45093	44927	45094	V350256906L4C003R05201223973_chr1_44926	621	454	atac	caag
V350256906L4C003R05300195999	chr1	455595	50M	169	455764	455596	455765	V350256906L4C003R05300195999_chr1_455595	12	91	GGCT	TGCT
V350256906L4C003R05400988219	chr1	541583	50M	165	541748	541584	541749	V350256906L4C003R05400988219_chr1_541583	0	0	GGGG	GAGG
V350256906L4C003R05401061681	chr1	739880	50M	202	740082	739881	740083	V350256906L4C003R05401061681_chr1_739880	0	15	CCCC	ATAC
V350256906L4C003R05401112389	chr1	1019451	50M	170	1019621	1019452	1019622	V350256906L4C003R05401112389_chr1_1019451	39	31	CCTG	CCTG
V350256906L4C003R05500180095	chr1	24396	50M	169	24565	24397	24566	V350256906L4C003R05500180095_chr1_24396	123	209	caca	CTGG
V350256906L4C003R05500245184	chr1	1067469	50M	173	1067642	1067470	1067643	V350256906L4C003R05500245184_chr1_1067469	0	0	CCTC	GCAG
V350256906L4C003R05500247504	chr1	456407	50M	170	456577	456408	456578	V350256906L4C003R05500247504_chr1_456407	557	387	CTTG	agaa
V350256906L4C003R05500248407	chr1	97947	50M	116	98063	97948	98064	V350256906L4C003R05500248407_chr1_97947	17	133	tcat	tgct
V350256906L4C003R05500274107	chr1	998631	50M	147	998778	998632	998779	V350256906L4C003R05500274107_chr1_998631	72	39	GGAG	CTCA
V350256906L4C003R05500335268	chr1	900244	50M	150	900394	900245	900395	V350256906L4C003R05500335268_chr1_900244	0	3	ACCT	CCCC
V350256906L4C003R05500348387	chr1	54678	50M	182	54860	54679	54861	V350256906L4C003R05500348387_chr1_54678	55	237	ccat	tgag
V350256906L4C003R05500391268	chr1	338816	50M	198	339014	338817	339015	V350256906L4C003R05500391268_chr1_338816	2	151	TGAA	tcaa
V350256906L4C003R05500408387	chr1	1140206	50M	172	1140378	1140207	1140379	V350256906L4C003R05500408387_chr1_1140206	55	71	GGGT	CCCT
V350256906L4C003R05500532062	chr1	1154017	50M	176	1154193	1154018	1154194	V350256906L4C003R05500532062_chr1_1154017	45	38	CGAG	GGGA
V350256906L4C003R05500953739	chr1	754694	50M	237	754931	754695	754932	V350256906L4C003R05500953739_chr1_754694	52	10	CCCT	CCGC
V350256906L4C003R05500984212	chr1	1307635	50M	172	1307807	1307636	1307808	V350256906L4C003R05500984212_chr1_1307635	49	28	CACT	GGGG
V350256906L4C003R05501335097	chr1	231101	50M	200	231301	231102	231302	V350256906L4C003R05501335097_chr1_231101	11	29	gtat	gtaa
V350256906L4C003R05600679128	chr1	1427631	50M	153	1427784	1427632	1427785	V350256906L4C003R05600679128_chr1_1427631	54	8	ccaa	agca
V350256906L4C003R05600955306	chr1	1173580	50M	151	1173731	1173581	1173732	V350256906L4C003R05600955306_chr1_1173580	0	17	CACC	CCTG
V350256906L4C003R05601114919	chr1	718280	50M	181	718461	718281	718462	V350256906L4C003R05601114919_chr1_718280	29	65	caaa	taag
V350256906L4C003R05601186494	chr1	1284926	50M	174	1285100	1284927	1285101	V350256906L4C003R05601186494_chr1_1284926	39	51	CGCG	CGGC
V350256906L4C003R05601241169	chr1	1295196	50M	173	1295369	1295197	1295370	V350256906L4C003R05601241169_chr1_1295196	76	44	CCCC	TGCA
V350256906L4C003R05700289469	chr1	824911	50M	150	825061	824912	825062	V350256906L4C003R05700289469_chr1_824911	119	0	CCAC	tgtg
V350256906L4C003R05700298631	chr1	1297866	50M	95	1297961	1297867	1297962	V350256906L4C003R05700298631_chr1_1297866	55	14	CCAC	cttg
V350256906L4C003R05700375554	chr1	657898	50M	178	658076	657899	658077	V350256906L4C003R05700375554_chr1_657898	76	203	CTCT	GCTG
V350256906L4C003R05700387111	chr1	88722	50M	157	88879	88723	88880	V350256906L4C003R05700387111_chr1_88722	116	220	gacc	GGTG
V350256906L4C003R05700618379	chr1	946308	6S44M	270	946578	946309	946579	V350256906L4C003R05700618379_chr1_946308	95	0	agta	aaaa
V350256906L4C003R05700761816	chr1	1370318	50M	145	1370463	1370319	1370464	V350256906L4C003R05700761816_chr1_1370318	71	31	TGCT	CCAC
V350256906L4C003R05701095529	chr1	1147177	50M	173	1147350	1147178	1147351	V350256906L4C003R05701095529_chr1_1147177	144	210	CCAG	TCCA
V350256906L4C003R05701193444	chr1	239545	50M	184	239729	239546	239730	V350256906L4C003R05701193444_chr1_239545	0	0	gtta	tttt
V350256906L4C003R05701278803	chr1	712854	50M	155	713009	712855	713010	V350256906L4C003R05701278803_chr1_712854	13	53	tgat	cccc
V350256906L4C003R05800870585	chr1	571219	50M	165	571384	571220	571385	V350256906L4C003R05800870585_chr1_571219	215	50	aaag	ccat
V350256906L4C003R05801135287	chr1	1253665	50M	177	1253842	1253666	1253843	V350256906L4C003R05801135287_chr1_1253665	60	59	agga	cgaa
V350256906L4C003R05900188847	chr1	719552	50M	161	719713	719553	719714	V350256906L4C003R05900188847_chr1_719552	15	8	tgac	ccat
V350256906L4C003R05900286948	chr1	724526	4S43M3S	161	724687	724527	724688	V350256906L4C003R05900286948_chr1_724526	190	29	ggaa	CATT
V350256906L4C003R05900465558	chr1	627453	50M	157	627610	627454	627611	V350256906L4C003R05900465558_chr1_627453	11	49	TGGA	TCCC
V350256906L4C003R05900910626	chr1	1334145	50M	158	1334303	1334146	1334304	V350256906L4C003R05900910626_chr1_1334145	64	58	ACCA	cccc
V350256906L4C003R05901364100	chr1	1200434	50M	179	1200613	1200435	1200614	V350256906L4C003R05901364100_chr1_1200434	55	58	CCCA	CGAG
V350256906L4C003R06000275009	chr1	1237892	50M	187	1238079	1237893	1238080	V350256906L4C003R06000275009_chr1_1237892	136	25	ACTT	GTTT
V350256906L4C003R06000312602	chr1	447992	50M	155	448147	447993	448148	V350256906L4C003R06000312602_chr1_447992	44	38	ccca	TTCA
V350256906L4C003R06000325919	chr1	524365	50M	162	524527	524366	524528	V350256906L4C003R06000325919_chr1_524365	28	150	AAAT	gcaa
V350256906L4C003R06000407565	chr1	1190419	50M	173	1190592	1190420	1190593	V350256906L4C003R06000407565_chr1_1190419	59	46	AGCC	CAGG
V350256906L4C003R06000427545	chr1	1169776	50M	164	1169940	1169777	1169941	V350256906L4C003R06000427545_chr1_1169776	29	75	CAGG	AGTC
V350256906L4C003R06000514341	chr1	1024872	50M	189	1025061	1024873	1025062	V350256906L4C003R06000514341_chr1_1024872	70	80	CAGA	CACT
V350256906L4C003R06000578094	chr1	637593	50M	159	637752	637594	637753	V350256906L4C003R06000578094_chr1_637593	191	32	ggca	GGtt
V350256906L4C003R06001102189	chr1	825980	50M	158	826138	825981	826139	V350256906L4C003R06001102189_chr1_825980	263	129	GACC	ctgc
V350256906L4C003R06001392481	chr1	1165615	50M	165	1165780	1165616	1165781	V350256906L4C003R06001392481_chr1_1165615	16	16	agct	GGTT
V350256906L4C003R06100046948	chr1	874093	50M	157	874250	874094	874251	V350256906L4C003R06100046948_chr1_874093	63	56	CTCC	CACG
V350256906L4C003R06100602961	chr1	629386	50M	192	629578	629387	629579	V350256906L4C003R06100602961_chr1_629386	53	63	TGCC	TTCC
V350256906L4C003R06100694226	chr1	944851	50M	178	945029	944852	945030	V350256906L4C003R06100694226_chr1_944851	35	9	ggag	agtg
V350256906L4C003R06100843596	chr1	97191	50M	166	97357	97192	97358	V350256906L4C003R06100843596_chr1_97191	0	0	AGGT	TATA
V350256906L4C003R06100857441	chr1	166238	50M	164	166402	166239	166403	V350256906L4C003R06100857441_chr1_166238	63	227	aggc	acat
V350256906L4C003R06100892788	chr1	367311	50M	169	367480	367312	367481	V350256906L4C003R06100892788_chr1_367311	101	48	TGGA	CAAC
V350256906L4C003R06101131776	chr1	146477	50M	178	146655	146478	146656	V350256906L4C003R06101131776_chr1_146477	65	73	ctcc	GCAC
V350256906L4C003R06101162114	chr1	827960	50M	166	828126	827961	828127	V350256906L4C003R06101162114_chr1_827960	76	38	ggtt	tgtg
V350256906L4C003R06200733627	chr1	1418064	50M	158	1418222	1418065	1418223	V350256906L4C003R06200733627_chr1_1418064	150	0	AGGT	cgta
V350256906L4C003R06201337259	chr1	898427	50M	145	898572	898428	898573	V350256906L4C003R06201337259_chr1_898427	0	48	CCTG	CATG
V350256906L4C003R06300076667	chr1	962061	50M	174	962235	962062	962236	V350256906L4C003R06300076667_chr1_962061	42	78	CCCC	CCTC
V350256906L4C003R06300145234	chr1	772630	50M	154	772784	772631	772785	V350256906L4C003R06300145234_chr1_772630	3	17	CCCA	ggta
V350256906L4C003R06300595716	chr1	1009470	50M	163	1009633	1009471	1009634	V350256906L4C003R06300595716_chr1_1009470	65	55	GCCC	CCTT
V350256906L4C003R06400064042	chr1	644374	50M	213	644587	644375	644588	V350256906L4C003R06400064042_chr1_644374	44	10	cctg	acaa
V350256906L4C003R06400127220	chr1	928783	50M	151	928934	928784	928935	V350256906L4C003R06400127220_chr1_928783	55	64	CCAA	CCTC
V350256906L4C003R06400514878	chr1	436912	50M	205	437117	436913	437118	V350256906L4C003R06400514878_chr1_436912	29	59	CACA	tgtg
V350256906L4C003R06400541613	chr1	590448	50M	164	590612	590449	590613	V350256906L4C003R06400541613_chr1_590448	64	58	caaa	taaa
V350256906L4C003R06400789993	chr1	147812	50M	147	147959	147813	147960	V350256906L4C003R06400789993_chr1_147812	43	60	tgag	taat
V350256906L4C003R06400914618	chr1	1112463	50M	167	1112630	1112464	1112631	V350256906L4C003R06400914618_chr1_1112463	4	0	tgtg	atgt
V350256906L4C003R06400940428	chr1	133776	50M	169	133945	133777	133946	V350256906L4C003R06400940428_chr1_133776	153	153	CACC	CCTG
V350256906L4C003R06401260064	chr1	698820	50M	163	698983	698821	698984	V350256906L4C003R06401260064_chr1_698820	33	90	GACA	GCTG
V350256906L4C003R06401315397	chr1	416000	50M	196	416196	416001	416197	V350256906L4C003R06401315397_chr1_416000	0	0	GAAT	TTAC
V350256906L4C003R06500204506	chr1	1005539	50M	174	1005713	1005540	1005714	V350256906L4C003R06500204506_chr1_1005539	17	77	CCTT	CGCA
V350256906L4C003R06500226812	chr1	27081	50M	181	27262	27082	27263	V350256906L4C003R06500226812_chr1_27081	0	61	tgca	CCAC
V350256906L4C003R06500498909	chr1	744862	50M	156	745018	744863	745019	V350256906L4C003R06500498909_chr1_744862	16	0	tata	CTAT
V350256906L4C003R06500615062	chr1	376470	50M	160	376630	376471	376631	V350256906L4C003R06500615062_chr1_376470	120	280	cctg	aaaa
V350256906L4C003R06500760125	chr1	1174156	50M	185	1174341	1174157	1174342	V350256906L4C003R06500760125_chr1_1174156	51	59	CCCT	TGTG
V350256906L4C003R06500765741	chr1	809104	50M	143	809247	809105	809248	V350256906L4C003R06500765741_chr1_809104	151	8	CCAC	CAAG
V350256906L4C003R06500898985	chr1	1006381	50M	161	1006542	1006382	1006543	V350256906L4C003R06500898985_chr1_1006381	0	37	CACA	TGCC
V350256906L4C003R06501179543	chr1	347087	50M	167	347254	347088	347255	V350256906L4C003R06501179543_chr1_347087	26	20	AAAG	ACAT
V350256906L4C003R06600409950	chr1	862977	50M	143	863120	862978	863121	V350256906L4C003R06600409950_chr1_862977	54	51	AGAG	CCTC
V350256906L4C003R06700490202	chr1	60411	50M	176	60587	60412	60588	V350256906L4C003R06700490202_chr1_60411	94	48	cctg	tcag
V350256906L4C003R06700520695	chr1	353317	50M	186	353503	353318	353504	V350256906L4C003R06700520695_chr1_353317	266	80	cctc	ctaa
V350256906L4C003R06700582750	chr1	144832	50M	169	145001	144833	145002	V350256906L4C003R06700582750_chr1_144832	303	383	agcc	caca
V350256906L4C003R06700636892	chr1	236111	50M	180	236291	236112	236292	V350256906L4C003R06700636892_chr1_236111	71	47	CTTT	TATA
V350256906L4C003R06701185730	chr1	24182	50M	165	24347	24183	24348	V350256906L4C003R06701185730_chr1_24182	38	74	gctc	ggag
V350256906L4C003R06701212436	chr1	1066908	50M	193	1067101	1066909	1067102	V350256906L4C003R06701212436_chr1_1066908	150	17	tgcc	CGAG
V350256906L4C003R06800105170	chr1	1138616	50M	172	1138788	1138617	1138789	V350256906L4C003R06800105170_chr1_1138616	34	51	GGCC	GCAA
V350256906L4C003R06800238649	chr1	76083	50M	160	76243	76084	76244	V350256906L4C003R06800238649_chr1_76083	54	21	caaa	cata
V350256906L4C003R06800551885	chr1	466819	50M	173	466992	466820	466993	V350256906L4C003R06800551885_chr1_466819	99	58	CCAT	CATG
V350256906L4C003R06800576994	chr1	726313	50M	186	726499	726314	726500	V350256906L4C003R06800576994_chr1_726313	22	22	cgaa	ttgc
V350256906L4C003R06801216634	chr1	167740	50M	172	167912	167741	167913	V350256906L4C003R06801216634_chr1_167740	16	34	ctcc	GAGG
V350256906L4C003R06801373107	chr1	825827	16S34M	158	825985	825828	825986	V350256906L4C003R06801373107_chr1_825827	110	268	aaaa	GGGT
V350256906L4C003R06900300239	chr1	557620	50M	183	557803	557621	557804	V350256906L4C003R06900300239_chr1_557620	19	8	GCCA	CCCA
V350256906L4C003R06900617350	chr1	713128	50M	146	713274	713129	713275	V350256906L4C003R06900617350_chr1_713128	47	0	tgta	CTTA
V350256906L4C003R06900985664	chr1	1059161	50M	160	1059321	1059162	1059322	V350256906L4C003R06900985664_chr1_1059161	59	65	cctg	gtgt
V350256906L4C003R07000144533	chr1	461987	50M	199	462186	461988	462187	V350256906L4C003R07000144533_chr1_461987	0	83	CTCC	actt
V350256906L4C003R07000272092	chr1	807463	50M	191	807654	807464	807655	V350256906L4C003R07000272092_chr1_807463	57	40	CCAA	ATAT
V350256906L4C003R07000888946	chr1	59245	50M	121	59366	59246	59367	V350256906L4C003R07000888946_chr1_59245	0	75	CCCT	GTTT
V350256906L4C003R07000919434	chr1	330842	50M	183	331025	330843	331026	V350256906L4C003R07000919434_chr1_330842	0	174	CACC	CCAG
V350256906L4C003R07000963886	chr1	263149	50M	182	263331	263150	263332	V350256906L4C003R07000963886_chr1_263149	161	31	ccaa	catt
V350256906L4C003R07001157914	chr1	588265	50M	166	588431	588266	588432	V350256906L4C003R07001157914_chr1_588265	13	0	aata	gact
V350256906L4C003R07100110557	chr1	663001	50M	177	663178	663002	663179	V350256906L4C003R07100110557_chr1_663001	22	43	GGTG	CTCC
V350256906L4C003R07100136184	chr1	1068136	50M	167	1068303	1068137	1068304	V350256906L4C003R07100136184_chr1_1068136	48	51	ctgc	gaag
V350256906L4C003R07100793659	chr1	237105	50M	143	237248	237106	237249	V350256906L4C003R07100793659_chr1_237105	132	0	AGGC	AAGA
V350256906L4C003R07100937645	chr1	770981	50M	170	771151	770982	771152	V350256906L4C003R07100937645_chr1_770981	12	101	GATG	AGTT
V350256906L4C003R07100947337	chr1	820204	50M	181	820385	820205	820386	V350256906L4C003R07100947337_chr1_820204	8	142	atac	agtg
V350256906L4C003R07200438227	chr1	772134	50M	177	772311	772135	772312	V350256906L4C003R07200438227_chr1_772134	2	151	gact	CTCA
V350256906L4C003R07200467998	chr1	806467	50M	168	806635	806468	806636	V350256906L4C003R07200467998_chr1_806467	16	31	ctat	aaaa
V350256906L4C003R07200627247	chr1	30152	50M	179	30331	30153	30332	V350256906L4C003R07200627247_chr1_30152	38	21	agac	CAAA
V350256906L4C003R07200872304	chr1	1199628	50M	156	1199784	1199629	1199785	V350256906L4C003R07200872304_chr1_1199628	0	154	CAGC	GAAG
V350256906L4C003R07201277661	chr1	160227	50M	167	160394	160228	160395	V350256906L4C003R07201277661_chr1_160227	85	252	TCTT	GAAT
V350256906L4C003R07201295020	chr1	768954	50M	179	769133	768955	769134	V350256906L4C003R07201295020_chr1_768954	72	39	AAAG	CCAG
V350256906L4C004R00100162444	chr1	234229	50M	157	234386	234230	234387	V350256906L4C004R00100162444_chr1_234229	18	57	GCCG	GGGG
V350256906L4C004R00100163085	chr1	1369073	50M	141	1369214	1369074	1369215	V350256906L4C004R00100163085_chr1_1369073	49	55	GGCC	CTCT
V350256906L4C004R00100500655	chr1	816705	50M	171	816876	816706	816877	V350256906L4C004R00100500655_chr1_816705	151	96	ctta	AAAA
V350256906L4C004R00100795472	chr1	1037206	50M	195	1037401	1037207	1037402	V350256906L4C004R00100795472_chr1_1037206	96	54	cttt	cggc
V350256906L4C004R00101334795	chr1	592302	50M	162	592464	592303	592465	V350256906L4C004R00101334795_chr1_592302	128	0	CTAC	aaca
V350256906L4C004R00101367208	chr1	1194071	50M	149	1194220	1194072	1194221	V350256906L4C004R00101367208_chr1_1194071	27	0	CCAA	tgag
V350256906L4C004R00200514965	chr1	1082873	50M	183	1083056	1082874	1083057	V350256906L4C004R00200514965_chr1_1082873	63	55	GCCC	GGCA
V350256906L4C004R00200612402	chr1	867310	50M	170	867480	867311	867481	V350256906L4C004R00200612402_chr1_867310	32	22	ACCC	TATT
V350256906L4C004R00201366335	chr1	1351513	50M	177	1351690	1351514	1351691	V350256906L4C004R00201366335_chr1_1351513	71	53	tgat	agaa
V350256906L4C004R00300464277	chr1	821972	50M	166	822138	821973	822139	V350256906L4C004R00300464277_chr1_821972	62	228	cggt	gcaa
V350256906L4C004R00300731495	chr1	17968	50M	166	18134	17969	18135	V350256906L4C004R00300731495_chr1_17968	0	34	GGCG	CCCT
V350256906L4C004R00300852226	chr1	28115	50M	185	28300	28116	28301	V350256906L4C004R00300852226_chr1_28115	19	0	GATC	aatc
V350256906L4C004R00301183690	chr1	566199	50M	150	566349	566200	566350	V350256906L4C004R00301183690_chr1_566199	60	6	AGCC	GCAA
V350256906L4C004R00301274453	chr1	809177	50M	157	809334	809178	809335	V350256906L4C004R00301274453_chr1_809177	78	22	CCGG	CGCC
V350256906L4C004R00400301358	chr1	67084	50M	191	67275	67085	67276	V350256906L4C004R00400301358_chr1_67084	58	62	TGCA	AATA
V350256906L4C004R00400797990	chr1	100023	50M	175	100198	100024	100199	V350256906L4C004R00400797990_chr1_100023	39	30	tcta	tagc
V350256906L4C004R00400849728	chr1	1184305	50M	145	1184450	1184306	1184451	V350256906L4C004R00400849728_chr1_1184305	19	164	CACT	GTAG
V350256906L4C004R00400925595	chr1	965773	50M	181	965954	965774	965955	V350256906L4C004R00400925595_chr1_965773	128	0	gcag	caca
V350256906L4C004R00401153586	chr1	1038658	50M	239	1038897	1038659	1038898	V350256906L4C004R00401153586_chr1_1038658	119	0	aaag	cgtt
V350256906L4C004R00401345126	chr1	948707	50M	165	948872	948708	948873	V350256906L4C004R00401345126_chr1_948707	0	92	CCCT	CGGC
V350256906L4C004R00500073009	chr1	718333	50M	155	718488	718334	718489	V350256906L4C004R00500073009_chr1_718333	0	92	ccat	ccaa
V350256906L4C004R00500121245	chr1	39828	50M	182	40010	39829	40011	V350256906L4C004R00500121245_chr1_39828	49	73	ctca	ccat
V350256906L4C004R00500273476	chr1	97192	50M	144	97336	97193	97337	V350256906L4C004R00500273476_chr1_97192	0	15	GGTG	TATA
V350256906L4C004R00500357429	chr1	332685	50M	176	332861	332686	332862	V350256906L4C004R00500357429_chr1_332685	0	0	ggaa	aaat
V350256906L4C004R00500442500	chr1	77970	50M	181	78151	77971	78152	V350256906L4C004R00500442500_chr1_77970	78	43	aaca	tcta
V350256906L4C004R00500855845	chr1	1351724	50M	164	1351888	1351725	1351889	V350256906L4C004R00500855845_chr1_1351724	67	59	cctt	cagg
V350256906L4C004R00501023727	chr1	1404838	50M	147	1404985	1404839	1404986	V350256906L4C004R00501023727_chr1_1404838	63	45	acca	cagg
V350256906L4C004R00600029190	chr1	635005	50M	160	635165	635006	635166	V350256906L4C004R00600029190_chr1_635005	220	60	cccc	caga
V350256906L4C004R00600165598	chr1	1088188	50M	158	1088346	1088189	1088347	V350256906L4C004R00600165598_chr1_1088188	28	132	TATC	GGAG
V350256906L4C004R00600439367	chr1	908284	50M	171	908455	908285	908456	V350256906L4C004R00600439367_chr1_908284	46	61	CCAG	CCCA
V350256906L4C004R00600498737	chr1	129568	50M	208	129776	129569	129777	V350256906L4C004R00600498737_chr1_129568	211	101	cacc	tggg
V350256906L4C004R00600588059	chr1	864291	50M	204	864495	864292	864496	V350256906L4C004R00600588059_chr1_864291	33	58	TAAC	CCAG
V350256906L4C004R00600751699	chr1	102053	50M	161	102214	102054	102215	V350256906L4C004R00600751699_chr1_102053	22	32	aaga	AATT
V350256906L4C004R00600772934	chr1	60172	50M	167	60339	60173	60340	V350256906L4C004R00600772934_chr1_60172	37	25	CACC	AGTG
V350256906L4C004R00700901305	chr1	1310354	50M	172	1310526	1310355	1310527	V350256906L4C004R00700901305_chr1_1310354	36	35	GGCG	TGGG
V350256906L4C004R00701233468	chr1	748316	50M	158	748474	748317	748475	V350256906L4C004R00701233468_chr1_748316	16	32	ctta	CCCC
V350256906L4C004R00801040095	chr1	408634	50M	163	408797	408635	408798	V350256906L4C004R00801040095_chr1_408634	11	5	CCTA	gcta
V350256906L4C004R00801078453	chr1	81869	50M	171	82040	81870	82041	V350256906L4C004R00801078453_chr1_81869	67	34	agcc	tgat
V350256906L4C004R00801184518	chr1	379896	50M	128	380024	379897	380025	V350256906L4C004R00801184518_chr1_379896	43	0	ccta	aaac
V350256906L4C004R00900023598	chr1	1212500	50M	161	1212661	1212501	1212662	V350256906L4C004R00900023598_chr1_1212500	26	57	ccta	ggtg
V350256906L4C004R00900285937	chr1	1002857	50M	187	1003044	1002858	1003045	V350256906L4C004R00900285937_chr1_1002857	44	46	TACG	CACC
V350256906L4C004R00901206133	chr1	674633	50M	155	674788	674634	674789	V350256906L4C004R00901206133_chr1_674633	0	0	ACAC	TGCT
V350256906L4C004R00901278031	chr1	957929	42M8S	132	958061	957930	958062	V350256906L4C004R00901278031_chr1_957929	15	0	CCTT	TTGG
V350256906L4C004R00901281174	chr1	1382984	50M	157	1383141	1382985	1383142	V350256906L4C004R00901281174_chr1_1382984	22	72	acca	ccaa
V350256906L4C004R00901375272	chr1	1346401	50M	158	1346559	1346402	1346560	V350256906L4C004R00901375272_chr1_1346401	33	4	ccct	atgg
V350256906L4C004R01000074708	chr1	65297	50M	191	65488	65298	65489	V350256906L4C004R01000074708_chr1_65297	155	14	CCAA	TTTT
V350256906L4C004R01000297059	chr1	568339	50M	159	568498	568340	568499	V350256906L4C004R01000297059_chr1_568339	32	68	TGCC	AGGA
V350256906L4C004R01000659741	chr1	929762	50M	172	929934	929763	929935	V350256906L4C004R01000659741_chr1_929762	170	179	caag	ccta
V350256906L4C004R01000724091	chr1	1414895	50M	172	1415067	1414896	1415068	V350256906L4C004R01000724091_chr1_1414895	64	79	cccg	CTGA
V350256906L4C004R01000784879	chr1	951727	50M	157	951884	951728	951885	V350256906L4C004R01000784879_chr1_951727	43	59	cccc	CTGG
V350256906L4C004R01000867586	chr1	1424812	50M	168	1424980	1424813	1424981	V350256906L4C004R01000867586_chr1_1424812	55	56	CACG	ACCT
V350256906L4C004R01001004438	chr1	674930	50M	164	675094	674931	675095	V350256906L4C004R01001004438_chr1_674930	65	60	CTTC	ggcc
V350256906L4C004R01001021596	chr1	1395110	50M	154	1395264	1395111	1395265	V350256906L4C004R01001021596_chr1_1395110	22	41	CCCG	CTCC
V350256906L4C004R01001097098	chr1	32557	50M	177	32734	32558	32735	V350256906L4C004R01001097098_chr1_32557	48	111	GAAG	GCAG
V350256906L4C004R01001406964	chr1	1058552	50M	154	1058706	1058553	1058707	V350256906L4C004R01001406964_chr1_1058552	36	10	CATT	ATGG
V350256906L4C004R01100096745	chr1	46075	50M	201	46276	46076	46277	V350256906L4C004R01100096745_chr1_46075	59	12	CTAA	TGTG
V350256906L4C004R01100309816	chr1	568470	50M	169	568639	568471	568640	V350256906L4C004R01100309816_chr1_568470	53	23	GACT	ATGT
V350256906L4C004R01100700516	chr1	1418815	50M	194	1419009	1418816	1419010	V350256906L4C004R01100700516_chr1_1418815	25	111	ccaa	ggcc
V350256906L4C004R01100735822	chr1	339976	50M	162	340138	339977	340139	V350256906L4C004R01100735822_chr1_339976	60	59	TAGC	acta
V350256906L4C004R01100894425	chr1	1056161	50M	133	1056294	1056162	1056295	V350256906L4C004R01100894425_chr1_1056161	61	0	gtaa	tgtt
V350256906L4C004R01100974345	chr1	760615	50M	172	760787	760616	760788	V350256906L4C004R01100974345_chr1_760615	72	77	CCAC	ATGC
V350256906L4C004R01101270680	chr1	1215529	50M	171	1215700	1215530	1215701	V350256906L4C004R01101270680_chr1_1215529	206	120	accc	gcta
V350256906L4C004R01200207707	chr1	1345447	50M	195	1345642	1345448	1345643	V350256906L4C004R01200207707_chr1_1345447	91	96	ccta	tcct
V350256906L4C004R01200303827	chr1	1091034	50M	204	1091238	1091035	1091239	V350256906L4C004R01200303827_chr1_1091034	99	56	CACT	GCTT
V350256906L4C004R01201320421	chr1	854580	50M	177	854757	854581	854758	V350256906L4C004R01201320421_chr1_854580	0	0	CACC	GGAG
V350256906L4C004R01300081518	chr1	442805	50M	164	442969	442806	442970	V350256906L4C004R01300081518_chr1_442805	36	6	AGTT	TGAG
V350256906L4C004R01400275318	chr1	1205689	50M	136	1205825	1205690	1205826	V350256906L4C004R01400275318_chr1_1205689	46	0	ACTT	CTGC
V350256906L4C004R01400411180	chr1	655181	50M	150	655331	655182	655332	V350256906L4C004R01400411180_chr1_655181	141	0	acct	attt
V350256906L4C004R01400556534	chr1	129656	50M	180	129836	129657	129837	V350256906L4C004R01400556534_chr1_129656	221	41	cccg	gcct
V350256906L4C004R01400626220	chr1	1002221	50M	175	1002396	1002222	1002397	V350256906L4C004R01400626220_chr1_1002221	68	69	GGAG	CCCC
V350256906L4C004R01400761514	chr1	93658	50M	147	93805	93659	93806	V350256906L4C004R01400761514_chr1_93658	2	55	TGTG	ctga
V350256906L4C004R01401041558	chr1	923791	50M	214	924005	923792	924006	V350256906L4C004R01401041558_chr1_923791	59	84	ccct	gagt
V350256906L4C004R01401088331	chr1	73666	50M	171	73837	73667	73838	V350256906L4C004R01401088331_chr1_73666	56	21	acca	ctct
V350256906L4C004R01401203716	chr1	69254	50M	150	69404	69255	69405	V350256906L4C004R01401203716_chr1_69254	51	64	TGCT	TCTC
V350256906L4C004R01401232538	chr1	1409770	50M	179	1409949	1409771	1409950	V350256906L4C004R01401232538_chr1_1409770	0	40	ccat	gaga
V350256906L4C004R01401278937	chr1	747037	50M	150	747187	747038	747188	V350256906L4C004R01401278937_chr1_747037	138	0	GTGG	CAAG
V350256906L4C004R01401311162	chr1	645207	50M	166	645373	645208	645374	V350256906L4C004R01401311162_chr1_645207	181	15	ccag	ccat
V350256906L4C004R01500518137	chr1	1215759	50M	168	1215927	1215760	1215928	V350256906L4C004R01500518137_chr1_1215759	61	63	gcgt	cgat
V350256906L4C004R01600010942	chr1	807824	50M	144	807968	807825	807969	V350256906L4C004R01600010942_chr1_807824	58	60	TATT	AGTC
V350256906L4C004R01600323412	chr1	622329	50M	169	622498	622330	622499	V350256906L4C004R01600323412_chr1_622329	50	0	CAGG	TGCA
V350256906L4C004R01600644381	chr1	1130937	50M	162	1131099	1130938	1131100	V350256906L4C004R01600644381_chr1_1130937	55	24	cttg	gtgg
V350256906L4C004R01600710269	chr1	619425	50M	167	619592	619426	619593	V350256906L4C004R01600710269_chr1_619425	27	49	ccaa	gcct
V350256906L4C004R01600757199	chr1	1299834	50M	178	1300012	1299835	1300013	V350256906L4C004R01600757199_chr1_1299834	24	35	TAGG	tttt
V350256906L4C004R01601142368	chr1	173622	50M	171	173793	173623	173794	V350256906L4C004R01601142368_chr1_173622	0	5	CAAA	GCCA
V350256906L4C004R01601227667	chr1	579272	50M	177	579449	579273	579450	V350256906L4C004R01601227667_chr1_579272	143	121	AGAG	aaat
V350256906L4C004R01601294565	chr1	627809	50M	163	627972	627810	627973	V350256906L4C004R01601294565_chr1_627809	103	100	GTCA	CCTC
V350256906L4C004R01700355328	chr1	640818	50M	172	640990	640819	640991	V350256906L4C004R01700355328_chr1_640818	11	0	caaa	TTTA
V350256906L4C004R01700399493	chr1	32878	50M	175	33053	32879	33054	V350256906L4C004R01700399493_chr1_32878	17	18	tggg	ggac
V350256906L4C004R01700421394	chr1	751915	50M	167	752082	751916	752083	V350256906L4C004R01700421394_chr1_751915	33	52	AAAC	gctt
V350256906L4C004R01700458953	chr1	784600	50M	194	784794	784601	784795	V350256906L4C004R01700458953_chr1_784600	0	0	TGCG	AGTG
V350256906L4C004R01700701464	chr1	1227155	50M	179	1227334	1227156	1227335	V350256906L4C004R01700701464_chr1_1227155	35	0	CCTA	AGCT
V350256906L4C004R01700994272	chr1	1129890	50M	181	1130071	1129891	1130072	V350256906L4C004R01700994272_chr1_1129890	32	0	cggt	caga
V350256906L4C004R01701083718	chr1	716368	50M	172	716540	716369	716541	V350256906L4C004R01701083718_chr1_716368	84	2	GCCC	GATT
V350256906L4C004R01701088115	chr1	1360630	50M	143	1360773	1360631	1360774	V350256906L4C004R01701088115_chr1_1360630	1	144	caag	cctg
V350256906L4C004R01701173312	chr1	626667	50M	174	626841	626668	626842	V350256906L4C004R01701173312_chr1_626667	161	42	TCTC	CCTG
V350256906L4C004R01701192560	chr1	872971	50M	175	873146	872972	873147	V350256906L4C004R01701192560_chr1_872971	0	51	CCCA	CCAC
V350256906L4C004R01701401490	chr1	119528	50M	168	119696	119529	119697	V350256906L4C004R01701401490_chr1_119528	0	90	TTTT	cttc
V350256906L4C004R01800004953	chr1	41882	50M	185	42067	41883	42068	V350256906L4C004R01800004953_chr1_41882	666	481	attg	ctct
V350256906L4C004R01800268117	chr1	13354	50M	164	13518	13355	13519	V350256906L4C004R01800268117_chr1_13354	56	220	TGCC	AGGA
V350256906L4C004R01800608199	chr1	85472	50M	170	85642	85473	85643	V350256906L4C004R01800608199_chr1_85472	145	0	ccta	ttaa
V350256906L4C004R01800698033	chr1	86012	50M	159	86171	86013	86172	V350256906L4C004R01800698033_chr1_86012	7	58	AAAC	ctta
V350256906L4C004R01800759274	chr1	1063302	50M	167	1063469	1063303	1063470	V350256906L4C004R01800759274_chr1_1063302	0	30	CGTT	AGTC
V350256906L4C004R01900004910	chr1	633714	50M	157	633871	633715	633872	V350256906L4C004R01900004910_chr1_633714	148	305	ccag	cccg
V350256906L4C004R01900074216	chr1	639122	50M	170	639292	639123	639293	V350256906L4C004R01900074216_chr1_639122	3	0	CTTT	TACT
V350256906L4C004R01900200644	chr1	913509	50M	120	913629	913510	913630	V350256906L4C004R01900200644_chr1_913509	38	53	CCCC	GGCA
V350256906L4C004R01900213189	chr1	1403105	50M	239	1403344	1403106	1403345	V350256906L4C004R01900213189_chr1_1403105	37	51	CCTC	CACC
V350256906L4C004R01900842138	chr1	454390	50M	198	454588	454391	454589	V350256906L4C004R01900842138_chr1_454390	102	300	acac	ACCC
V350256906L4C004R01900991104	chr1	766758	50M	178	766936	766759	766937	V350256906L4C004R01900991104_chr1_766758	59	58	GAGC	TGAC
V350256906L4C004R01901346867	chr1	36070	50M	136	36206	36071	36207	V350256906L4C004R01901346867_chr1_36070	156	20	CCCC	CAGG
V350256906L4C004R02000019149	chr1	1360982	50M	189	1361171	1360983	1361172	V350256906L4C004R02000019149_chr1_1360982	0	48	CCAC	ACCT
V350256906L4C004R02000391748	chr1	975143	50M	154	975297	975144	975298	V350256906L4C004R02000391748_chr1_975143	32	186	AGAG	CTCC
V350256906L4C004R02000507961	chr1	112408	50M	188	112596	112409	112597	V350256906L4C004R02000507961_chr1_112408	20	208	cgaa	ATTT
V350256906L4C004R02000905372	chr1	460264	50M	210	460474	460265	460475	V350256906L4C004R02000905372_chr1_460264	62	49	TAGG	GCTT
V350256906L4C004R02001097658	chr1	724932	3S34M13S	187	725119	724933	725120	V350256906L4C004R02001097658_chr1_724932	0	149	gaat	tcca
V350256906L4C004R02001213936	chr1	1424493	50M	168	1424661	1424494	1424662	V350256906L4C004R02001213936_chr1_1424493	6	0	CCCT	CCTC
V350256906L4C004R02100051214	chr1	1298723	50M	181	1298904	1298724	1298905	V350256906L4C004R02100051214_chr1_1298723	38	78	aaca	ggca
V350256906L4C004R02100293963	chr1	150260	50M	172	150432	150261	150433	V350256906L4C004R02100293963_chr1_150260	48	22	tcct	tacc
V350256906L4C004R02100534251	chr1	575672	50M	178	575850	575673	575851	V350256906L4C004R02100534251_chr1_575672	56	46	tgtc	caga
V350256906L4C004R02101235276	chr1	233455	50M	155	233610	233456	233611	V350256906L4C004R02101235276_chr1_233455	45	47	ccca	agaa
V350256906L4C004R02101241326	chr1	639921	50M	207	640128	639922	640129	V350256906L4C004R02101241326_chr1_639921	67	53	ACAT	tagg
V350256906L4C004R02200226291	chr1	797836	50M	168	798004	797837	798005	V350256906L4C004R02200226291_chr1_797836	59	34	TACG	AGTT
V350256906L4C004R02200514217	chr1	75477	50M	175	75652	75478	75653	V350256906L4C004R02200514217_chr1_75477	51	226	acat	ggga
V350256906L4C004R02200637089	chr1	580704	50M	165	580869	580705	580870	V350256906L4C004R02200637089_chr1_580704	49	60	ctgc	tcat
V350256906L4C004R02200813800	chr1	1157269	50M	152	1157421	1157270	1157422	V350256906L4C004R02200813800_chr1_1157269	76	43	gcag	ACAC
V350256906L4C004R02201247360	chr1	23631	50M	166	23797	23632	23798	V350256906L4C004R02201247360_chr1_23631	168	2	CCAA	TTGG
V350256906L4C004R02300151809	chr1	123071	50M	156	123227	123072	123228	V350256906L4C004R02300151809_chr1_123071	0	23	ACAC	caga
V350256906L4C004R02300283028	chr1	131533	50M	170	131703	131534	131704	V350256906L4C004R02300283028_chr1_131533	70	48	CCTC	CATG
V350256906L4C004R02300308151	chr1	346339	50M	183	346522	346340	346523	V350256906L4C004R02300308151_chr1_346339	60	18	acat	tatt
V350256906L4C004R02300325706	chr1	1041169	50M	161	1041330	1041170	1041331	V350256906L4C004R02300325706_chr1_1041169	24	2	gcat	TAGA
V350256906L4C004R02301007979	chr1	833369	50M	174	833543	833370	833544	V350256906L4C004R02301007979_chr1_833369	27	64	ctcc	aggg
V350256906L4C004R02301051494	chr1	1021880	50M	150	1022030	1021881	1022031	V350256906L4C004R02301051494_chr1_1021880	53	70	CGGG	CCTG
V350256906L4C004R02400184844	chr1	328827	50M	170	328997	328828	328998	V350256906L4C004R02400184844_chr1_328827	238	68	TGTA	agcc
V350256906L4C004R02400504355	chr1	924071	50M	174	924245	924072	924246	V350256906L4C004R02400504355_chr1_924071	150	219	tgga	ACCC
V350256906L4C004R02400778119	chr1	849152	50M	170	849322	849153	849323	V350256906L4C004R02400778119_chr1_849152	50	66	AACG	CAGG
V350256906L4C004R02400991587	chr1	59212	50M	206	59418	59213	59419	V350256906L4C004R02400991587_chr1_59212	17	23	CCTG	GTAA
V350256906L4C004R02401197728	chr1	47980	50M	190	48170	47981	48171	V350256906L4C004R02401197728_chr1_47980	26	0	CAGA	TGAA
V350256906L4C004R02500384153	chr1	43992	50M	145	44137	43993	44138	V350256906L4C004R02500384153_chr1_43992	28	82	taaa	tgca
V350256906L4C004R02500464684	chr1	368171	50M	216	368387	368172	368388	V350256906L4C004R02500464684_chr1_368171	0	31	TAAT	TGAG
V350256906L4C004R02500524155	chr1	235837	50M	249	236086	235838	236087	V350256906L4C004R02500524155_chr1_235837	0	46	CATA	TACA
V350256906L4C004R02500788010	chr1	468092	50M	163	468255	468093	468256	V350256906L4C004R02500788010_chr1_468092	0	0	cttt	gctt
V350256906L4C004R02500838230	chr1	1398494	50M	168	1398662	1398495	1398663	V350256906L4C004R02500838230_chr1_1398494	67	87	GCTT	CCAA
V350256906L4C004R02501035987	chr1	964559	50M	175	964734	964560	964735	V350256906L4C004R02501035987_chr1_964559	118	32	CCCA	CCCA
V350256906L4C004R02501263435	chr1	888327	50M	151	888478	888328	888479	V350256906L4C004R02501263435_chr1_888327	59	47	TGTG	TGTG
V350256906L4C004R02501339295	chr1	57714	50M	165	57879	57715	57880	V350256906L4C004R02501339295_chr1_57714	57	65	CTAA	ATAG
V350256906L4C004R02501404859	chr1	626278	50M	129	626407	626279	626408	V350256906L4C004R02501404859_chr1_626278	0	64	gaaa	catg
V350256906L4C004R02600297706	chr1	248710	50M	180	248890	248711	248891	V350256906L4C004R02600297706_chr1_248710	68	16	CTGA	aggc
V350256906L4C004R02600400178	chr1	145914	50M	171	146085	145915	146086	V350256906L4C004R02600400178_chr1_145914	63	50	cctc	cccc
V350256906L4C004R02600496245	chr1	699723	50M	191	699914	699724	699915	V350256906L4C004R02600496245_chr1_699723	89	70	actt	ccac
V350256906L4C004R02600523855	chr1	1272208	50M	166	1272374	1272209	1272375	V350256906L4C004R02600523855_chr1_1272208	67	59	CCCT	CCCT
V350256906L4C004R02600678905	chr1	160644	50M	181	160825	160645	160826	V350256906L4C004R02600678905_chr1_160644	113	49	CCCA	CGAA
V350256906L4C004R02600749124	chr1	327261	50M	166	327427	327262	327428	V350256906L4C004R02600749124_chr1_327261	18	0	CCCC	CCTC
V350256906L4C004R02600981071	chr1	650784	50M	162	650946	650785	650947	V350256906L4C004R02600981071_chr1_650784	60	59	TTAA	cagt
V350256906L4C004R02601012060	chr1	634743	50M	177	634920	634744	634921	V350256906L4C004R02601012060_chr1_634743	146	305	ctag	cgga
V350256906L4C004R02601049601	chr1	544075	50M	177	544252	544076	544253	V350256906L4C004R02601049601_chr1_544075	59	162	ACGC	AGAA
V350256906L4C004R02601060366	chr1	1204485	50M	180	1204665	1204486	1204666	V350256906L4C004R02601060366_chr1_1204485	0	180	AAGA	CCCT
V350256906L4C004R02701045599	chr1	788767	50M	117	788884	788768	788885	V350256906L4C004R02701045599_chr1_788767	99	0	acag	CATC
V350256906L4C004R02701253207	chr1	858015	50M	169	858184	858016	858185	V350256906L4C004R02701253207_chr1_858015	66	74	CAGG	ACCA
V350256906L4C004R02701256908	chr1	100947	50M	154	101101	100948	101102	V350256906L4C004R02701256908_chr1_100947	148	40	AGAA	ctcc
V350256906L4C004R02800109001	chr1	151430	50M	173	151603	151431	151604	V350256906L4C004R02800109001_chr1_151430	63	86	ctca	cagc
V350256906L4C004R02800152875	chr1	897324	50M	159	897483	897325	897484	V350256906L4C004R02800152875_chr1_897324	20	0	CGCA	CAAA
V350256906L4C004R02800177524	chr1	87912	50M	204	88116	87913	88117	V350256906L4C004R02800177524_chr1_87912	31	40	CCTC	GGGC
V350256906L4C004R02800536106	chr1	147432	50M	171	147603	147433	147604	V350256906L4C004R02800536106_chr1_147432	98	252	GTca	gttt
V350256906L4C004R02800707523	chr1	85622	50M	214	85836	85623	85837	V350256906L4C004R02800707523_chr1_85622	0	0	acag	tgtg
V350256906L4C004R02900149464	chr1	644687	50M	159	644846	644688	644847	V350256906L4C004R02900149464_chr1_644687	51	24	cata	gtca
V350256906L4C004R02900196878	chr1	169727	50M	166	169893	169728	169894	V350256906L4C004R02900196878_chr1_169727	4	0	CCAG	gaca
V350256906L4C004R03000386538	chr1	1349535	50M	183	1349718	1349536	1349719	V350256906L4C004R03000386538_chr1_1349535	10	17	tgtg	cagt
V350256906L4C004R03000742208	chr1	698865	50M	155	699020	698866	699021	V350256906L4C004R03000742208_chr1_698865	0	53	CCCT	GTTT
V350256906L4C004R03000754008	chr1	146960	50M	181	147141	146961	147142	V350256906L4C004R03000754008_chr1_146960	18	120	tcag	agcc
V350256906L4C004R03000767920	chr1	1266616	50M	164	1266780	1266617	1266781	V350256906L4C004R03000767920_chr1_1266616	0	28	CAAG	CCCA
V350256906L4C004R03000994908	chr1	1006133	50M	178	1006311	1006134	1006312	V350256906L4C004R03000994908_chr1_1006133	68	63	CTCT	TGCA
V350256906L4C004R03001172776	chr1	816742	42M8S	200	816942	816743	816943	V350256906L4C004R03001172776_chr1_816742	188	30	agat	TCTC
V350256906L4C004R03001295380	chr1	141037	50M	152	141189	141038	141190	V350256906L4C004R03001295380_chr1_141037	53	16	acat	tctg
V350256906L4C004R03100231056	chr1	34712	50M	184	34896	34713	34897	V350256906L4C004R03100231056_chr1_34712	70	68	ccat	ctgt
V350256906L4C004R03100269656	chr1	584788	50M	203	584991	584789	584992	V350256906L4C004R03100269656_chr1_584788	13	0	ggtg	ccct
V350256906L4C004R03100401792	chr1	134754	50M	109	134863	134755	134864	V350256906L4C004R03100401792_chr1_134754	0	17	CCAG	TTTT
V350256906L4C004R03100438497	chr1	1080252	50M	170	1080422	1080253	1080423	V350256906L4C004R03100438497_chr1_1080252	0	14	CCCA	CCTG
V350256906L4C004R03100538222	chr1	932622	50M	145	932767	932623	932768	V350256906L4C004R03100538222_chr1_932622	28	0	GGGG	TGAA
V350256906L4C004R03100640402	chr1	370154	50M	116	370270	370155	370271	V350256906L4C004R03100640402_chr1_370154	30	41	cata	ccca
V350256906L4C004R03100808435	chr1	685922	50M	179	686101	685923	686102	V350256906L4C004R03100808435_chr1_685922	68	80	cctt	catg
V350256906L4C004R03100947841	chr1	339983	50M	168	340151	339984	340152	V350256906L4C004R03100947841_chr1_339983	53	57	TACT	ccct
V350256906L4C004R03101076931	chr1	612689	50M	236	612925	612690	612926	V350256906L4C004R03101076931_chr1_612689	0	0	ctcc	gctc
V350256906L4C004R03101248005	chr1	653799	50M	197	653996	653800	653997	V350256906L4C004R03101248005_chr1_653799	49	37	CAAA	ccag
V350256906L4C004R03200045048	chr1	470399	50M	175	470574	470400	470575	V350256906L4C004R03200045048_chr1_470399	33	42	gcat	tcat
V350256906L4C004R03200091796	chr1	90526	50M	170	90696	90527	90697	V350256906L4C004R03200091796_chr1_90526	57	25	agcc	TCCC
V350256906L4C004R03200402630	chr1	1025418	50M	190	1025608	1025419	1025609	V350256906L4C004R03200402630_chr1_1025418	20	34	CCCC	GGGG
V350256906L4C004R03200748109	chr1	53359	50M	179	53538	53360	53539	V350256906L4C004R03200748109_chr1_53359	93	272	TGTC	CTCT
V350256906L4C004R03201026671	chr1	406782	50M	169	406951	406783	406952	V350256906L4C004R03201026671_chr1_406782	227	58	tgtt	ctgt
V350256906L4C004R03300193078	chr1	1367526	50M	142	1367668	1367527	1367669	V350256906L4C004R03300193078_chr1_1367526	31	57	CCCA	TCCT
V350256906L4C004R03300234065	chr1	823666	50M	151	823817	823667	823818	V350256906L4C004R03300234065_chr1_823666	0	2	GCTT	ttct
V350256906L4C004R03300674204	chr1	960232	50M	157	960389	960233	960390	V350256906L4C004R03300674204_chr1_960232	46	71	CGCC	CCAG
V350256906L4C004R03301377035	chr1	1368512	50M	139	1368651	1368513	1368652	V350256906L4C004R03301377035_chr1_1368512	37	24	CAAC	AGAT
V350256906L4C004R03301405479	chr1	1200893	50M	150	1201043	1200894	1201044	V350256906L4C004R03301405479_chr1_1200893	1	69	cAGA	agtg
V350256906L4C004R03400028134	chr1	1343475	50M	141	1343616	1343476	1343617	V350256906L4C004R03400028134_chr1_1343475	38	55	cccc	ggtg
V350256906L4C004R03400043987	chr1	1057343	50M	158	1057501	1057344	1057502	V350256906L4C004R03400043987_chr1_1057343	0	0	CCCT	GGGA
V350256906L4C004R03400498287	chr1	1216956	50M	198	1217154	1216957	1217155	V350256906L4C004R03400498287_chr1_1216956	50	51	CCTA	CTGT
V350256906L4C004R03400530437	chr1	263052	50M	155	263207	263053	263208	V350256906L4C004R03400530437_chr1_263052	64	155	taga	tatt
V350256906L4C004R03400717537	chr1	1316922	50M	151	1317073	1316923	1317074	V350256906L4C004R03400717537_chr1_1316922	73	7	GCCA	TGAG
V350256906L4C004R03401042036	chr1	1038686	50M	165	1038851	1038687	1038852	V350256906L4C004R03401042036_chr1_1038686	91	44	tagg	acat
V350256906L4C004R03401175551	chr1	458974	50M	159	459133	458975	459134	V350256906L4C004R03401175551_chr1_458974	0	9	ggaa	ACCT
V350256906L4C004R03401196480	chr1	812340	50M	183	812523	812341	812524	V350256906L4C004R03401196480_chr1_812340	327	144	GGGT	CAAG
V350256906L4C004R03401262065	chr1	418751	50M	181	418932	418752	418933	V350256906L4C004R03401262065_chr1_418751	48	46	ggct	caaa
V350256906L4C004R03500393819	chr1	973024	50M	172	973196	973025	973197	V350256906L4C004R03500393819_chr1_973024	2	174	GGCA	CAGG
V350256906L4C004R03500830934	chr1	646956	50M	204	647160	646957	647161	V350256906L4C004R03500830934_chr1_646956	287	199	TACA	AGAG
V350256906L4C004R03500952668	chr1	944778	50M	179	944957	944779	944958	V350256906L4C004R03500952668_chr1_944778	33	47	CGgg	cccg
V350256906L4C004R03501030256	chr1	1271332	50M	167	1271499	1271333	1271500	V350256906L4C004R03501030256_chr1_1271332	66	76	CACG	GCCT
V350256906L4C004R03501297360	chr1	978538	50M	176	978714	978539	978715	V350256906L4C004R03501297360_chr1_978538	6	6	GGAC	CGCC
V350256906L4C004R03600493405	chr1	390509	50M	196	390705	390510	390706	V350256906L4C004R03600493405_chr1_390509	1	33	ccta	tccc
V350256906L4C004R03600675937	chr1	1059769	50M	170	1059939	1059770	1059940	V350256906L4C004R03600675937_chr1_1059769	263	93	CACT	CCAA
V350256906L4C004R03600752208	chr1	1362286	50M	208	1362494	1362287	1362495	V350256906L4C004R03600752208_chr1_1362286	56	92	GGCG	ccgt
V350256906L4C004R03600764720	chr1	462213	50M	148	462361	462214	462362	V350256906L4C004R03600764720_chr1_462213	110	258	agtg	cggt
V350256906L4C004R03601092889	chr1	625174	50M	152	625326	625175	625327	V350256906L4C004R03601092889_chr1_625174	39	0	GAAA	AATT
V350256906L4C004R03601235333	chr1	1043963	50M	171	1044134	1043964	1044135	V350256906L4C004R03601235333_chr1_1043963	349	178	ACAG	CGAG
V350256906L4C004R03601355687	chr1	99899	50M	175	100074	99900	100075	V350256906L4C004R03601355687_chr1_99899	58	69	aata	tgac
V350256906L4C004R03700204141	chr1	1026880	50M	186	1027066	1026881	1027067	V350256906L4C004R03700204141_chr1_1026880	39	0	CCCA	ccct
V350256906L4C004R03700421609	chr1	1423624	50M	174	1423798	1423625	1423799	V350256906L4C004R03700421609_chr1_1423624	63	75	ccac	catc
V350256906L4C004R03700476449	chr1	913853	50M	174	914027	913854	914028	V350256906L4C004R03700476449_chr1_913853	277	323	TTGG	GGCC
V350256906L4C004R03700757056	chr1	1103574	50M	152	1103726	1103575	1103727	V350256906L4C004R03700757056_chr1_1103574	47	65	GGGG	CACC
V350256906L4C004R03701360864	chr1	1345907	50M	168	1346075	1345908	1346076	V350256906L4C004R03701360864_chr1_1345907	0	15	ctga	agag
V350256906L4C004R03800787148	chr1	738295	50M	182	738477	738296	738478	V350256906L4C004R03800787148_chr1_738295	6	25	GCCT	ACTT
V350256906L4C004R03801027205	chr1	175107	50M	149	175256	175108	175257	V350256906L4C004R03801027205_chr1_175107	130	243	CAGC	ggct
V350256906L4C004R03801198506	chr1	1355153	50M	177	1355330	1355154	1355331	V350256906L4C004R03801198506_chr1_1355153	50	63	CCCT	CCAG
V350256906L4C004R03801374831	chr1	113636	50M	124	113760	113637	113761	V350256906L4C004R03801374831_chr1_113636	53	51	AGAA	gaaa
V350256906L4C004R03900268744	chr1	1247715	50M	167	1247882	1247716	1247883	V350256906L4C004R03900268744_chr1_1247715	48	64	TGAG	GGCT
V350256906L4C004R03900974264	chr1	328461	50M	160	328621	328462	328622	V350256906L4C004R03900974264_chr1_328461	49	57	TTGG	CCCT
V350256906L4C004R03901400619	chr1	435443	50M	183	435626	435444	435627	V350256906L4C004R03901400619_chr1_435443	65	58	TGAC	AAGA
V350256906L4C004R04000164227	chr1	812951	50M	179	813130	812952	813131	V350256906L4C004R04000164227_chr1_812951	0	133	CCTC	TGCT
V350256906L4C004R04000174650	chr1	972701	50M	182	972883	972702	972884	V350256906L4C004R04000174650_chr1_972701	63	95	TTAC	AACT
V350256906L4C004R04000458686	chr1	1022828	50M	205	1023033	1022829	1023034	V350256906L4C004R04000458686_chr1_1022828	60	59	TCTC	CCCA
V350256906L4C004R04000566474	chr1	941267	50M	174	941441	941268	941442	V350256906L4C004R04000566474_chr1_941267	0	0	CCAG	GAGC
V350256906L4C004R04000613157	chr1	1295597	50M	179	1295776	1295598	1295777	V350256906L4C004R04000613157_chr1_1295597	98	50	CCCA	TCTG
V350256906L4C004R04000978140	chr1	1310033	50M	154	1310187	1310034	1310188	V350256906L4C004R04000978140_chr1_1310033	48	75	GCAC	GGCA
V350256906L4C004R04000995219	chr1	708726	50M	161	708887	708727	708888	V350256906L4C004R04000995219_chr1_708726	154	0	GATG	GCCA
V350256906L4C004R04001277372	chr1	1120823	50M	171	1120994	1120824	1120995	V350256906L4C004R04001277372_chr1_1120823	67	82	TGGC	CTGC
V350256906L4C004R04100400773	chr1	618059	50M	175	618234	618060	618235	V350256906L4C004R04100400773_chr1_618059	53	22	AAGG	GTTT
V350256906L4C004R04100404417	chr1	725727	37M13S	156	725883	725728	725884	V350256906L4C004R04100404417_chr1_725727	156	0	caat	ccaa
V350256906L4C004R04100994642	chr1	1299065	50M	199	1299264	1299066	1299265	V350256906L4C004R04100994642_chr1_1299065	54	41	ccac	cgct
V350256906L4C004R04101234123	chr1	1389323	50M	190	1389513	1389324	1389514	V350256906L4C004R04101234123_chr1_1389323	59	43	CCTA	GCCA
V350256906L4C004R04101334980	chr1	797668	50M	174	797842	797669	797843	V350256906L4C004R04101334980_chr1_797668	62	65	CAAA	ACCG
V350256906L4C004R04101366868	chr1	263710	50M	144	263854	263711	263855	V350256906L4C004R04101366868_chr1_263710	63	16	gcgc	CAAC
V350256906L4C004R04200259517	chr1	13297	50M	171	13468	13298	13469	V350256906L4C004R04200259517_chr1_13297	0	170	GGAC	CTAC
V350256906L4C004R04201050045	chr1	744441	50M	177	744618	744442	744619	V350256906L4C004R04201050045_chr1_744441	3	17	agta	ccca
V350256906L4C004R04300168861	chr1	1391309	50M	162	1391471	1391310	1391472	V350256906L4C004R04300168861_chr1_1391309	61	59	AGCT	CCCC
V350256906L4C004R04300560619	chr1	690903	50M	197	691100	690904	691101	V350256906L4C004R04300560619_chr1_690903	0	29	gtcc	CAGT
V350256906L4C004R04300721903	chr1	1338664	50M	163	1338827	1338665	1338828	V350256906L4C004R04300721903_chr1_1338664	62	36	ccca	catg
V350256906L4C004R04301038083	chr1	579091	50M	141	579232	579092	579233	V350256906L4C004R04301038083_chr1_579091	27	103	CTTA	TATT
V350256906L4C004R04400121235	chr1	781759	50M	170	781929	781760	781930	V350256906L4C004R04400121235_chr1_781759	7	0	atat	ccca
V350256906L4C004R04400123571	chr1	634175	50M	165	634340	634176	634341	V350256906L4C004R04400123571_chr1_634175	129	0	cctc	gttt
V350256906L4C004R04400203879	chr1	538594	50M	140	538734	538595	538735	V350256906L4C004R04400203879_chr1_538594	11	0	aagg	tctc
V350256906L4C004R04400549251	chr1	163124	50M	167	163291	163125	163292	V350256906L4C004R04400549251_chr1_163124	11	11	TTTA	CTTT
V350256906L4C004R04400936550	chr1	756798	50M	167	756965	756799	756966	V350256906L4C004R04400936550_chr1_756798	58	19	CCTG	GTAG
V350256906L4C004R04401018710	chr1	708309	50M	178	708487	708310	708488	V350256906L4C004R04401018710_chr1_708309	29	41	CTTT	CCCT
V350256906L4C004R04401268025	chr1	632111	50M	158	632269	632112	632270	V350256906L4C004R04401268025_chr1_632111	29	54	AAAG	TATT
V350256906L4C004R04401320818	chr1	794841	50M	147	794988	794842	794989	V350256906L4C004R04401320818_chr1_794841	70	28	taac	agac
V350256906L4C004R04500031302	chr1	633868	50M	179	634047	633869	634048	V350256906L4C004R04500031302_chr1_633868	302	257	gggt	gtga
V350256906L4C004R04500034082	chr1	1297801	50M	176	1297977	1297802	1297978	V350256906L4C004R04500034082_chr1_1297801	0	0	ACAC	tgtt
V350256906L4C004R04500506188	chr1	1121787	50M	183	1121970	1121788	1121971	V350256906L4C004R04500506188_chr1_1121787	145	10	acgt	taag
V350256906L4C004R04500512567	chr1	521658	50M	194	521852	521659	521853	V350256906L4C004R04500512567_chr1_521658	145	7	TGCG	ccca
V350256906L4C004R04500863311	chr1	740600	50M	159	740759	740601	740760	V350256906L4C004R04500863311_chr1_740600	21	126	TAGT	GAAA
V350256906L4C004R04501213691	chr1	782626	50M	173	782799	782627	782800	V350256906L4C004R04501213691_chr1_782626	55	67	CCAG	CTCA
V350256906L4C004R04600174678	chr1	682476	50M	170	682646	682477	682647	V350256906L4C004R04600174678_chr1_682476	42	0	ggtg	cctg
V350256906L4C004R04600428074	chr1	1423249	50M	148	1423397	1423250	1423398	V350256906L4C004R04600428074_chr1_1423249	57	69	GCTC	cgcc
V350256906L4C004R04600930649	chr1	642092	50M	145	642237	642093	642238	V350256906L4C004R04600930649_chr1_642092	0	24	GCAC	gtta
V350256906L4C004R04600949221	chr1	1295971	50M	157	1296128	1295972	1296129	V350256906L4C004R04600949221_chr1_1295971	45	55	AAAG	CCAG
V350256906L4C004R04600958951	chr1	1204416	50M	156	1204572	1204417	1204573	V350256906L4C004R04600958951_chr1_1204416	45	87	ACTC	CCTC
V350256906L4C004R04601251424	chr1	39333	50M	151	39484	39334	39485	V350256906L4C004R04601251424_chr1_39333	263	279	tcca	ctta
V350256906L4C004R04700125415	chr1	848969	50M	173	849142	848970	849143	V350256906L4C004R04700125415_chr1_848969	55	60	AGCC	GCCC
V350256906L4C004R04700287118	chr1	846386	50M	203	846589	846387	846590	V350256906L4C004R04700287118_chr1_846386	27	0	CCTG	TTTA
V350256906L4C004R04700732576	chr1	746754	50M	185	746939	746755	746940	V350256906L4C004R04700732576_chr1_746754	30	107	TCAA	CCAT
V350256906L4C004R04700888763	chr1	464785	50M	177	464962	464786	464963	V350256906L4C004R04700888763_chr1_464785	154	232	CCCT	ACCC
V350256906L4C004R04701288717	chr1	787395	50M	211	787606	787396	787607	V350256906L4C004R04701288717_chr1_787395	64	62	GTAC	GTTC
V350256906L4C004R04701360602	chr1	1128156	50M	176	1128332	1128157	1128333	V350256906L4C004R04701360602_chr1_1128156	59	50	CAGT	caaa
V350256906L4C004R04800052035	chr1	782804	50M	177	782981	782805	782982	V350256906L4C004R04800052035_chr1_782804	62	90	CCAT	CCCT
V350256906L4C004R04800201624	chr1	846126	50M	171	846297	846127	846298	V350256906L4C004R04800201624_chr1_846126	28	31	GAAA	GCCA
V350256906L4C004R04801104183	chr1	95826	50M	142	95968	95827	95969	V350256906L4C004R04801104183_chr1_95826	33	59	CCAT	CCCT
V350256906L4C004R04801126090	chr1	389264	50M	148	389412	389265	389413	V350256906L4C004R04801126090_chr1_389264	54	71	ctta	ggaa
V350256906L4C004R04900048887	chr1	370696	50M	155	370851	370697	370852	V350256906L4C004R04900048887_chr1_370696	32	69	cctt	acag
V350256906L4C004R04900154974	chr1	1043810	50M	141	1043951	1043811	1043952	V350256906L4C004R04900154974_chr1_1043810	200	341	CCAC	CGAG
V350256906L4C004R04900241995	chr1	691196	50M	167	691363	691197	691364	V350256906L4C004R04900241995_chr1_691196	30	107	GCCA	TCCA
V350256906L4C004R04900507460	chr1	1272284	50M	182	1272466	1272285	1272467	V350256906L4C004R04900507460_chr1_1272284	7	2	GGCC	CGTG
V350256906L4C004R04900566904	chr1	1426670	50M	169	1426839	1426671	1426840	V350256906L4C004R04900566904_chr1_1426670	78	58	cttt	cccc
V350256906L4C004R04900710550	chr1	98558	50M	127	98685	98559	98686	V350256906L4C004R04900710550_chr1_98558	38	0	TGTA	CCTC
V350256906L4C004R04900754739	chr1	767900	50M	167	768067	767901	768068	V350256906L4C004R04900754739_chr1_767900	51	96	TGAt	CCAT
V350256906L4C004R04901014750	chr1	339172	50M	176	339348	339173	339349	V350256906L4C004R04901014750_chr1_339172	0	0	caaa	gctt
V350256906L4C004R04901054357	chr1	1309188	50M	141	1309329	1309189	1309330	V350256906L4C004R04901054357_chr1_1309188	0	4	CCCC	TCTT
V350256906L4C004R04901320793	chr1	1086425	50M	174	1086599	1086426	1086600	V350256906L4C004R04901320793_chr1_1086425	54	58	CGTG	GCCT
V350256906L4C004R04901328154	chr1	643150	50M	208	643358	643151	643359	V350256906L4C004R04901328154_chr1_643150	77	102	tctg	aaca
V350256906L4C004R04901374273	chr1	890170	50M	166	890336	890171	890337	V350256906L4C004R04901374273_chr1_890170	17	0	ccag	CCTT
V350256906L4C004R05000027100	chr1	100254	50M	172	100426	100255	100427	V350256906L4C004R05000027100_chr1_100254	38	47	tatc	ACAG
V350256906L4C004R05000207837	chr1	733109	50M	174	733283	733110	733284	V350256906L4C004R05000207837_chr1_733109	82	256	CATC	TGTG
V350256906L4C004R05000299833	chr1	587118	50M	166	587284	587119	587285	V350256906L4C004R05000299833_chr1_587118	60	70	tctt	caat
V350256906L4C004R05000351773	chr1	1328619	50M	190	1328809	1328620	1328810	V350256906L4C004R05000351773_chr1_1328619	61	0	GTCT	TGAG
V350256906L4C004R05000362176	chr1	655631	50M	203	655834	655632	655835	V350256906L4C004R05000362176_chr1_655631	52	47	TAAA	ggtt
V350256906L4C004R05000372308	chr1	420098	50M	176	420274	420099	420275	V350256906L4C004R05000372308_chr1_420098	0	0	tgag	CCTG
V350256906L4C004R05000650091	chr1	787623	50M	198	787821	787624	787822	V350256906L4C004R05000650091_chr1_787623	45	20	TATC	TAAT
V350256906L4C004R05001003660	chr1	158224	50M	176	158400	158225	158401	V350256906L4C004R05001003660_chr1_158224	12	127	GGaa	GAAA
V350256906L4C004R05001035639	chr1	130669	50M	147	130816	130670	130817	V350256906L4C004R05001035639_chr1_130669	0	25	acaa	cagg
V350256906L4C004R05001210855	chr1	145874	50M	211	146085	145875	146086	V350256906L4C004R05001210855_chr1_145874	37	50	tgac	cccc
V350256906L4C004R05001342793	chr1	779751	50M	176	779927	779752	779928	V350256906L4C004R05001342793_chr1_779751	21	10	ACTG	CATT
V350256906L4C004R05100285863	chr1	350557	50M	203	350760	350558	350761	V350256906L4C004R05100285863_chr1_350557	20	0	tcca	ctaa
V350256906L4C004R05100512245	chr1	13803	50M	174	13977	13804	13978	V350256906L4C004R05100512245_chr1_13803	56	55	CCTG	CTCA
V350256906L4C004R05100675327	chr1	1068876	50M	178	1069054	1068877	1069055	V350256906L4C004R05100675327_chr1_1068876	26	8	CCCC	GGGA
V350256906L4C004R05100685716	chr1	399574	50M	166	399740	399575	399741	V350256906L4C004R05100685716_chr1_399574	75	0	ccca	caga
V350256906L4C004R05100689303	chr1	1300850	50M	174	1301024	1300851	1301025	V350256906L4C004R05100689303_chr1_1300850	173	0	acta	attt
V350256906L4C004R05200072204	chr1	976048	50M	169	976217	976049	976218	V350256906L4C004R05200072204_chr1_976048	4	149	GCCG	CACT
V350256906L4C004R05200081101	chr1	87940	50M	185	88125	87941	88126	V350256906L4C004R05200081101_chr1_87940	59	49	CACT	GTTG
V350256906L4C004R05200415910	chr1	461386	50M	172	461558	461387	461559	V350256906L4C004R05200415910_chr1_461386	249	77	ccca	gcct
V350256906L4C004R05200740717	chr1	617495	50M	172	617667	617496	617668	V350256906L4C004R05200740717_chr1_617495	46	50	gttg	tgca
V350256906L4C004R05200870251	chr1	41235	50M	170	41405	41236	41406	V350256906L4C004R05200870251_chr1_41235	24	194	CAAC	tgag
V350256906L4C004R05200905632	chr1	33697	50M	202	33899	33698	33900	V350256906L4C004R05200905632_chr1_33697	160	8	cccc	acat
V350256906L4C004R05201063321	chr1	1077186	50M	185	1077371	1077187	1077372	V350256906L4C004R05201063321_chr1_1077186	93	64	CCTG	GGGT
V350256906L4C004R05201159302	chr1	656992	50M	190	657182	656993	657183	V350256906L4C004R05201159302_chr1_656992	10	22	cttc	cccg
V350256906L4C004R05300100501	chr1	715404	50M	164	715568	715405	715569	V350256906L4C004R05300100501_chr1_715404	0	0	cgca	CCTG
V350256906L4C004R05300134325	chr1	1191032	50M	153	1191185	1191033	1191186	V350256906L4C004R05300134325_chr1_1191032	150	53	ACTG	CTGA
V350256906L4C004R05300681293	chr1	1245412	50M	190	1245602	1245413	1245603	V350256906L4C004R05300681293_chr1_1245412	0	0	CCAG	GGAG
V350256906L4C004R05301023317	chr1	1409311	50M	167	1409478	1409312	1409479	V350256906L4C004R05301023317_chr1_1409311	63	68	GGGG	gact
V350256906L4C004R05301078188	chr1	1086615	50M	164	1086779	1086616	1086780	V350256906L4C004R05301078188_chr1_1086615	42	62	CTCA	CGAG
V350256906L4C004R05400100006	chr1	1362114	50M	175	1362289	1362115	1362290	V350256906L4C004R05400100006_chr1_1362114	228	53	CCCA	GCCC
V350256906L4C004R05400185153	chr1	761347	50M	136	761483	761348	761484	V350256906L4C004R05400185153_chr1_761347	113	0	ACAG	TTTT
V350256906L4C004R05400662543	chr1	1171806	50M	186	1171992	1171807	1171993	V350256906L4C004R05400662543_chr1_1171806	9	5	AAGG	CTCC
V350256906L4C004R05400889578	chr1	149241	50M	198	149439	149242	149440	V350256906L4C004R05400889578_chr1_149241	46	118	GGGG	ccca
V350256906L4C004R05400990471	chr1	816900	50M	210	817110	816901	817111	V350256906L4C004R05400990471_chr1_816900	72	5	CAAC	CTTA
V350256906L4C004R05401088323	chr1	1426572	50M	161	1426733	1426573	1426734	V350256906L4C004R05401088323_chr1_1426572	22	15	CCAG	cgac
V350256906L4C004R05401168701	chr1	767287	50M	171	767458	767288	767459	V350256906L4C004R05401168701_chr1_767287	48	29	CTTA	CCTC
V350256906L4C004R05500582042	chr1	852259	50M	157	852416	852260	852417	V350256906L4C004R05500582042_chr1_852259	56	44	CTTT	CTTC
V350256906L4C004R05500759914	chr1	425638	50M	159	425797	425639	425798	V350256906L4C004R05500759914_chr1_425638	0	17	GGAT	CCTT
V350256906L4C004R05500875582	chr1	773388	50M	163	773551	773389	773552	V350256906L4C004R05500875582_chr1_773388	57	82	ctca	cctc
V350256906L4C004R05500945103	chr1	989823	50M	134	989957	989824	989958	V350256906L4C004R05500945103_chr1_989823	8	6	CCCA	TCTC
V350256906L4C004R05501181408	chr1	960716	50M	166	960882	960717	960883	V350256906L4C004R05501181408_chr1_960716	36	20	GCCT	TGGG
V350256906L4C004R05501299312	chr1	725542	10S40M	141	725683	725543	725684	V350256906L4C004R05501299312_chr1_725542	26	167	gaat	ccat
V350256906L4C004R05600164710	chr1	111913	50M	170	112083	111914	112084	V350256906L4C004R05600164710_chr1_111913	80	45	CCTG	CAAA
V350256906L4C004R05600646083	chr1	365894	50M	159	366053	365895	366054	V350256906L4C004R05600646083_chr1_365894	0	124	AGAG	CACA
V350256906L4C004R05600805196	chr1	754950	50M	172	755122	754951	755123	V350256906L4C004R05600805196_chr1_754950	0	67	CCAC	gtgg
V350256906L4C004R05600879726	chr1	919895	50M	183	920078	919896	920079	V350256906L4C004R05600879726_chr1_919895	50	48	CCAT	actg
V350256906L4C004R05600921651	chr1	740691	50M	148	740839	740692	740840	V350256906L4C004R05600921651_chr1_740691	58	206	TCCA	TGAT
V350256906L4C004R05700346262	chr1	372432	50M	170	372602	372433	372603	V350256906L4C004R05700346262_chr1_372432	0	129	aaac	taca
V350256906L4C004R05700383597	chr1	60203	50M	177	60380	60204	60381	V350256906L4C004R05700383597_chr1_60203	64	66	CCAT	gTAC
V350256906L4C004R05700624199	chr1	467571	50M	141	467712	467572	467713	V350256906L4C004R05700624199_chr1_467571	57	31	cccc	ccaa
V350256906L4C004R05700824574	chr1	673533	50M	211	673744	673534	673745	V350256906L4C004R05700824574_chr1_673533	150	34	CCAT	aaca
V350256906L4C004R05701210659	chr1	983241	50M	174	983415	983242	983416	V350256906L4C004R05701210659_chr1_983241	64	51	GCCG	CGTG
V350256906L4C004R05701230538	chr1	471134	50M	162	471296	471135	471297	V350256906L4C004R05701230538_chr1_471134	56	86	ATCA	CAGG
V350256906L4C004R05800055671	chr1	846808	50M	171	846979	846809	846980	V350256906L4C004R05800055671_chr1_846808	28	171	CGCC	CCCT
V350256906L4C004R05800182420	chr1	675109	50M	169	675278	675110	675279	V350256906L4C004R05800182420_chr1_675109	75	18	cgtg	CAAC
V350256906L4C004R05800184614	chr1	729484	50M	190	729674	729485	729675	V350256906L4C004R05800184614_chr1_729484	51	241	tcat	CCCC
V350256906L4C004R05800189433	chr1	746705	50M	152	746857	746706	746858	V350256906L4C004R05800189433_chr1_746705	45	25	TAGA	CTGT
V350256906L4C004R05800264224	chr1	904145	50M	131	904276	904146	904277	V350256906L4C004R05800264224_chr1_904145	0	38	gcaa	CCCC
V350256906L4C004R05800458248	chr1	1122673	50M	197	1122870	1122674	1122871	V350256906L4C004R05800458248_chr1_1122673	33	129	ccat	cctg
V350256906L4C004R05800991977	chr1	725632	50M	211	725843	725633	725844	V350256906L4C004R05800991977_chr1_725632	116	40	aact	caat
V350256906L4C004R05801182333	chr1	1016403	50M	157	1016560	1016404	1016561	V350256906L4C004R05801182333_chr1_1016403	46	64	CCTT	GAAG
V350256906L4C004R05900130738	chr1	1299987	50M	173	1300160	1299988	1300161	V350256906L4C004R05900130738_chr1_1299987	60	52	TGAT	atag
V350256906L4C004R05900603218	chr1	1034110	50M	191	1034301	1034111	1034302	V350256906L4C004R05900603218_chr1_1034110	23	0	gcct	caca
V350256906L4C004R05901052143	chr1	897751	50M	166	897917	897752	897918	V350256906L4C004R05901052143_chr1_897751	79	34	CTAG	CCAG
V350256906L4C004R05901118282	chr1	176570	50M	171	176741	176571	176742	V350256906L4C004R05901118282_chr1_176570	159	0	GCAC	TGAT
V350256906L4C004R05901151222	chr1	1077457	50M	183	1077640	1077458	1077641	V350256906L4C004R05901151222_chr1_1077457	0	0	CTGT	caga
V350256906L4C004R05901237202	chr1	954330	50M	121	954451	954331	954452	V350256906L4C004R05901237202_chr1_954330	137	55	tagg	ctga
V350256906L4C004R06000176196	chr1	1027550	50M	170	1027720	1027551	1027721	V350256906L4C004R06000176196_chr1_1027550	16	37	GGTG	CCCG
V350256906L4C004R06000438138	chr1	911238	50M	143	911381	911239	911382	V350256906L4C004R06000438138_chr1_911238	65	50	cccc	ACCA
V350256906L4C004R06000540048	chr1	12874	19M1D31M	190	13064	12875	13065	V350256906L4C004R06000540048_chr1_12874	135	25	CTAT	GCCA
V350256906L4C004R06000568677	chr1	783381	50M	156	783537	783382	783538	V350256906L4C004R06000568677_chr1_783381	0	106	GCTG	CCAA
V350256906L4C004R06000719718	chr1	325739	50M	190	325929	325740	325930	V350256906L4C004R06000719718_chr1_325739	60	68	CCCT	GGCC
V350256906L4C004R06000743207	chr1	658179	50M	135	658314	658180	658315	V350256906L4C004R06000743207_chr1_658179	100	11	TGAG	CCGC
V350256906L4C004R06001014017	chr1	68659	50M	176	68835	68660	68836	V350256906L4C004R06001014017_chr1_68659	98	34	ggcc	CCAT
V350256906L4C004R06001018203	chr1	611592	50M	169	611761	611593	611762	V350256906L4C004R06001018203_chr1_611592	1	27	caca	ggag
V350256906L4C004R06001062070	chr1	725592	50M	249	725841	725593	725842	V350256906L4C004R06001062070_chr1_725592	76	42	gaat	attc
V350256906L4C004R06001284820	chr1	925030	50M	201	925231	925031	925232	V350256906L4C004R06001284820_chr1_925030	63	94	gtca	tatg
V350256906L4C004R06001318047	chr1	821603	32M18S	158	821761	821604	821762	V350256906L4C004R06001318047_chr1_821603	26	11	ctgc	ctat
V350256906L4C004R06100083239	chr1	1061408	50M	173	1061581	1061409	1061582	V350256906L4C004R06100083239_chr1_1061408	41	100	CCAG	GCAG
V350256906L4C004R06100194821	chr1	451221	50M	153	451374	451222	451375	V350256906L4C004R06100194821_chr1_451221	64	26	ttgt	taCC
V350256906L4C004R06100232051	chr1	167207	50M	180	167387	167208	167388	V350256906L4C004R06100232051_chr1_167207	70	13	cgcc	aggc
V350256906L4C004R06100239975	chr1	1032488	50M	141	1032629	1032489	1032630	V350256906L4C004R06100239975_chr1_1032488	58	0	tgct	tgta
V350256906L4C004R06100387902	chr1	924219	50M	198	924417	924220	924418	V350256906L4C004R06100387902_chr1_924219	245	47	GGTT	CCAG
V350256906L4C004R06100885873	chr1	1018991	50M	155	1019146	1018992	1019147	V350256906L4C004R06100885873_chr1_1018991	12	68	TTGG	GGAC
V350256906L4C004R06101099416	chr1	38926	50M	157	39083	38927	39084	V350256906L4C004R06101099416_chr1_38926	63	13	gcaa	acga
V350256906L4C004R06101299639	chr1	1331191	50M	161	1331352	1331192	1331353	V350256906L4C004R06101299639_chr1_1331191	61	66	CTTT	ctcc
V350256906L4C004R06200079105	chr1	376030	50M	169	376199	376031	376200	V350256906L4C004R06200079105_chr1_376030	68	0	cttt	gcca
V350256906L4C004R06200904078	chr1	906731	50M	131	906862	906732	906863	V350256906L4C004R06200904078_chr1_906731	64	24	TACC	TCCT
V350256906L4C004R06201084539	chr1	10332	50M	131	10463	10333	10464	V350256906L4C004R06201084539_chr1_10332	191	60	ccta	aggg
V350256906L4C004R06201124537	chr1	804231	50M	156	804387	804232	804388	V350256906L4C004R06201124537_chr1_804231	16	48	CAGC	ACAA
V350256906L4C004R06300277495	chr1	937931	50M	171	938102	937932	938103	V350256906L4C004R06300277495_chr1_937931	55	61	tgta	tgtg
V350256906L4C004R06300340076	chr1	582682	50M	169	582851	582683	582852	V350256906L4C004R06300340076_chr1_582682	15	121	cgtc	ccta
V350256906L4C004R06300871736	chr1	16433	50M	186	16619	16434	16620	V350256906L4C004R06300871736_chr1_16433	188	54	CCAG	CGTC
V350256906L4C004R06301267335	chr1	753357	50M	168	753525	753358	753526	V350256906L4C004R06301267335_chr1_753357	0	75	CCGC	aaag
V350256906L4C004R06301333804	chr1	693973	50M	175	694148	693974	694149	V350256906L4C004R06301333804_chr1_693973	50	33	ccca	cagc
V350256906L4C004R06401017037	chr1	1197160	50M	183	1197343	1197161	1197344	V350256906L4C004R06401017037_chr1_1197160	6	57	ggga	tcac
V350256906L4C004R06401036752	chr1	881907	50M	150	882057	881908	882058	V350256906L4C004R06401036752_chr1_881907	0	41	CCCG	CCCT
V350256906L4C004R06500037887	chr1	727131	50M	221	727352	727132	727353	V350256906L4C004R06500037887_chr1_727131	65	55	GAGT	agcc
V350256906L4C004R06500335519	chr1	949644	50M	165	949809	949645	949810	V350256906L4C004R06500335519_chr1_949644	25	13	CCTA	TGAA
V350256906L4C004R06500341776	chr1	831232	50M	181	831413	831233	831414	V350256906L4C004R06500341776_chr1_831232	141	150	cccc	ccct
V350256906L4C004R06501010839	chr1	84110	50M	155	84265	84111	84266	V350256906L4C004R06501010839_chr1_84110	0	147	cctt	taca
V350256906L4C004R06501362098	chr1	1140577	50M	166	1140743	1140578	1140744	V350256906L4C004R06501362098_chr1_1140577	55	55	CAGA	CTGG
V350256906L4C004R06600491070	chr1	753562	50M	205	753767	753563	753768	V350256906L4C004R06600491070_chr1_753562	38	0	tcat	GCTC
V350256906L4C004R06601237371	chr1	984667	50M	188	984855	984668	984856	V350256906L4C004R06601237371_chr1_984667	0	183	GCCG	ACAC
V350256906L4C004R06601389733	chr1	163489	50M	159	163648	163490	163649	V350256906L4C004R06601389733_chr1_163489	5	0	TGCT	CCCC
V350256906L4C004R06700823598	chr1	917524	50M	184	917708	917525	917709	V350256906L4C004R06700823598_chr1_917524	36	0	CCTC	CTGC
V350256906L4C004R06701206240	chr1	229240	50M	201	229441	229241	229442	V350256906L4C004R06701206240_chr1_229240	0	38	ctag	ccag
V350256906L4C004R06701279418	chr1	579426	50M	205	579631	579427	579632	V350256906L4C004R06701279418_chr1_579426	144	34	agag	tgct
V350256906L4C004R06800683483	chr1	972146	50M	176	972322	972147	972323	V350256906L4C004R06800683483_chr1_972146	38	49	CCAG	CCCC
V350256906L4C004R06801020606	chr1	142877	50M	216	143093	142878	143094	V350256906L4C004R06801020606_chr1_142877	0	42	TCCC	CATA
V350256906L4C004R06801128166	chr1	110475	50M	170	110645	110476	110646	V350256906L4C004R06801128166_chr1_110475	9	15	ccat	tcca
V350256906L4C004R06801151544	chr1	680323	50M	183	680506	680324	680507	V350256906L4C004R06801151544_chr1_680323	0	117	ccag	acct
V350256906L4C004R06900044702	chr1	246597	50M	173	246770	246598	246771	V350256906L4C004R06900044702_chr1_246597	5	23	cagt	CCTG
V350256906L4C004R06900317187	chr1	884794	50M	211	885005	884795	885006	V350256906L4C004R06900317187_chr1_884794	37	19	TGCC	CTGT
V350256906L4C004R06900428004	chr1	1088502	50M	163	1088665	1088503	1088666	V350256906L4C004R06900428004_chr1_1088502	0	29	GGGA	GATA
V350256906L4C004R06900486195	chr1	1185029	50M	141	1185170	1185030	1185171	V350256906L4C004R06900486195_chr1_1185029	0	33	CCCC	gctg
V350256906L4C004R06900570337	chr1	812750	50M	164	812914	812751	812915	V350256906L4C004R06900570337_chr1_812750	61	20	CTTG	AATC
V350256906L4C004R06900809564	chr1	920626	50M	181	920807	920627	920808	V350256906L4C004R06900809564_chr1_920626	55	73	ccaa	ctct
V350256906L4C004R06900817646	chr1	1102407	50M	143	1102550	1102408	1102551	V350256906L4C004R06900817646_chr1_1102407	292	149	CCCA	GGCA
V350256906L4C004R06900910062	chr1	1317967	50M	162	1318129	1317968	1318130	V350256906L4C004R06900910062_chr1_1317967	264	102	ACCC	GAAG
V350256906L4C004R06901289841	chr1	72144	50M	174	72318	72145	72319	V350256906L4C004R06901289841_chr1_72144	0	173	cata	ggat
V350256906L4C004R07000806389	chr1	973952	50M	171	974123	973953	974124	V350256906L4C004R07000806389_chr1_973952	71	65	GCCA	GCTG
V350256906L4C004R07000814881	chr1	40016	50M	141	40157	40017	40158	V350256906L4C004R07000814881_chr1_40016	67	0	tcag	ctca
V350256906L4C004R07000949707	chr1	409046	50M	189	409235	409047	409236	V350256906L4C004R07000949707_chr1_409046	59	74	ctaa	AGAG
V350256906L4C004R07001036263	chr1	15111	50M	171	15282	15112	15283	V350256906L4C004R07001036263_chr1_15111	63	29	CCAT	tccc
V350256906L4C004R07001175965	chr1	651639	50M	176	651815	651640	651816	V350256906L4C004R07001175965_chr1_651639	0	0	CCCA	GAGC
V350256906L4C004R07100009828	chr1	682568	50M	173	682741	682569	682742	V350256906L4C004R07100009828_chr1_682568	0	23	caag	CTCt
V350256906L4C004R07100229703	chr1	1354061	50M	169	1354230	1354062	1354231	V350256906L4C004R07100229703_chr1_1354061	0	0	gttt	ggga
V350256906L4C004R07101183894	chr1	854863	50M	150	855013	854864	855014	V350256906L4C004R07101183894_chr1_854863	62	47	GCCA	CCCT
V350256906L4C004R07200413871	chr1	860672	50M	218	860890	860673	860891	V350256906L4C004R07200413871_chr1_860672	129	0	GGGA	CTTT
V350256906L4C004R07200920930	chr1	534616	50M	186	534802	534617	534803	V350256906L4C004R07200920930_chr1_534616	52	61	caca	gcag
V350256906L4C004R07201070746	chr1	170195	50M	185	170380	170196	170381	V350256906L4C004R07201070746_chr1_170195	167	352	CTTG	CATC
V350256906L4C004R07201136309	chr1	556698	50M	180	556878	556699	556879	V350256906L4C004R07201136309_chr1_556698	13	35	actc	CTGT
V350256906L4C004R07201265741	chr1	255031	50M	166	255197	255032	255198	V350256906L4C004R07201265741_chr1_255031	52	94	CCTC	GATC
V350256906L4C005R00100019980	chr1	1149562	50M	185	1149747	1149563	1149748	V350256906L4C005R00100019980_chr1_1149562	4	0	GGAC	CTGT
V350256906L4C005R00100037886	chr1	875265	50M	168	875433	875266	875434	V350256906L4C005R00100037886_chr1_875265	28	34	CCAG	CCCC
V350256906L4C005R00100070740	chr1	466990	50M	196	467186	466991	467187	V350256906L4C005R00100070740_chr1_466990	56	70	TGTG	TTTT
V350256906L4C005R00100086815	chr1	175850	50M	183	176033	175851	176034	V350256906L4C005R00100086815_chr1_175850	57	240	ccaa	gtag
V350256906L4C005R00100496110	chr1	19847	50M	237	20084	19848	20085	V350256906L4C005R00100496110_chr1_19847	49	237	GCAC	ccag
V350256906L4C005R00101015583	chr1	382292	50M	166	382458	382293	382459	V350256906L4C005R00101015583_chr1_382292	31	9	gctg	cacc
V350256906L4C005R00101089558	chr1	57758	50M	173	57931	57759	57932	V350256906L4C005R00101089558_chr1_57758	13	41	CCAA	GAAA
V350256906L4C005R00101119510	chr1	1217777	50M	168	1217945	1217778	1217946	V350256906L4C005R00101119510_chr1_1217777	54	19	CCCA	TGTG
V350256906L4C005R00201079483	chr1	1032697	50M	185	1032882	1032698	1032883	V350256906L4C005R00201079483_chr1_1032697	67	54	gcct	ggtt
V350256906L4C005R00201159476	chr1	1283387	50M	156	1283543	1283388	1283544	V350256906L4C005R00201159476_chr1_1283387	73	35	CAAG	CCTG
V350256906L4C005R00201282358	chr1	761346	50M	183	761529	761347	761530	V350256906L4C005R00201282358_chr1_761346	114	43	CACA	TATA
V350256906L4C005R00300062064	chr1	173122	50M	205	173327	173123	173328	V350256906L4C005R00300062064_chr1_173122	0	12	CGAA	TGAT
V350256906L4C005R00300290130	chr1	76308	50M	167	76475	76309	76476	V350256906L4C005R00300290130_chr1_76308	86	237	cgct	ccat
V350256906L4C005R00300316973	chr1	1103709	50M	173	1103882	1103710	1103883	V350256906L4C005R00300316973_chr1_1103709	63	41	GGCT	CCCT
V350256906L4C005R00300682965	chr1	112009	50M	204	112213	112010	112214	V350256906L4C005R00300682965_chr1_112009	0	0	TATA	aaaa
V350256906L4C005R00300814313	chr1	833313	50M	159	833472	833314	833473	V350256906L4C005R00300814313_chr1_833313	55	37	ggca	ccgt
V350256906L4C005R00300814314	chr1	833313	50M	159	833472	833314	833473	V350256906L4C005R00300814314_chr1_833313	55	37	ggca	ccgt
V350256906L4C005R00300886430	chr1	451476	50M	177	451653	451477	451654	V350256906L4C005R00300886430_chr1_451476	128	112	tgaa	taca
V350256906L4C005R00301332683	chr1	334505	50M	130	334635	334506	334636	V350256906L4C005R00301332683_chr1_334505	51	65	cgag	ccaa
V350256906L4C005R00400266428	chr1	1143724	50M	164	1143888	1143725	1143889	V350256906L4C005R00400266428_chr1_1143724	0	0	TCCC	AGGG
V350256906L4C005R00400324851	chr1	759143	50M	171	759314	759144	759315	V350256906L4C005R00400324851_chr1_759143	0	7	AATA	GACT
V350256906L4C005R00401339613	chr1	1245078	50M	197	1245275	1245079	1245276	V350256906L4C005R00401339613_chr1_1245078	66	90	CCAT	CGTG
V350256906L4C005R00500222671	chr1	656154	50M	187	656341	656155	656342	V350256906L4C005R00500222671_chr1_656154	53	46	tgca	attc
V350256906L4C005R00500243849	chr1	665764	50M	204	665968	665765	665969	V350256906L4C005R00500243849_chr1_665764	242	38	TGGA	tgtt
V350256906L4C005R00500415413	chr1	976455	47M3S	164	976619	976456	976620	V350256906L4C005R00500415413_chr1_976455	0	46	agcg	CGTC
V350256906L4C005R00500550491	chr1	751100	50M	147	751247	751101	751248	V350256906L4C005R00500550491_chr1_751100	21	61	gact	TGAC
V350256906L4C005R00501057373	chr1	1140808	50M	173	1140981	1140809	1140982	V350256906L4C005R00501057373_chr1_1140808	0	0	AGGG	CTGT
V350256906L4C005R00501296053	chr1	256660	50M	180	256840	256661	256841	V350256906L4C005R00501296053_chr1_256660	149	140	tgtt	ctat
V350256906L4C005R00600140842	chr1	1027892	50M	194	1028086	1027893	1028087	V350256906L4C005R00600140842_chr1_1027892	97	189	CAAA	GACC
V350256906L4C005R00600439826	chr1	152909	50M	179	153088	152910	153089	V350256906L4C005R00600439826_chr1_152909	609	430	cccg	agca
V350256906L4C005R00600547812	chr1	1150825	50M	171	1150996	1150826	1150997	V350256906L4C005R00600547812_chr1_1150825	19	21	CCCT	CAAG
V350256906L4C005R00600571738	chr1	1087668	50M	189	1087857	1087669	1087858	V350256906L4C005R00600571738_chr1_1087668	66	60	ctga	CGAT
V350256906L4C005R00600831714	chr1	642636	50M	173	642809	642637	642810	V350256906L4C005R00600831714_chr1_642636	0	6	CTGA	tagc
V350256906L4C005R00601106159	chr1	107630	50M	159	107789	107631	107790	V350256906L4C005R00601106159_chr1_107630	75	68	cctt	tagc
V350256906L4C005R00601309952	chr1	134905	50M	158	135063	134906	135064	V350256906L4C005R00601309952_chr1_134905	59	217	ACCA	GTGG
V350256906L4C005R00700383577	chr1	1264548	50M	176	1264724	1264549	1264725	V350256906L4C005R00700383577_chr1_1264548	5	8	ACCC	TGAC
V350256906L4C005R00700772331	chr1	664869	50M	198	665067	664870	665068	V350256906L4C005R00700772331_chr1_664869	57	83	GGGC	CAGA
V350256906L4C005R00700855804	chr1	785097	50M	152	785249	785098	785250	V350256906L4C005R00700855804_chr1_785097	73	50	gcac	taac
V350256906L4C005R00700881428	chr1	688394	50M	175	688569	688395	688570	V350256906L4C005R00700881428_chr1_688394	162	249	aagg	gcca
V350256906L4C005R00700937869	chr1	750700	50M	176	750876	750701	750877	V350256906L4C005R00700937869_chr1_750700	208	64	cact	CCTA
V350256906L4C005R00700955760	chr1	120108	50M	168	120276	120109	120277	V350256906L4C005R00700955760_chr1_120108	201	33	CTAA	CTGA
V350256906L4C005R00700995314	chr1	1028159	50M	159	1028318	1028160	1028319	V350256906L4C005R00700995314_chr1_1028159	116	21	CCAG	gctg
V350256906L4C005R00701171356	chr1	820959	2S48M	165	821124	820960	821125	V350256906L4C005R00701171356_chr1_820959	35	70	tctc	caga
V350256906L4C005R00701272402	chr1	1108475	50M	164	1108639	1108476	1108640	V350256906L4C005R00701272402_chr1_1108475	69	69	aaca	ccga
V350256906L4C005R00701396005	chr1	657913	50M	176	658089	657914	658090	V350256906L4C005R00701396005_chr1_657913	91	190	CCTG	CCTG
V350256906L4C005R00800089964	chr1	813541	50M	163	813704	813542	813705	V350256906L4C005R00800089964_chr1_813541	464	301	TTAA	CCTG
V350256906L4C005R00800986483	chr1	384210	50M	153	384363	384211	384364	V350256906L4C005R00800986483_chr1_384210	0	88	TCAT	gcta
V350256906L4C005R00801201404	chr1	857883	50M	247	858130	857884	858131	V350256906L4C005R00801201404_chr1_857883	22	20	TGGT	CCTT
V350256906L4C005R00900222959	chr1	1345256	50M	158	1345414	1345257	1345415	V350256906L4C005R00900222959_chr1_1345256	36	58	catt	tcaa
V350256906L4C005R00900440914	chr1	833403	50M	143	833546	833404	833547	V350256906L4C005R00900440914_chr1_833403	0	61	cgaa	cgaa
V350256906L4C005R00900459173	chr1	938131	50M	182	938313	938132	938314	V350256906L4C005R00900459173_chr1_938131	44	29	cctg	cggt
V350256906L4C005R00900465759	chr1	467068	50M	171	467239	467069	467240	V350256906L4C005R00900465759_chr1_467068	134	17	TGCA	cgat
V350256906L4C005R00900880154	chr1	95909	50M	156	96065	95910	96066	V350256906L4C005R00900880154_chr1_95909	0	0	GGAG	CTCA
V350256906L4C005R00900889432	chr1	1369570	50M	185	1369755	1369571	1369756	V350256906L4C005R00900889432_chr1_1369570	60	65	CCGC	CTGG
V350256906L4C005R00900966672	chr1	761988	50M	148	762136	761989	762137	V350256906L4C005R00900966672_chr1_761988	87	50	CCCT	CTGA
V350256906L4C005R00901096290	chr1	820976	50M	177	821153	820977	821154	V350256906L4C005R00901096290_chr1_820976	18	41	ctgc	atga
V350256906L4C005R01000938925	chr1	801722	50M	172	801894	801723	801895	V350256906L4C005R01000938925_chr1_801722	38	7	caga	AGAC
V350256906L4C005R01001227899	chr1	1070680	50M	174	1070854	1070681	1070855	V350256906L4C005R01001227899_chr1_1070680	49	73	ccgg	agaa
V350256906L4C005R01100247789	chr1	53361	50M	156	53517	53362	53518	V350256906L4C005R01100247789_chr1_53361	95	251	TCAT	ATAC
V350256906L4C005R01100415450	chr1	342739	50M	203	342942	342740	342943	V350256906L4C005R01100415450_chr1_342739	108	39	GACT	TAGG
V350256906L4C005R01100510695	chr1	627912	50M	167	628079	627913	628080	V350256906L4C005R01100510695_chr1_627912	160	0	GGAT	TAGC
V350256906L4C005R01101161523	chr1	602552	50M	159	602711	602553	602712	V350256906L4C005R01101161523_chr1_602552	145	24	ccaa	ctaa
V350256906L4C005R01101288907	chr1	924176	50M	200	924376	924177	924377	V350256906L4C005R01101288907_chr1_924176	255	88	TGAT	ACTC
V350256906L4C005R01101296487	chr1	125992	50M	170	126162	125993	126163	V350256906L4C005R01101296487_chr1_125992	0	34	ATAC	tgcc
V350256906L4C005R01200223780	chr1	1387661	50M	178	1387839	1387662	1387840	V350256906L4C005R01200223780_chr1_1387661	80	83	GTCA	GCCC
V350256906L4C005R01200356487	chr1	861990	50M	161	862151	861991	862152	V350256906L4C005R01200356487_chr1_861990	50	36	CCAA	CCTT
V350256906L4C005R01200394506	chr1	1348730	50M	191	1348921	1348731	1348922	V350256906L4C005R01200394506_chr1_1348730	49	66	tatg	ccag
V350256906L4C005R01200403100	chr1	1055232	50M	177	1055409	1055233	1055410	V350256906L4C005R01200403100_chr1_1055232	67	66	ggtg	tttt
V350256906L4C005R01200703450	chr1	1317840	50M	195	1318035	1317841	1318036	V350256906L4C005R01200703450_chr1_1317840	270	196	CCAG	CTGG
V350256906L4C005R01201220687	chr1	1240816	50M	154	1240970	1240817	1240971	V350256906L4C005R01201220687_chr1_1240816	100	10	GCCA	TGCC
V350256906L4C005R01201287602	chr1	126108	50M	199	126307	126109	126308	V350256906L4C005R01201287602_chr1_126108	32	83	gaca	atgt
V350256906L4C005R01300233079	chr1	657305	50M	223	657528	657306	657529	V350256906L4C005R01300233079_chr1_657305	69	53	acta	CCAC
V350256906L4C005R01300740623	chr1	856135	50M	137	856272	856136	856273	V350256906L4C005R01300740623_chr1_856135	18	13	CACA	GGTG
V350256906L4C005R01300778820	chr1	947743	50M	181	947924	947744	947925	V350256906L4C005R01300778820_chr1_947743	46	54	accg	aact
V350256906L4C005R01301086704	chr1	1337796	50M	184	1337980	1337797	1337981	V350256906L4C005R01301086704_chr1_1337796	3	0	AGGC	ACTT
V350256906L4C005R01301323850	chr1	118060	50M	164	118224	118061	118225	V350256906L4C005R01301323850_chr1_118060	0	9	ggtc	taac
V350256906L4C005R01400166570	chr1	1159102	50M	168	1159270	1159103	1159271	V350256906L4C005R01400166570_chr1_1159102	2	41	CCAC	CAGG
V350256906L4C005R01400476378	chr1	53560	50M	155	53715	53561	53716	V350256906L4C005R01400476378_chr1_53560	294	213	CCAT	TATG
V350256906L4C005R01400650240	chr1	849559	50M	162	849721	849560	849722	V350256906L4C005R01400650240_chr1_849559	20	11	GGGA	CAGG
V350256906L4C005R01400683183	chr1	454606	50M	145	454751	454607	454752	V350256906L4C005R01400683183_chr1_454606	312	167	CCCT	TGGG
V350256906L4C005R01500410519	chr1	67450	50M	170	67620	67451	67621	V350256906L4C005R01500410519_chr1_67450	51	73	AAAT	GTCC
V350256906L4C005R01500695284	chr1	830062	50M	174	830236	830063	830237	V350256906L4C005R01500695284_chr1_830062	63	59	CCAA	CAAC
V350256906L4C005R01500754884	chr1	12351	50M	109	12460	12352	12461	V350256906L4C005R01500754884_chr1_12351	26	0	CAGC	CACC
V350256906L4C005R01501232395	chr1	337833	50M	155	337988	337834	337989	V350256906L4C005R01501232395_chr1_337833	63	63	CTGT	GAAC
V350256906L4C005R01501324752	chr1	12959	50M	157	13116	12960	13117	V350256906L4C005R01501324752_chr1_12959	50	52	TCCC	CTTT
V350256906L4C005R01501332890	chr1	1194407	50M	169	1194576	1194408	1194577	V350256906L4C005R01501332890_chr1_1194407	0	0	tgag	caca
V350256906L4C005R01501396872	chr1	927807	50M	147	927954	927808	927955	V350256906L4C005R01501396872_chr1_927807	58	33	ccca	gggg
V350256906L4C005R01600369077	chr1	251511	50M	201	251712	251512	251713	V350256906L4C005R01600369077_chr1_251511	62	85	CTAC	CAAG
V350256906L4C005R01600987702	chr1	261398	50M	148	261546	261399	261547	V350256906L4C005R01600987702_chr1_261398	47	42	taat	TATA
V350256906L4C005R01601240273	chr1	816704	50M	168	816872	816705	816873	V350256906L4C005R01601240273_chr1_816704	150	100	tctt	CTTA
V350256906L4C005R01700238886	chr1	1057152	50M	208	1057360	1057153	1057361	V350256906L4C005R01700238886_chr1_1057152	0	7	GGGG	CAGG
V350256906L4C005R01700658436	chr1	1329255	50M	193	1329448	1329256	1329449	V350256906L4C005R01700658436_chr1_1329255	23	33	ccag	tgca
V350256906L4C005R01701184424	chr1	399813	50M	179	399992	399814	399993	V350256906L4C005R01701184424_chr1_399813	45	105	agtt	aaca
V350256906L4C005R01701193163	chr1	27613	50M	170	27783	27614	27784	V350256906L4C005R01701193163_chr1_27613	57	116	GGGC	TACT
V350256906L4C005R01701325438	chr1	98370	50M	270	98640	98371	98641	V350256906L4C005R01701325438_chr1_98370	99	27	CATT	CATT
V350256906L4C005R01800118040	chr1	943364	1S49M	175	943539	943365	943540	V350256906L4C005R01800118040_chr1_943364	163	39	gatc	CCAG
V350256906L4C005R01800168829	chr1	165847	50M	169	166016	165848	166017	V350256906L4C005R01800168829_chr1_165847	30	15	CACA	AAAT
V350256906L4C005R01800489306	chr1	251453	50M	229	251682	251454	251683	V350256906L4C005R01800489306_chr1_251453	4	56	CACA	GTTA
V350256906L4C005R01800498848	chr1	260144	50M	144	260288	260145	260289	V350256906L4C005R01800498848_chr1_260144	33	56	cact	catc
V350256906L4C005R01900281473	chr1	1044421	50M	175	1044596	1044422	1044597	V350256906L4C005R01900281473_chr1_1044421	64	60	CGTT	ccaa
V350256906L4C005R01900714088	chr1	142955	50M	177	143132	142956	143133	V350256906L4C005R01900714088_chr1_142955	66	3	CATG	AGTG
V350256906L4C005R02000373927	chr1	149754	50M	161	149915	149755	149916	V350256906L4C005R02000373927_chr1_149754	6	0	TTTT	ccat
V350256906L4C005R02000472368	chr1	59211	50M	180	59391	59212	59392	V350256906L4C005R02000472368_chr1_59211	16	50	GCCT	ACTG
V350256906L4C005R02000681569	chr1	917413	50M	194	917607	917414	917608	V350256906L4C005R02000681569_chr1_917413	18	51	GGGT	CATC
V350256906L4C005R02001009324	chr1	14066	50M	164	14230	14067	14231	V350256906L4C005R02001009324_chr1_14066	49	72	GGCA	TGCA
V350256906L4C005R02001140501	chr1	853404	50M	150	853554	853405	853555	V350256906L4C005R02001140501_chr1_853404	8	52	TGCC	ATTT
V350256906L4C005R02100358684	chr1	726208	37M13S	220	726428	726209	726429	V350256906L4C005R02100358684_chr1_726208	41	0	gaat	attc
V350256906L4C005R02100514967	chr1	17549	50M	186	17735	17550	17736	V350256906L4C005R02100514967_chr1_17549	78	59	CACT	GAAG
V350256906L4C005R02100628057	chr1	802608	50M	162	802770	802609	802771	V350256906L4C005R02100628057_chr1_802608	31	66	GGAT	CTCA
V350256906L4C005R02200263912	chr1	320307	50M	164	320471	320308	320472	V350256906L4C005R02200263912_chr1_320307	140	178	gcct	CACT
V350256906L4C005R02200628193	chr1	735762	50M	159	735921	735763	735922	V350256906L4C005R02200628193_chr1_735762	61	76	atat	gcca
V350256906L4C005R02300126982	chr1	814775	50M	219	814994	814776	814995	V350256906L4C005R02300126982_chr1_814775	38	0	ACAC	cctg
V350256906L4C005R02300291258	chr1	615078	50M	166	615244	615079	615245	V350256906L4C005R02300291258_chr1_615078	9	175	ggtc	taaa
V350256906L4C005R02300532902	chr1	1352121	7M1D43M	217	1352338	1352122	1352339	V350256906L4C005R02300532902_chr1_1352121	22	0	cata	gcct
V350256906L4C005R02301071433	chr1	13190	50M	161	13351	13191	13352	V350256906L4C005R02301071433_chr1_13190	0	53	ACTC	CCAA
V350256906L4C005R02301123893	chr1	1323490	50M	205	1323695	1323491	1323696	V350256906L4C005R02301123893_chr1_1323490	91	75	CCCA	tatt
V350256906L4C005R02400340726	chr1	355823	50M	172	355995	355824	355996	V350256906L4C005R02400340726_chr1_355823	199	134	cccg	gtga
V350256906L4C005R02400915610	chr1	156720	50M	173	156893	156721	156894	V350256906L4C005R02400915610_chr1_156720	14	102	tatt	caag
V350256906L4C005R02401140166	chr1	1130944	50M	170	1131114	1130945	1131115	V350256906L4C005R02401140166_chr1_1130944	62	39	cgaa	caag
V350256906L4C005R02500049617	chr1	692920	50M	169	693089	692921	693090	V350256906L4C005R02500049617_chr1_692920	41	56	gggt	tgca
V350256906L4C005R02500071653	chr1	726825	23S22M5S	147	726972	726826	726973	V350256906L4C005R02500071653_chr1_726825	0	23	gaat	tcca
V350256906L4C005R02500097780	chr1	551035	50M	165	551200	551036	551201	V350256906L4C005R02500097780_chr1_551035	17	182	GACC	CCTC
V350256906L4C005R02500184734	chr1	73649	50M	154	73803	73650	73804	V350256906L4C005R02500184734_chr1_73649	39	0	ccat	caaa
V350256906L4C005R02500398262	chr1	1214465	50M	178	1214643	1214466	1214644	V350256906L4C005R02500398262_chr1_1214465	60	47	gggg	ccca
V350256906L4C005R02500833986	chr1	692585	50M	180	692765	692586	692766	V350256906L4C005R02500833986_chr1_692585	107	196	agga	tcag
V350256906L4C005R02501068448	chr1	817858	50M	177	818035	817859	818036	V350256906L4C005R02501068448_chr1_817858	150	68	CATA	CTAA
V350256906L4C005R02501189279	chr1	340470	50M	186	340656	340471	340657	V350256906L4C005R02501189279_chr1_340470	29	69	CAAG	CCTA
V350256906L4C005R02501308601	chr1	706369	50M	144	706513	706370	706514	V350256906L4C005R02501308601_chr1_706369	108	209	GAGA	TCTG
V350256906L4C005R02600132952	chr1	1398825	50M	152	1398977	1398826	1398978	V350256906L4C005R02600132952_chr1_1398825	91	18	CCTT	GGTC
V350256906L4C005R02600302232	chr1	820084	50M	157	820241	820085	820242	V350256906L4C005R02600302232_chr1_820084	0	0	attc	ctta
V350256906L4C005R02600812396	chr1	38661	50M	158	38819	38662	38820	V350256906L4C005R02600812396_chr1_38661	290	170	gtac	tggc
V350256906L4C005R02601208549	chr1	584764	50M	151	584915	584765	584916	V350256906L4C005R02601208549_chr1_584764	37	71	cagg	ccct
V350256906L4C005R02700325546	chr1	555420	50M	188	555608	555421	555609	V350256906L4C005R02700325546_chr1_555420	36	29	atgg	ttag
V350256906L4C005R02700539346	chr1	749212	50M	135	749347	749213	749348	V350256906L4C005R02700539346_chr1_749212	129	264	CTAC	ccac
V350256906L4C005R02700658681	chr1	1340819	50M	150	1340969	1340820	1340970	V350256906L4C005R02700658681_chr1_1340819	129	279	cagc	gcct
V350256906L4C005R02701022985	chr1	342564	50M	181	342745	342565	342746	V350256906L4C005R02701022985_chr1_342564	104	102	CTGA	CTAG
V350256906L4C005R02701059311	chr1	1123452	50M	141	1123593	1123453	1123594	V350256906L4C005R02701059311_chr1_1123452	68	27	tcca	gaca
V350256906L4C005R02701098048	chr1	655707	50M	159	655866	655708	655867	V350256906L4C005R02701098048_chr1_655707	0	15	CAAA	aggc
V350256906L4C005R02800014745	chr1	156587	50M	172	156759	156588	156760	V350256906L4C005R02800014745_chr1_156587	12	6	CCAC	Cttt
V350256906L4C005R02800190715	chr1	1172187	50M	161	1172348	1172188	1172349	V350256906L4C005R02800190715_chr1_1172187	6	129	AAGA	GCCT
V350256906L4C005R02800238471	chr1	1185149	50M	165	1185314	1185150	1185315	V350256906L4C005R02800238471_chr1_1185149	54	61	caaa	ccca
V350256906L4C005R02800346334	chr1	1065313	50M	150	1065463	1065314	1065464	V350256906L4C005R02800346334_chr1_1065313	17	0	GTTC	ccag
V350256906L4C005R02800414348	chr1	74692	50M	181	74873	74693	74874	V350256906L4C005R02800414348_chr1_74692	433	252	tgtt	aaaa
V350256906L4C005R02800634438	chr1	249643	50M	163	249806	249644	249807	V350256906L4C005R02800634438_chr1_249643	80	46	agtt	tcaa
V350256906L4C005R02800743240	chr1	127306	50M	195	127501	127307	127502	V350256906L4C005R02800743240_chr1_127306	0	174	CAAA	AGAT
V350256906L4C005R02801276012	chr1	820687	50M	192	820879	820688	820880	V350256906L4C005R02801276012_chr1_820687	37	17	ccag	ggcc
V350256906L4C005R02900056934	chr1	553623	50M	205	553828	553624	553829	V350256906L4C005R02900056934_chr1_553623	41	57	aaag	agga
V350256906L4C005R02900591702	chr1	30662	50M	177	30839	30663	30840	V350256906L4C005R02900591702_chr1_30662	94	39	CCAG	tacc
V350256906L4C005R02900662749	chr1	1090419	50M	110	1090529	1090420	1090530	V350256906L4C005R02900662749_chr1_1090419	81	0	tggc	ccag
V350256906L4C005R02900694835	chr1	319266	50M	161	319427	319267	319428	V350256906L4C005R02900694835_chr1_319266	31	24	taat	tgag
V350256906L4C005R02900777613	chr1	686205	50M	166	686371	686206	686372	V350256906L4C005R02900777613_chr1_686205	0	3	ccca	ATTT
V350256906L4C005R02900917645	chr1	600073	50M	195	600268	600074	600269	V350256906L4C005R02900917645_chr1_600073	75	75	ccca	gatc
V350256906L4C005R02901052414	chr1	1071859	50M	191	1072050	1071860	1072051	V350256906L4C005R02901052414_chr1_1071859	145	22	CCTG	CAGG
V350256906L4C005R02901136566	chr1	772915	50M	132	773047	772916	773048	V350256906L4C005R02901136566_chr1_772915	70	2	gctt	actg
V350256906L4C005R02901217479	chr1	1040164	50M	194	1040358	1040165	1040359	V350256906L4C005R02901217479_chr1_1040164	35	32	agcc	gtct
V350256906L4C005R03000015154	chr1	783588	50M	175	783763	783589	783764	V350256906L4C005R03000015154_chr1_783588	157	7	CAGG	TAGG
V350256906L4C005R03000140775	chr1	759618	50M	152	759770	759619	759771	V350256906L4C005R03000140775_chr1_759618	40	0	CGTA	ACTC
V350256906L4C005R03000193135	chr1	862897	50M	179	863076	862898	863077	V350256906L4C005R03000193135_chr1_862897	26	7	CCTC	CCAA
V350256906L4C005R03000270868	chr1	1058990	50M	175	1059165	1058991	1059166	V350256906L4C005R03000270868_chr1_1058990	58	55	acac	cagg
V350256906L4C005R03000421873	chr1	928248	50M	250	928498	928249	928499	V350256906L4C005R03000421873_chr1_928248	0	3	CTGG	TGAC
V350256906L4C005R03000530987	chr1	61377	50M	186	61563	61378	61564	V350256906L4C005R03000530987_chr1_61377	0	8	AAAA	TATT
V350256906L4C005R03000806043	chr1	1373511	50M	185	1373696	1373512	1373697	V350256906L4C005R03000806043_chr1_1373511	77	56	GAAA	CCTG
V350256906L4C005R03000965688	chr1	590623	50M	172	590795	590624	590796	V350256906L4C005R03000965688_chr1_590623	69	32	tgtc	ttga
V350256906L4C005R03001337501	chr1	902019	50M	181	902200	902020	902201	V350256906L4C005R03001337501_chr1_902019	52	63	CCTG	TGCA
V350256906L4C005R03100026848	chr1	418010	50M	172	418182	418011	418183	V350256906L4C005R03100026848_chr1_418010	62	47	TCTC	GGCA
V350256906L4C005R03100043047	chr1	423786	50M	196	423982	423787	423983	V350256906L4C005R03100043047_chr1_423786	297	180	tgtt	caaa
V350256906L4C005R03100216931	chr1	677186	50M	185	677371	677187	677372	V350256906L4C005R03100216931_chr1_677186	12	101	tttt	ctgg
V350256906L4C005R03100690053	chr1	561020	50M	179	561199	561021	561200	V350256906L4C005R03100690053_chr1_561020	49	42	gcca	gacc
V350256906L4C005R03101323221	chr1	1318147	50M	208	1318355	1318148	1318356	V350256906L4C005R03101323221_chr1_1318147	84	7	TCCA	ttga
V350256906L4C005R03200406220	chr1	1065134	50M	164	1065298	1065135	1065299	V350256906L4C005R03200406220_chr1_1065134	16	2	AGAA	CAAG
V350256906L4C005R03200598024	chr1	726730	50M	194	726924	726731	726925	V350256906L4C005R03200598024_chr1_726730	81	71	gaat	agtc
V350256906L4C005R03200674241	chr1	1227294	50M	170	1227464	1227295	1227465	V350256906L4C005R03200674241_chr1_1227294	0	36	ATGC	TCAG
V350256906L4C005R03201027557	chr1	777973	50M	162	778135	777974	778136	V350256906L4C005R03201027557_chr1_777973	64	4	GCAT	GCAG
V350256906L4C005R03201042264	chr1	724395	22S19M9S	164	724559	724396	724560	V350256906L4C005R03201042264_chr1_724395	88	157	tgca	tcca
V350256906L4C005R03201095994	chr1	144207	50M	140	144347	144208	144348	V350256906L4C005R03201095994_chr1_144207	215	75	caaa	agac
V350256906L4C005R03201258224	chr1	659550	50M	169	659719	659551	659720	V350256906L4C005R03201258224_chr1_659550	2	0	CCTC	CCCA
V350256906L4C005R03300182322	chr1	396235	50M	143	396378	396236	396379	V350256906L4C005R03300182322_chr1_396235	59	58	gtcc	CCAA
V350256906L4C005R03300214631	chr1	770004	50M	181	770185	770005	770186	V350256906L4C005R03300214631_chr1_770004	45	44	GGTT	cttt
V350256906L4C005R03300317415	chr1	174047	50M	254	174301	174048	174302	V350256906L4C005R03300317415_chr1_174047	69	0	TGCT	CGTG
V350256906L4C005R03300477499	chr1	41131	50M	138	41269	41132	41270	V350256906L4C005R03300477499_chr1_41131	0	58	TCCA	CTGG
V350256906L4C005R03300499710	chr1	1295473	50M	158	1295631	1295474	1295632	V350256906L4C005R03300499710_chr1_1295473	0	64	GCCC	CGAC
V350256906L4C005R03300648629	chr1	1128097	50M	203	1128300	1128098	1128301	V350256906L4C005R03300648629_chr1_1128097	19	18	GTTG	ggtg
V350256906L4C005R03300674715	chr1	701033	50M	168	701201	701034	701202	V350256906L4C005R03300674715_chr1_701033	80	40	gaat	AATG
V350256906L4C005R03300752346	chr1	1083671	50M	156	1083827	1083672	1083828	V350256906L4C005R03300752346_chr1_1083671	71	53	TCCC	gtac
V350256906L4C005R03301142250	chr1	554407	50M	215	554622	554408	554623	V350256906L4C005R03301142250_chr1_554407	0	17	tgac	ccaa
V350256906L4C005R03400165770	chr1	688173	50M	180	688353	688174	688354	V350256906L4C005R03400165770_chr1_688173	0	121	aggc	caaa
V350256906L4C005R03400213827	chr1	128512	50M	186	128698	128513	128699	V350256906L4C005R03400213827_chr1_128512	72	30	catc	actt
V350256906L4C005R03400317000	chr1	877412	50M	266	877678	877413	877679	V350256906L4C005R03400317000_chr1_877412	84	135	CGCC	CGAG
V350256906L4C005R03400463182	chr1	1122714	50M	192	1122906	1122715	1122907	V350256906L4C005R03400463182_chr1_1122714	0	165	ctaa	ccca
V350256906L4C005R03400480802	chr1	817926	50M	194	818120	817927	818121	V350256906L4C005R03400480802_chr1_817926	177	0	TGTA	acaa
V350256906L4C005R03401117768	chr1	397366	50M	141	397507	397367	397508	V350256906L4C005R03401117768_chr1_397366	53	9	acat	CAGT
V350256906L4C005R03500136592	chr1	1227630	35M4D15M	197	1227827	1227631	1227828	V350256906L4C005R03500136592_chr1_1227630	57	42	CCAT	CCCT
V350256906L4C005R03500673125	chr1	1419425	50M	238	1419663	1419426	1419664	V350256906L4C005R03500673125_chr1_1419425	69	59	ACCA	tgtg
V350256906L4C005R03501057625	chr1	133692	50M	115	133807	133693	133808	V350256906L4C005R03501057625_chr1_133692	69	184	GCAC	GGTT
V350256906L4C005R03501128154	chr1	409348	50M	250	409598	409349	409599	V350256906L4C005R03501128154_chr1_409348	8	61	TTTT	accc
V350256906L4C005R03501196922	chr1	883735	50M	204	883939	883736	883940	V350256906L4C005R03501196922_chr1_883735	61	68	CCTG	TCCA
V350256906L4C005R03501272287	chr1	467813	50M	202	468015	467814	468016	V350256906L4C005R03501272287_chr1_467813	132	49	ggag	caga
V350256906L4C005R03600049075	chr1	1313072	50M	166	1313238	1313073	1313239	V350256906L4C005R03600049075_chr1_1313072	45	30	cagg	aaag
V350256906L4C005R03600813832	chr1	351267	50M	188	351455	351268	351456	V350256906L4C005R03600813832_chr1_351267	94	51	agaa	TGTA
V350256906L4C005R03600961242	chr1	861271	50M	170	861441	861272	861442	V350256906L4C005R03600961242_chr1_861271	5	4	CTCA	CCGC
V350256906L4C005R03601030943	chr1	694426	50M	165	694591	694427	694592	V350256906L4C005R03601030943_chr1_694426	98	263	CCAT	tagt
V350256906L4C005R03601121323	chr1	640605	50M	153	640758	640606	640759	V350256906L4C005R03601121323_chr1_640605	19	71	taaa	caca
V350256906L4C005R03800247967	chr1	641374	50M	171	641545	641375	641546	V350256906L4C005R03800247967_chr1_641374	66	7	CACA	tcag
V350256906L4C005R03800250971	chr1	570316	50M	173	570489	570317	570490	V350256906L4C005R03800250971_chr1_570316	0	0	AGAT	GCTA
V350256906L4C005R03800314522	chr1	712522	50M	173	712695	712523	712696	V350256906L4C005R03800314522_chr1_712522	1	0	AGTG	TAAA
V350256906L4C005R03800461264	chr1	49909	50M	175	50084	49910	50085	V350256906L4C005R03800461264_chr1_49909	93	62	GCTC	AAAG
V350256906L4C005R03801406506	chr1	913790	50M	150	913940	913791	913941	V350256906L4C005R03801406506_chr1_913790	214	364	CGTC	GGCC
V350256906L4C005R03900032888	chr1	1128406	50M	180	1128586	1128407	1128587	V350256906L4C005R03900032888_chr1_1128406	124	58	aata	ctac
V350256906L4C005R03900200612	chr1	823583	50M	163	823746	823584	823747	V350256906L4C005R03900200612_chr1_823583	68	60	cttc	cctt
V350256906L4C005R03900520941	chr1	1214856	50M	179	1215035	1214857	1215036	V350256906L4C005R03900520941_chr1_1214856	59	44	cact	cgag
V350256906L4C005R03900677023	chr1	924400	50M	141	924541	924401	924542	V350256906L4C005R03900677023_chr1_924400	64	29	TGGG	CCCC
V350256906L4C005R03900833720	chr1	650907	50M	162	651069	650908	651070	V350256906L4C005R03900833720_chr1_650907	20	125	CCAA	ggct
V350256906L4C005R03900868632	chr1	380349	50M	174	380523	380350	380524	V350256906L4C005R03900868632_chr1_380349	117	76	acat	aagt
V350256906L4C005R03901046984	chr1	236498	50M	199	236697	236499	236698	V350256906L4C005R03901046984_chr1_236498	59	31	ctgg	TGTC
V350256906L4C005R04000139730	chr1	1034833	50M	156	1034989	1034834	1034990	V350256906L4C005R04000139730_chr1_1034833	6	48	ggtc	ccaa
V350256906L4C005R04000220818	chr1	78431	50M	185	78616	78432	78617	V350256906L4C005R04000220818_chr1_78431	26	135	ACta	ctca
V350256906L4C005R04000240913	chr1	842268	50M	139	842407	842269	842408	V350256906L4C005R04000240913_chr1_842268	50	47	CTTT	CGGA
V350256906L4C005R04000474262	chr1	266465	50M	168	266633	266466	266634	V350256906L4C005R04000474262_chr1_266465	84	7	GACG	CATC
V350256906L4C005R04000550499	chr1	415056	50M	149	415205	415057	415206	V350256906L4C005R04000550499_chr1_415056	46	37	ggcc	tgca
V350256906L4C005R04000797392	chr1	1353211	50M	167	1353378	1353212	1353379	V350256906L4C005R04000797392_chr1_1353211	93	62	gcct	tgat
V350256906L4C005R04000853421	chr1	1066435	50M	172	1066607	1066436	1066608	V350256906L4C005R04000853421_chr1_1066435	151	45	cctg	aaga
V350256906L4C005R04000993992	chr1	815539	50M	166	815705	815540	815706	V350256906L4C005R04000993992_chr1_815539	174	140	ttat	aaca
V350256906L4C005R04001127275	chr1	411050	50M	168	411218	411051	411219	V350256906L4C005R04001127275_chr1_411050	31	10	agga	ACTG
V350256906L4C005R04001279690	chr1	455979	50M	160	456139	455980	456140	V350256906L4C005R04001279690_chr1_455979	306	466	CCTA	GCCA
V350256906L4C005R04001305159	chr1	24520	50M	183	24703	24521	24704	V350256906L4C005R04001305159_chr1_24520	247	71	AGGA	GCCA
V350256906L4C005R04001328257	chr1	773968	50M	170	774138	773969	774139	V350256906L4C005R04001328257_chr1_773968	74	66	cctc	tgag
V350256906L4C005R04001390185	chr1	971838	50M	179	972017	971839	972018	V350256906L4C005R04001390185_chr1_971838	0	0	CCAG	CCCA
V350256906L4C005R04100604630	chr1	1399633	50M	178	1399811	1399634	1399812	V350256906L4C005R04100604630_chr1_1399633	2	25	CATA	ACCG
V350256906L4C005R04100758097	chr1	72219	50M	174	72393	72220	72394	V350256906L4C005R04100758097_chr1_72219	74	248	agaa	ccaa
V350256906L4C005R04101269703	chr1	32441	50M	174	32615	32442	32616	V350256906L4C005R04101269703_chr1_32441	23	106	CTGG	CCCA
V350256906L4C005R04101344882	chr1	404460	50M	191	404651	404461	404652	V350256906L4C005R04101344882_chr1_404460	101	213	tcct	ctaa
V350256906L4C005R04200051878	chr1	725849	31S19M	108	725957	725850	725958	V350256906L4C005R04200051878_chr1_725849	34	32	atgg	catt
V350256906L4C005R04200073470	chr1	1066817	50M	165	1066982	1066818	1066983	V350256906L4C005R04200073470_chr1_1066817	94	76	agac	tact
V350256906L4C005R04200217260	chr1	1242231	50M	197	1242428	1242232	1242429	V350256906L4C005R04200217260_chr1_1242231	112	38	ACAC	CCTC
V350256906L4C005R04200281322	chr1	817774	50M	152	817926	817775	817927	V350256906L4C005R04200281322_chr1_817774	66	177	CATT	TCTC
V350256906L4C005R04200428775	chr1	536930	50M	180	537110	536931	537111	V350256906L4C005R04200428775_chr1_536930	539	480	cttg	gaca
V350256906L4C005R04200831977	chr1	759199	50M	172	759371	759200	759372	V350256906L4C005R04200831977_chr1_759199	8	12	CATA	CAAC
V350256906L4C005R04201171861	chr1	810059	50M	182	810241	810060	810242	V350256906L4C005R04201171861_chr1_810059	0	36	CCAC	CTGA
V350256906L4C005R04300731185	chr1	459494	50M	159	459653	459495	459654	V350256906L4C005R04300731185_chr1_459494	69	32	CTAC	CTTG
V350256906L4C005R04300863443	chr1	79806	50M	184	79990	79807	79991	V350256906L4C005R04300863443_chr1_79806	0	0	cgtc	tttt
V350256906L4C005R04300981556	chr1	60783	50M	177	60960	60784	60961	V350256906L4C005R04300981556_chr1_60783	29	90	AAAA	TCAG
V350256906L4C005R04301107000	chr1	1294090	50M	188	1294278	1294091	1294279	V350256906L4C005R04301107000_chr1_1294090	0	0	GGAG	CAGA
V350256906L4C005R04301177491	chr1	16608	50M	176	16784	16609	16785	V350256906L4C005R04301177491_chr1_16608	65	50	TGAA	CCAC
V350256906L4C005R04400224941	chr1	618782	50M	195	618977	618783	618978	V350256906L4C005R04400224941_chr1_618782	0	9	tagg	cctt
V350256906L4C005R04400427345	chr1	54018	50M	177	54195	54019	54196	V350256906L4C005R04400427345_chr1_54018	0	0	AAAA	CAAC
V350256906L4C005R04400544234	chr1	76528	50M	173	76701	76529	76702	V350256906L4C005R04400544234_chr1_76528	184	11	taga	cctc
V350256906L4C005R04401119323	chr1	364822	50M	172	364994	364823	364995	V350256906L4C005R04401119323_chr1_364822	51	29	TGAT	GGAG
V350256906L4C005R04401372540	chr1	697409	50M	168	697577	697410	697578	V350256906L4C005R04401372540_chr1_697409	64	57	caga	ccag
V350256906L4C005R04500199940	chr1	1392541	50M	164	1392705	1392542	1392706	V350256906L4C005R04500199940_chr1_1392541	66	50	TCCT	ccac
V350256906L4C005R04500311321	chr1	691567	50M	142	691709	691568	691710	V350256906L4C005R04500311321_chr1_691567	163	21	CACA	tctc
V350256906L4C005R04500348117	chr1	1259035	50M	165	1259200	1259036	1259201	V350256906L4C005R04500348117_chr1_1259035	136	0	ccca	CACG
V350256906L4C005R04500366141	chr1	1231425	50M	185	1231610	1231426	1231611	V350256906L4C005R04500366141_chr1_1231425	40	82	CCTG	GGAG
V350256906L4C005R04500454476	chr1	378956	50M	213	379169	378957	379170	V350256906L4C005R04500454476_chr1_378956	45	13	GAGA	CCAG
V350256906L4C005R04500529420	chr1	123713	50M	175	123888	123714	123889	V350256906L4C005R04500529420_chr1_123713	10	141	agct	tcta
V350256906L4C005R04500622743	chr1	149405	50M	193	149598	149406	149599	V350256906L4C005R04500622743_chr1_149405	84	120	tggt	caag
V350256906L4C005R04500783062	chr1	51656	50M	135	51791	51657	51792	V350256906L4C005R04500783062_chr1_51656	58	0	ggag	cggt
V350256906L4C005R04501016912	chr1	346887	50M	167	347054	346888	347055	V350256906L4C005R04501016912_chr1_346887	31	0	tagc	CAAG
V350256906L4C005R04501067554	chr1	159982	50M	193	160175	159983	160176	V350256906L4C005R04501067554_chr1_159982	89	33	CCCA	CCAT
V350256906L4C005R04600041544	chr1	840719	50M	194	840913	840720	840914	V350256906L4C005R04600041544_chr1_840719	57	48	ccct	CCTG
V350256906L4C005R04600602675	chr1	854728	50M	200	854928	854729	854929	V350256906L4C005R04600602675_chr1_854728	12	0	TGCA	CTGT
V350256906L4C005R04600718933	chr1	337678	50M	190	337868	337679	337869	V350256906L4C005R04600718933_chr1_337678	170	28	TTGA	CCAA
V350256906L4C005R04700043879	chr1	97842	50M	210	98052	97843	98053	V350256906L4C005R04700043879_chr1_97842	48	122	tacc	cagc
V350256906L4C005R04700264865	chr1	1399584	50M	176	1399760	1399585	1399761	V350256906L4C005R04700264865_chr1_1399584	51	76	caaa	gctg
V350256906L4C005R04700751351	chr1	1357341	50M	167	1357508	1357342	1357509	V350256906L4C005R04700751351_chr1_1357341	44	77	CCCA	TCCC
V350256906L4C005R04700947642	chr1	882264	50M	211	882475	882265	882476	V350256906L4C005R04700947642_chr1_882264	40	60	cccg	AGCG
V350256906L4C005R04700971987	chr1	1339466	50M	140	1339606	1339467	1339607	V350256906L4C005R04700971987_chr1_1339466	77	24	gcct	gctg
V350256906L4C005R04701180250	chr1	943651	50M	165	943816	943652	943817	V350256906L4C005R04701180250_chr1_943651	21	3	GAAG	agca
V350256906L4C005R04800137007	chr1	790179	50M	146	790325	790180	790326	V350256906L4C005R04800137007_chr1_790179	81	35	CCCA	GCCC
V350256906L4C005R04800290381	chr1	1214721	50M	172	1214893	1214722	1214894	V350256906L4C005R04800290381_chr1_1214721	10	22	cctc	gaga
V350256906L4C005R04800811407	chr1	781200	50M	136	781336	781201	781337	V350256906L4C005R04800811407_chr1_781200	0	9	CTAG	GTGT
V350256906L4C005R04800856943	chr1	1152057	50M	185	1152242	1152058	1152243	V350256906L4C005R04800856943_chr1_1152057	56	7	CCCC	GGTT
V350256906L4C005R04800944681	chr1	33141	50M	171	33312	33142	33313	V350256906L4C005R04800944681_chr1_33141	106	0	ccat	ccat
V350256906L4C005R04900093164	chr1	264503	50M	184	264687	264504	264688	V350256906L4C005R04900093164_chr1_264503	54	71	aaaa	CTTA
V350256906L4C005R04900330816	chr1	1048419	50M	174	1048593	1048420	1048594	V350256906L4C005R04900330816_chr1_1048419	58	41	acaa	gttt
V350256906L4C005R04900581703	chr1	1088101	50M	159	1088260	1088102	1088261	V350256906L4C005R04900581703_chr1_1088101	10	100	CTAT	GGAG
V350256906L4C005R04900801292	chr1	41294	50M	180	41474	41295	41475	V350256906L4C005R04900801292_chr1_41294	83	263	CAAA	tgtg
V350256906L4C005R04900812221	chr1	712623	50M	174	712797	712624	712798	V350256906L4C005R04900812221_chr1_712623	41	47	TATT	ctga
V350256906L4C005R05000407297	chr1	106903	50M	196	107099	106904	107100	V350256906L4C005R05000407297_chr1_106903	147	0	CCTT	TTGA
V350256906L4C005R05000843435	chr1	65019	50M	165	65184	65020	65185	V350256906L4C005R05000843435_chr1_65019	18	63	GCTC	GTAA
V350256906L4C005R05001113492	chr1	731464	50M	178	731642	731465	731643	V350256906L4C005R05001113492_chr1_731464	53	55	tggg	GCCT
V350256906L4C005R05100121517	chr1	1346866	50M	161	1347027	1346867	1347028	V350256906L4C005R05100121517_chr1_1346866	31	86	ctgg	cacc
V350256906L4C005R05100299066	chr1	346252	50M	171	346423	346253	346424	V350256906L4C005R05100299066_chr1_346252	0	22	ctaa	tcat
V350256906L4C005R05100496170	chr1	724218	26S22M2S	127	724345	724219	724346	V350256906L4C005R05100496170_chr1_724218	22	38	aacg	ttca
V350256906L4C005R05100747219	chr1	582579	50M	163	582742	582580	582743	V350256906L4C005R05100747219_chr1_582579	29	12	AAAA	gcca
V350256906L4C005R05101061402	chr1	776878	50M	181	777059	776879	777060	V350256906L4C005R05101061402_chr1_776878	167	0	GGTT	ccaa
V350256906L4C005R05101120970	chr1	404113	50M	164	404277	404114	404278	V350256906L4C005R05101120970_chr1_404113	106	0	TTTC	atac
V350256906L4C005R05101219137	chr1	64638	50M	185	64823	64639	64824	V350256906L4C005R05101219137_chr1_64638	153	8	ccta	CCAG
V350256906L4C005R05101325610	chr1	908633	50M	160	908793	908634	908794	V350256906L4C005R05101325610_chr1_908633	26	186	GCCG	CCAG
V350256906L4C005R05200094042	chr1	901325	50M	157	901482	901326	901483	V350256906L4C005R05200094042_chr1_901325	42	74	CACA	CCCT
V350256906L4C005R05200262590	chr1	671535	50M	169	671704	671536	671705	V350256906L4C005R05200262590_chr1_671535	14	0	CCTG	ttgt
V350256906L4C005R05200442529	chr1	1188075	50M	159	1188234	1188076	1188235	V350256906L4C005R05200442529_chr1_1188075	57	41	cttg	cttt
V350256906L4C005R05200786011	chr1	96723	50M	174	96897	96724	96898	V350256906L4C005R05200786011_chr1_96723	63	65	ACAA	CCAC
V350256906L4C005R05200984217	chr1	160063	50M	223	160286	160064	160287	V350256906L4C005R05200984217_chr1_160063	8	144	TACA	GGTT
V350256906L4C005R05201026076	chr1	1381123	50M	176	1381299	1381124	1381300	V350256906L4C005R05201026076_chr1_1381123	51	61	gtaa	aagc
V350256906L4C005R05300015181	chr1	585537	50M	163	585700	585538	585701	V350256906L4C005R05300015181_chr1_585537	21	41	ccca	ctga
V350256906L4C005R05300184055	chr1	54493	50M	172	54665	54494	54666	V350256906L4C005R05300184055_chr1_54493	59	42	cttc	ggga
V350256906L4C005R05300513531	chr1	753056	50M	101	753157	753057	753158	V350256906L4C005R05300513531_chr1_753056	189	192	TTTA	ACTG
V350256906L4C005R05300732692	chr1	987318	50M	165	987483	987319	987484	V350256906L4C005R05300732692_chr1_987318	64	0	TCTC	CCCC
V350256906L4C005R05300787803	chr1	765888	50M	176	766064	765889	766065	V350256906L4C005R05300787803_chr1_765888	69	74	catt	ggga
V350256906L4C005R05300947058	chr1	1017242	50M	167	1017409	1017243	1017410	V350256906L4C005R05300947058_chr1_1017242	99	23	CCAC	CCGG
V350256906L4C005R05301281321	chr1	1407663	50M	188	1407851	1407664	1407852	V350256906L4C005R05301281321_chr1_1407663	36	61	CTGC	CCCA
V350256906L4C005R05400543570	chr1	457698	50M	162	457860	457699	457861	V350256906L4C005R05400543570_chr1_457698	47	61	cgtg	atgg
V350256906L4C005R05400891137	chr1	989686	50M	157	989843	989687	989844	V350256906L4C005R05400891137_chr1_989686	46	28	CATC	CCTT
V350256906L4C005R05401293410	chr1	691301	50M	134	691435	691302	691436	V350256906L4C005R05401293410_chr1_691301	45	179	ccca	ACTC
V350256906L4C005R05500125862	chr1	1350142	50M	171	1350313	1350143	1350314	V350256906L4C005R05500125862_chr1_1350142	0	0	cgcg	ccca
V350256906L4C005R05500148848	chr1	726169	1S49M	173	726342	726170	726343	V350256906L4C005R05500148848_chr1_726169	80	51	aatg	ttcc
V350256906L4C005R05500196925	chr1	469010	50M	169	469179	469011	469180	V350256906L4C005R05500196925_chr1_469010	54	15	tttc	tggg
V350256906L4C005R05501293568	chr1	127627	50M	168	127795	127628	127796	V350256906L4C005R05501293568_chr1_127627	188	20	caaa	gggt
V350256906L4C005R05600006663	chr1	590972	50M	177	591149	590973	591150	V350256906L4C005R05600006663_chr1_590972	0	164	acaa	CATG
V350256906L4C005R05600254079	chr1	755264	50M	158	755422	755265	755423	V350256906L4C005R05600254079_chr1_755264	52	108	tcag	GACA
V350256906L4C005R05600535408	chr1	466538	50M	159	466697	466539	466698	V350256906L4C005R05600535408_chr1_466538	6	123	ATTT	CAGA
V350256906L4C005R05601346444	chr1	427345	50M	186	427531	427346	427532	V350256906L4C005R05601346444_chr1_427345	34	38	CGAC	CACA
V350256906L4C005R05700044150	chr1	64510	50M	176	64686	64511	64687	V350256906L4C005R05700044150_chr1_64510	25	145	ggtg	TACA
V350256906L4C005R05700050732	chr1	967747	50M	170	967917	967748	967918	V350256906L4C005R05700050732_chr1_967747	176	103	CCCA	CACC
V350256906L4C005R05700061869	chr1	1074478	50M	167	1074645	1074479	1074646	V350256906L4C005R05700061869_chr1_1074478	87	185	GCTT	CCCC
V350256906L4C005R05700361189	chr1	808183	50M	187	808370	808184	808371	V350256906L4C005R05700361189_chr1_808183	67	78	CCTA	AGAT
V350256906L4C005R05700434221	chr1	1339870	15M1D35M	135	1340005	1339871	1340006	V350256906L4C005R05700434221_chr1_1339870	30	64	CAAG	ggag
V350256906L4C005R05700478618	chr1	660487	50M	174	660661	660488	660662	V350256906L4C005R05700478618_chr1_660487	0	148	ggct	aatc
V350256906L4C005R05700622677	chr1	883666	50M	191	883857	883667	883858	V350256906L4C005R05700622677_chr1_883666	0	0	CTCA	CCTG
V350256906L4C005R05700778360	chr1	459285	50M	186	459471	459286	459472	V350256906L4C005R05700778360_chr1_459285	103	92	ggtg	GGGA
V350256906L4C005R05700786363	chr1	686121	50M	170	686291	686122	686292	V350256906L4C005R05700786363_chr1_686121	60	60	cata	acag
V350256906L4C005R05700879233	chr1	127207	50M	152	127359	127208	127360	V350256906L4C005R05700879233_chr1_127207	58	32	CTGG	CCAT
V350256906L4C005R05700970949	chr1	819797	50M	173	819970	819798	819971	V350256906L4C005R05700970949_chr1_819797	68	52	tgtt	gaat
V350256906L4C005R05701008938	chr1	1311616	50M	142	1311758	1311617	1311759	V350256906L4C005R05701008938_chr1_1311616	182	83	CCTG	CCTG
V350256906L4C005R05800085683	chr1	776498	50M	182	776680	776499	776681	V350256906L4C005R05800085683_chr1_776498	27	1	CAGT	CCTT
V350256906L4C005R05800300762	chr1	626191	50M	131	626322	626192	626323	V350256906L4C005R05800300762_chr1_626191	53	0	agac	tgaa
V350256906L4C005R05800630857	chr1	1395673	50M	172	1395845	1395674	1395846	V350256906L4C005R05800630857_chr1_1395673	0	2	ctgg	CCAC
V350256906L4C005R05800773241	chr1	702440	50M	169	702609	702441	702610	V350256906L4C005R05800773241_chr1_702440	84	20	CATA	TGTT
V350256906L4C005R05900100136	chr1	1068347	50M	167	1068514	1068348	1068515	V350256906L4C005R05900100136_chr1_1068347	7	76	ccat	AGCT
V350256906L4C005R05900563867	chr1	1418803	50M	166	1418969	1418804	1418970	V350256906L4C005R05900563867_chr1_1418803	13	151	caca	tgtt
V350256906L4C005R05900938000	chr1	556518	50M	192	556710	556519	556711	V350256906L4C005R05900938000_chr1_556518	9	1	TTCT	ccaa
V350256906L4C005R05901173597	chr1	762031	50M	148	762179	762032	762180	V350256906L4C005R05901173597_chr1_762031	130	7	TCCT	AGCG
V350256906L4C005R05901396570	chr1	384874	50M	163	385037	384875	385038	V350256906L4C005R05901396570_chr1_384874	25	40	gtgt	acaa
V350256906L4C005R05901397038	chr1	1160472	50M	140	1160612	1160473	1160613	V350256906L4C005R05901397038_chr1_1160472	182	42	CAGG	ccca
V350256906L4C005R06000018150	chr1	1257381	50M	170	1257551	1257382	1257552	V350256906L4C005R06000018150_chr1_1257381	9	94	ATCT	CCCT
V350256906L4C005R06000166804	chr1	1020281	50M	159	1020440	1020282	1020441	V350256906L4C005R06000166804_chr1_1020281	44	71	CTTT	CAGC
V350256906L4C005R06000185386	chr1	586340	50M	174	586514	586341	586515	V350256906L4C005R06000185386_chr1_586340	25	18	caac	agaa
V350256906L4C005R06000246836	chr1	93146	50M	153	93299	93147	93300	V350256906L4C005R06000246836_chr1_93146	13	63	GTTA	tcat
V350256906L4C005R06000399964	chr1	265669	50M	161	265830	265670	265831	V350256906L4C005R06000399964_chr1_265669	8	57	AATC	GAGC
V350256906L4C005R06000592841	chr1	1020928	50M	182	1021110	1020929	1021111	V350256906L4C005R06000592841_chr1_1020928	79	66	CGAG	CCCG
V350256906L4C005R06000621208	chr1	364862	50M	109	364971	364863	364972	V350256906L4C005R06000621208_chr1_364862	73	6	TCCA	TGTG
V350256906L4C005R06000809717	chr1	1238840	50M	154	1238994	1238841	1238995	V350256906L4C005R06000809717_chr1_1238840	9	108	CCCG	GGGG
V350256906L4C005R06000847731	chr1	831704	50M	141	831845	831705	831846	V350256906L4C005R06000847731_chr1_831704	108	0	ccat	gaat
V350256906L4C005R06001378107	chr1	231546	50M	196	231742	231547	231743	V350256906L4C005R06001378107_chr1_231546	274	272	atgt	gcca
V350256906L4C005R06100097270	chr1	635149	50M	163	635312	635150	635313	V350256906L4C005R06100097270_chr1_635149	76	28	gcca	acag
V350256906L4C005R06100195106	chr1	581298	50M	167	581465	581299	581466	V350256906L4C005R06100195106_chr1_581298	8	16	cagg	ctac
V350256906L4C005R06100617508	chr1	1182622	50M	174	1182796	1182623	1182797	V350256906L4C005R06100617508_chr1_1182622	16	40	CAGC	CAAG
V350256906L4C005R06100739229	chr1	797239	50M	148	797387	797240	797388	V350256906L4C005R06100739229_chr1_797239	83	2	ggat	tcca
V350256906L4C005R06101204778	chr1	442381	50M	208	442589	442382	442590	V350256906L4C005R06101204778_chr1_442381	5	0	cccg	tcat
V350256906L4C005R06200723899	chr1	99900	50M	157	100057	99901	100058	V350256906L4C005R06200723899_chr1_99900	57	73	ataa	gtac
V350256906L4C005R06201037216	chr1	250329	50M	148	250477	250330	250478	V350256906L4C005R06201037216_chr1_250329	21	0	ccct	gtta
V350256906L4C005R06300103363	chr1	132021	50M	164	132185	132022	132186	V350256906L4C005R06300103363_chr1_132021	190	58	ACTC	CCAC
V350256906L4C005R06301062292	chr1	1394072	50M	175	1394247	1394073	1394248	V350256906L4C005R06301062292_chr1_1394072	51	72	ggat	cctg
V350256906L4C005R06301247858	chr1	49919	50M	209	50128	49920	50129	V350256906L4C005R06301247858_chr1_49919	83	86	TGAA	CTAT
V350256906L4C005R06301398369	chr1	333481	50M	169	333650	333482	333651	V350256906L4C005R06301398369_chr1_333481	25	0	tgaa	gaca
V350256906L4C005R06400375757	chr1	874704	50M	156	874860	874705	874861	V350256906L4C005R06400375757_chr1_874704	5	62	CCAT	TGCC
V350256906L4C005R06400440460	chr1	1064842	50M	214	1065056	1064843	1065057	V350256906L4C005R06400440460_chr1_1064842	42	16	GGCC	CCCT
V350256906L4C005R06401007314	chr1	1386400	25M1I24M	161	1386561	1386401	1386562	V350256906L4C005R06401007314_chr1_1386400	20	0	ACCT	tagt
V350256906L4C005R06500249639	chr1	1142254	50M	165	1142419	1142255	1142420	V350256906L4C005R06500249639_chr1_1142254	83	200	CGGG	GGTG
V350256906L4C005R06500439222	chr1	462311	50M	148	462459	462312	462460	V350256906L4C005R06500439222_chr1_462311	208	211	ccac	Ggac
V350256906L4C005R06500694495	chr1	450646	50M	130	450776	450647	450777	V350256906L4C005R06500694495_chr1_450646	53	10	ggga	cggc
V350256906L4C005R06501278066	chr1	1124206	50M	184	1124390	1124207	1124391	V350256906L4C005R06501278066_chr1_1124206	24	10	ccat	ggat
V350256906L4C005R06501339568	chr1	436669	50M	179	436848	436670	436849	V350256906L4C005R06501339568_chr1_436669	40	7	TCTC	TAGT
V350256906L4C005R06501363551	chr1	555774	50M	158	555932	555775	555933	V350256906L4C005R06501363551_chr1_555774	0	15	ggcc	tatc
V350256906L4C005R06600013118	chr1	249356	50M	150	249506	249357	249507	V350256906L4C005R06600013118_chr1_249356	0	23	tgaa	ccac
V350256906L4C005R06600041770	chr1	49978	50M	200	50178	49979	50179	V350256906L4C005R06600041770_chr1_49978	24	36	GAAC	AGCC
V350256906L4C005R06600416478	chr1	970685	50M	189	970874	970686	970875	V350256906L4C005R06600416478_chr1_970685	44	19	GCCT	CCTA
V350256906L4C005R06600420957	chr1	1296143	50M	167	1296310	1296144	1296311	V350256906L4C005R06600420957_chr1_1296143	70	17	AGGC	ccat
V350256906L4C005R06600543793	chr1	981534	50M	196	981730	981535	981731	V350256906L4C005R06600543793_chr1_981534	85	69	CCCC	GGTG
V350256906L4C005R06600712997	chr1	725933	39M11S	138	726071	725934	726072	V350256906L4C005R06600712997_chr1_725933	8	146	aatg	attc
V350256906L4C005R06600780768	chr1	1353387	50M	165	1353552	1353388	1353553	V350256906L4C005R06600780768_chr1_1353387	71	50	agtc	acac
V350256906L4C005R06600835449	chr1	53032	50M	177	53209	53033	53210	V350256906L4C005R06600835449_chr1_53032	14	16	TCAC	TACA
V350256906L4C005R06601037347	chr1	628620	50M	146	628766	628621	628767	V350256906L4C005R06601037347_chr1_628620	35	55	aaca	ccaa
V350256906L4C005R06601114529	chr1	801722	50M	179	801901	801723	801902	V350256906L4C005R06601114529_chr1_801722	38	0	caga	CCAC
V350256906L4C005R06601207458	chr1	1138231	50M	188	1138419	1138232	1138420	V350256906L4C005R06601207458_chr1_1138231	79	69	GGTC	CCCT
V350256906L4C005R06601213740	chr1	1068686	50M	168	1068854	1068687	1068855	V350256906L4C005R06601213740_chr1_1068686	66	4	CCTG	GAGG
V350256906L4C005R06700399279	chr1	566440	50M	186	566626	566441	566627	V350256906L4C005R06700399279_chr1_566440	51	73	CCTC	CGAT
V350256906L4C005R06700472165	chr1	104672	50M	168	104840	104673	104841	V350256906L4C005R06700472165_chr1_104672	13	15	acct	ctct
V350256906L4C005R06700666497	chr1	1027394	50M	157	1027551	1027395	1027552	V350256906L4C005R06700666497_chr1_1027394	172	15	CCGA	CGTA
V350256906L4C005R06700717364	chr1	973033	48M2S	177	973210	973034	973211	V350256906L4C005R06700717364_chr1_973033	11	188	CCCA	CCCC
V350256906L4C005R06701139985	chr1	1017400	50M	154	1017554	1017401	1017555	V350256906L4C005R06701139985_chr1_1017400	14	0	GGAG	GCCC
V350256906L4C005R06701200923	chr1	1006351	50M	181	1006532	1006352	1006533	V350256906L4C005R06701200923_chr1_1006351	23	47	TACA	CCAC
V350256906L4C005R06800004561	chr1	681404	50M	176	681580	681405	681581	V350256906L4C005R06800004561_chr1_681404	58	45	ccct	GAGA
V350256906L4C005R06800478460	chr1	84096	50M	160	84256	84097	84257	V350256906L4C005R06800478460_chr1_84096	0	138	ttaa	gttt
V350256906L4C005R06800731513	chr1	787811	50M	164	787975	787812	787976	V350256906L4C005R06800731513_chr1_787811	30	65	CCCT	TGAA
V350256906L4C005R06801189734	chr1	1192457	50M	181	1192638	1192458	1192639	V350256906L4C005R06801189734_chr1_1192457	79	55	GACC	CCCA
V350256906L4C005R06900067135	chr1	412908	50M	157	413065	412909	413066	V350256906L4C005R06900067135_chr1_412908	350	193	AAGC	TGCC
V350256906L4C005R06900641629	chr1	816701	50M	169	816870	816702	816871	V350256906L4C005R06900641629_chr1_816701	147	102	atct	TACA
V350256906L4C005R06900926876	chr1	424124	50M	182	424306	424125	424307	V350256906L4C005R06900926876_chr1_424124	38	22	AAAA	TCTT
V350256906L4C005R07000182381	chr1	129046	50M	173	129219	129047	129220	V350256906L4C005R07000182381_chr1_129046	63	36	GCTT	GGAC
V350256906L4C005R07000608532	chr1	701202	50M	162	701364	701203	701365	V350256906L4C005R07000608532_chr1_701202	39	86	TAGT	TAAG
V350256906L4C005R07001065814	chr1	361344	50M	194	361538	361345	361539	V350256906L4C005R07001065814_chr1_361344	54	45	CCAT	CGAA
V350256906L4C005R07001073988	chr1	981751	50M	144	981895	981752	981896	V350256906L4C005R07001073988_chr1_981751	48	53	CCCC	CTGC
V350256906L4C005R07001201713	chr1	753820	50M	152	753972	753821	753973	V350256906L4C005R07001201713_chr1_753820	28	0	CCAT	CTTT
V350256906L4C005R07100024785	chr1	1358801	50M	189	1358990	1358802	1358991	V350256906L4C005R07100024785_chr1_1358801	43	87	aGCG	ctac
V350256906L4C005R07100037418	chr1	1191897	50M	163	1192060	1191898	1192061	V350256906L4C005R07100037418_chr1_1191897	75	63	CAGA	tgat
V350256906L4C005R07100126298	chr1	561712	50M	153	561865	561713	561866	V350256906L4C005R07100126298_chr1_561712	7	29	CAGA	AGAA
V350256906L4C005R07100228355	chr1	246703	50M	163	246866	246704	246867	V350256906L4C005R07100228355_chr1_246703	57	39	CATT	CCAG
V350256906L4C005R07100275692	chr1	1125374	50M	157	1125531	1125375	1125532	V350256906L4C005R07100275692_chr1_1125374	49	12	ccca	acct
V350256906L4C005R07100689192	chr1	605876	50M	163	606039	605877	606040	V350256906L4C005R07100689192_chr1_605876	32	89	cgct	ACGT
V350256906L4C005R07100758022	chr1	22631	50M	167	22798	22632	22799	V350256906L4C005R07100758022_chr1_22631	0	143	GGAC	CACC
V350256906L4C005R07100848760	chr1	883197	50M	166	883363	883198	883364	V350256906L4C005R07100848760_chr1_883197	62	58	GCCT	CTTG
V350256906L4C005R07100865266	chr1	404395	50M	163	404558	404396	404559	V350256906L4C005R07100865266_chr1_404395	36	199	cacc	TCAT
V350256906L4C005R07200349444	chr1	579091	50M	144	579235	579092	579236	V350256906L4C005R07200349444_chr1_579091	27	106	CTTA	ATCT
V350256906L4C005R07200883787	chr1	725068	1S46M3S	194	725262	725069	725263	V350256906L4C005R07200883787_chr1_725068	98	7	aatg	cttt
V350256906L4C005R07201222127	chr1	74845	50M	216	75061	74846	75062	V350256906L4C005R07201222127_chr1_74845	280	64	gttt	tctg
V350256906L4C005R07201342104	chr1	48860	50M	196	49056	48861	49057	V350256906L4C005R07201342104_chr1_48860	0	0	gtga	tcat
V350256906L4C006R00100194195	chr1	1002998	50M	174	1003172	1002999	1003173	V350256906L4C006R00100194195_chr1_1002998	76	43	TCAT	ACGT
V350256906L4C006R00100420045	chr1	852303	50M	170	852473	852304	852474	V350256906L4C006R00100420045_chr1_852303	12	37	CCCT	GGGC
V350256906L4C006R00100479689	chr1	898738	50M	182	898920	898739	898921	V350256906L4C006R00100479689_chr1_898738	67	75	GGCT	CTGT
V350256906L4C006R00100676991	chr1	1324247	50M	185	1324432	1324248	1324433	V350256906L4C006R00100676991_chr1_1324247	183	0	ggag	ccag
V350256906L4C006R00100742480	chr1	400518	50M	182	400700	400519	400701	V350256906L4C006R00100742480_chr1_400518	185	174	cttt	tcag
V350256906L4C006R00101045316	chr1	560406	50M	188	560594	560407	560595	V350256906L4C006R00101045316_chr1_560406	9	0	CCCT	tata
V350256906L4C006R00200451749	chr1	835235	50M	184	835419	835236	835420	V350256906L4C006R00200451749_chr1_835235	54	59	CGTG	CTGG
V350256906L4C006R00200489708	chr1	1383292	50M	161	1383453	1383293	1383454	V350256906L4C006R00200489708_chr1_1383292	33	0	gatc	atct
V350256906L4C006R00200585744	chr1	28071	50M	183	28254	28072	28255	V350256906L4C006R00200585744_chr1_28071	0	26	AGTC	ctac
V350256906L4C006R00201008526	chr1	1377761	50M	162	1377923	1377762	1377924	V350256906L4C006R00201008526_chr1_1377761	46	67	TGAT	GGTT
V350256906L4C006R00201097296	chr1	964497	50M	162	964659	964498	964660	V350256906L4C006R00201097296_chr1_964497	180	18	CGAA	CCCA
V350256906L4C006R00201178252	chr1	710754	50M	169	710923	710755	710924	V350256906L4C006R00201178252_chr1_710754	0	0	GGTA	AACA
V350256906L4C006R00201220618	chr1	1264656	50M	154	1264810	1264657	1264811	V350256906L4C006R00201220618_chr1_1264656	64	42	CACT	AGAC
V350256906L4C006R00300500656	chr1	725746	9S29M12S	211	725957	725747	725958	V350256906L4C006R00300500656_chr1_725746	137	32	ggac	catt
V350256906L4C006R00300534745	chr1	954597	50M	168	954765	954598	954766	V350256906L4C006R00300534745_chr1_954597	67	72	ccca	TGCA
V350256906L4C006R00300577742	chr1	632895	50M	148	633043	632896	633044	V350256906L4C006R00300577742_chr1_632895	9	32	caat	ctca
V350256906L4C006R00300777678	chr1	1305308	50M	178	1305486	1305309	1305487	V350256906L4C006R00300777678_chr1_1305308	22	11	gctg	ATGC
V350256906L4C006R00300900064	chr1	828014	50M	165	828179	828015	828180	V350256906L4C006R00300900064_chr1_828014	24	49	gtga	tggc
V350256906L4C006R00400053203	chr1	756472	50M	188	756660	756473	756661	V350256906L4C006R00400053203_chr1_756472	41	196	TATA	GGCA
V350256906L4C006R00400157497	chr1	166644	50M	169	166813	166645	166814	V350256906L4C006R00400157497_chr1_166644	77	21	CTAA	ACAT
V350256906L4C006R00400205848	chr1	43989	50M	178	44167	43990	44168	V350256906L4C006R00400205848_chr1_43989	25	52	cact	tcaa
V350256906L4C006R00400632290	chr1	456203	50M	178	456381	456204	456382	V350256906L4C006R00400632290_chr1_456203	530	583	tcat	CCTA
V350256906L4C006R00401257995	chr1	33021	50M	149	33170	33022	33171	V350256906L4C006R00401257995_chr1_33021	0	92	attt	ccta
V350256906L4C006R00500092203	chr1	243538	50M	176	243714	243539	243715	V350256906L4C006R00500092203_chr1_243538	0	0	CATG	CAAA
V350256906L4C006R00500280040	chr1	379611	50M	175	379786	379612	379787	V350256906L4C006R00500280040_chr1_379611	1	10	tgtt	ggaa
V350256906L4C006R00500591772	chr1	464071	50M	168	464239	464072	464240	V350256906L4C006R00500591772_chr1_464071	16	11	ACTG	GTAT
V350256906L4C006R00500966547	chr1	47439	50M	181	47620	47440	47621	V350256906L4C006R00500966547_chr1_47439	42	94	CCAC	CAAG
V350256906L4C006R00501402588	chr1	926111	50M	166	926277	926112	926278	V350256906L4C006R00501402588_chr1_926111	25	0	tggc	ccca
V350256906L4C006R00600257266	chr1	1227088	50M	150	1227238	1227089	1227239	V350256906L4C006R00600257266_chr1_1227088	0	17	CCAG	CGGC
V350256906L4C006R00600325717	chr1	1142458	50M	161	1142619	1142459	1142620	V350256906L4C006R00600325717_chr1_1142458	161	0	GCAG	CGCG
V350256906L4C006R00600420124	chr1	1045617	50M	138	1045755	1045618	1045756	V350256906L4C006R00600420124_chr1_1045617	50	25	acct	ctat
V350256906L4C006R00600740986	chr1	543004	50M	155	543159	543005	543160	V350256906L4C006R00600740986_chr1_543004	35	0	CCAG	aata
V350256906L4C006R00600916247	chr1	729281	50M	167	729448	729282	729449	V350256906L4C006R00600916247_chr1_729281	0	15	tgaa	ccac
V350256906L4C006R00601168311	chr1	157992	50M	166	158158	157993	158159	V350256906L4C006R00601168311_chr1_157992	41	49	CTGC	taca
V350256906L4C006R00700010032	chr1	975705	50M	169	975874	975706	975875	V350256906L4C006R00700010032_chr1_975705	347	178	CCCA	CCCT
V350256906L4C006R00700181058	chr1	796012	50M	177	796189	796013	796190	V350256906L4C006R00700181058_chr1_796012	95	70	CATC	tccg
V350256906L4C006R00700294856	chr1	1294207	50M	191	1294398	1294208	1294399	V350256906L4C006R00700294856_chr1_1294207	45	52	TCTA	GAAG
V350256906L4C006R00701065706	chr1	1033147	50M	184	1033331	1033148	1033332	V350256906L4C006R00701065706_chr1_1033147	255	71	tgtc	cgtg
V350256906L4C006R00701089392	chr1	453802	50M	234	454036	453803	454037	V350256906L4C006R00701089392_chr1_453802	71	0	ggat	CCTG
V350256906L4C006R00701115308	chr1	106286	50M	144	106430	106287	106431	V350256906L4C006R00701115308_chr1_106286	182	38	ATAG	CCCT
V350256906L4C006R00701207202	chr1	14409	50M	160	14569	14410	14570	V350256906L4C006R00701207202_chr1_14409	57	0	GCTC	CCAG
V350256906L4C006R00701246832	chr1	1214801	50M	182	1214983	1214802	1214984	V350256906L4C006R00701246832_chr1_1214801	29	24	gaga	gtga
V350256906L4C006R00701310499	chr1	446863	50M	165	447028	446864	447029	V350256906L4C006R00701310499_chr1_446863	36	102	CCCT	tatg
V350256906L4C006R00800248706	chr1	1298286	50M	164	1298450	1298287	1298451	V350256906L4C006R00800248706_chr1_1298286	47	87	accc	cgcc
V350256906L4C006R00800297967	chr1	1302907	50M	147	1303054	1302908	1303055	V350256906L4C006R00800297967_chr1_1302907	25	63	gagt	CACC
V350256906L4C006R00800378281	chr1	1071797	50M	144	1071941	1071798	1071942	V350256906L4C006R00800378281_chr1_1071797	141	63	TGAG	GAAG
V350256906L4C006R00800665928	chr1	595251	50M	161	595412	595252	595413	V350256906L4C006R00800665928_chr1_595251	87	248	ACTG	ccca
V350256906L4C006R00800840393	chr1	847326	50M	153	847479	847327	847480	V350256906L4C006R00800840393_chr1_847326	52	40	ggat	CCAG
V350256906L4C006R00801007198	chr1	70276	50M	165	70441	70277	70442	V350256906L4C006R00801007198_chr1_70276	56	0	GTAC	CCTT
V350256906L4C006R00801329502	chr1	871635	50M	167	871802	871636	871803	V350256906L4C006R00801329502_chr1_871635	65	16	CTGG	CCTC
V350256906L4C006R00900001231	chr1	628188	50M	177	628365	628189	628366	V350256906L4C006R00900001231_chr1_628188	51	58	AGCA	GTTG
V350256906L4C006R00900258379	chr1	76132	50M	183	76315	76133	76316	V350256906L4C006R00900258379_chr1_76132	5	93	cgtg	ggta
V350256906L4C006R00900686536	chr1	337763	50M	178	337941	337764	337942	V350256906L4C006R00900686536_chr1_337763	133	16	CTTC	CCCC
V350256906L4C006R01000574170	chr1	355648	50M	180	355828	355649	355829	V350256906L4C006R01000574170_chr1_355648	24	204	tgaa	ccgg
V350256906L4C006R01000665063	chr1	903489	50M	165	903654	903490	903655	V350256906L4C006R01000665063_chr1_903489	59	58	CCTT	CCCT
V350256906L4C006R01000822082	chr1	1217982	50M	170	1218152	1217983	1218153	V350256906L4C006R01000822082_chr1_1217982	56	108	TGAT	caaa
V350256906L4C006R01001025917	chr1	40843	50M	161	41004	40844	41005	V350256906L4C006R01001025917_chr1_40843	86	59	actt	CCTG
V350256906L4C006R01001064952	chr1	658102	50M	155	658257	658103	658258	V350256906L4C006R01001064952_chr1_658102	177	22	CACC	CTGA
V350256906L4C006R01001390762	chr1	1046474	50M	156	1046630	1046475	1046631	V350256906L4C006R01001390762_chr1_1046474	5	72	CATG	gccc
V350256906L4C006R01100421928	chr1	937628	50M	161	937789	937629	937790	V350256906L4C006R01100421928_chr1_937628	41	49	cctg	ccct
V350256906L4C006R01100872790	chr1	176495	50M	159	176654	176496	176655	V350256906L4C006R01100872790_chr1_176495	234	75	CCAC	GTCG
V350256906L4C006R01101191037	chr1	1062044	50M	166	1062210	1062045	1062211	V350256906L4C006R01101191037_chr1_1062044	72	38	CTGC	CCCA
V350256906L4C006R01101309989	chr1	75359	50M	167	75526	75360	75527	V350256906L4C006R01101309989_chr1_75359	21	100	atca	tgtt
V350256906L4C006R01200012411	chr1	1201648	50M	185	1201833	1201649	1201834	V350256906L4C006R01200012411_chr1_1201648	30	34	CAAC	cctg
V350256906L4C006R01200093212	chr1	236981	50M	174	237155	236982	237156	V350256906L4C006R01200093212_chr1_236981	41	82	AAAT	GGAA
V350256906L4C006R01200757768	chr1	1266615	50M	165	1266780	1266616	1266781	V350256906L4C006R01200757768_chr1_1266615	0	28	GCAA	CCCA
V350256906L4C006R01200820714	chr1	699709	50M	158	699867	699710	699868	V350256906L4C006R01200820714_chr1_699709	103	23	cctg	cctt
V350256906L4C006R01201202679	chr1	714186	50M	181	714367	714187	714368	V350256906L4C006R01201202679_chr1_714186	59	43	CCTA	GGCC
V350256906L4C006R01201278280	chr1	608196	50M	133	608329	608197	608330	V350256906L4C006R01201278280_chr1_608196	132	228	ggtt	taag
V350256906L4C006R01300174019	chr1	765644	50M	174	765818	765645	765819	V350256906L4C006R01300174019_chr1_765644	45	45	gcca	ttag
V350256906L4C006R01300314414	chr1	375396	50M	160	375556	375397	375557	V350256906L4C006R01300314414_chr1_375396	0	0	tata	caca
V350256906L4C006R01300344311	chr1	765678	50M	165	765843	765679	765844	V350256906L4C006R01300344311_chr1_765678	63	70	ccct	caat
V350256906L4C006R01300635643	chr1	696348	50M	167	696515	696349	696516	V350256906L4C006R01300635643_chr1_696348	45	47	CATA	CTTT
V350256906L4C006R01300689271	chr1	914110	50M	148	914258	914111	914259	V350256906L4C006R01300689271_chr1_914110	240	92	CTGG	CGTG
V350256906L4C006R01300712593	chr1	67429	50M	189	67618	67430	67619	V350256906L4C006R01300712593_chr1_67429	56	71	CTTT	CCTG
V350256906L4C006R01300791523	chr1	673102	50M	159	673261	673103	673262	V350256906L4C006R01300791523_chr1_673102	31	0	ggtg	gtca
V350256906L4C006R01301170812	chr1	752228	50M	161	752389	752229	752390	V350256906L4C006R01301170812_chr1_752228	149	0	ctac	ttaa
V350256906L4C006R01400242742	chr1	995917	50M	168	996085	995918	996086	V350256906L4C006R01400242742_chr1_995917	49	25	agat	CCCT
V350256906L4C006R01401194567	chr1	24010	50M	174	24184	24011	24185	V350256906L4C006R01401194567_chr1_24010	12	40	ccca	gcag
V350256906L4C006R01401324247	chr1	45157	50M	179	45336	45158	45337	V350256906L4C006R01401324247_chr1_45157	390	211	ccaa	tcaa
V350256906L4C006R01500349938	chr1	1077765	50M	185	1077950	1077766	1077951	V350256906L4C006R01500349938_chr1_1077765	91	39	ctaa	TGCA
V350256906L4C006R01500377703	chr1	1137667	50M	116	1137783	1137668	1137784	V350256906L4C006R01500377703_chr1_1137667	13	75	ccag	cggg
V350256906L4C006R01501103247	chr1	38177	50M	179	38356	38178	38357	V350256906L4C006R01501103247_chr1_38177	20	0	cctc	aaca
V350256906L4C006R01501244750	chr1	465482	50M	160	465642	465483	465643	V350256906L4C006R01501244750_chr1_465482	37	197	CATC	GTTT
V350256906L4C006R01501324477	chr1	340520	50M	170	340690	340521	340691	V350256906L4C006R01501324477_chr1_340520	45	103	CACA	TCTT
V350256906L4C006R01600324020	chr1	713672	50M	155	713827	713673	713828	V350256906L4C006R01600324020_chr1_713672	67	35	cgca	GCGC
V350256906L4C006R01600502397	chr1	778303	50M	167	778470	778304	778471	V350256906L4C006R01600502397_chr1_778303	8	74	CTCT	CCCA
V350256906L4C006R01600548448	chr1	1346396	50M	165	1346561	1346397	1346562	V350256906L4C006R01600548448_chr1_1346396	38	2	gacc	caat
V350256906L4C006R01600579797	chr1	1226151	50M	176	1226327	1226152	1226328	V350256906L4C006R01600579797_chr1_1226151	23	16	CAAG	TGTG
V350256906L4C006R01600617227	chr1	896571	50M	263	896834	896572	896835	V350256906L4C006R01600617227_chr1_896571	0	63	CACC	GGCC
V350256906L4C006R01601056613	chr1	121780	50M	204	121984	121781	121985	V350256906L4C006R01601056613_chr1_121780	0	0	GGAG	AGTG
V350256906L4C006R01700337193	chr1	65228	38M	208	65436	65229	65437	V350256906L4C006R01700337193_chr1_65228	107	16	ATTT	ACCT
V350256906L4C006R01700621450	chr1	1408830	50M	196	1409026	1408831	1409027	V350256906L4C006R01700621450_chr1_1408830	24	4	cgcc	cgcg
V350256906L4C006R01700622953	chr1	1228263	50M	185	1228448	1228264	1228449	V350256906L4C006R01700622953_chr1_1228263	0	22	AGTG	GGCG
V350256906L4C006R01700677544	chr1	27260	50M	162	27422	27261	27423	V350256906L4C006R01700677544_chr1_27260	63	43	GGCA	agat
V350256906L4C006R01700974543	chr1	967133	50M	193	967326	967134	967327	V350256906L4C006R01700974543_chr1_967133	72	41	CCCA	GCTG
V350256906L4C006R01701110222	chr1	555562	50M	168	555730	555563	555731	V350256906L4C006R01701110222_chr1_555562	0	30	ACCT	acag
V350256906L4C006R01701267967	chr1	18140	50M	168	18308	18141	18309	V350256906L4C006R01701267967_chr1_18140	28	75	TGGA	CAAG
V350256906L4C006R01800268209	chr1	466097	50M	94	466191	466098	466192	V350256906L4C006R01800268209_chr1_466097	58	0	ggcc	tgat
V350256906L4C006R01800467967	chr1	1182341	50M	203	1182544	1182342	1182545	V350256906L4C006R01800467967_chr1_1182341	60	28	CAGA	GCTG
V350256906L4C006R01800496079	chr1	169696	50M	177	169873	169697	169874	V350256906L4C006R01800496079_chr1_169696	15	3	CCAG	aaaa
V350256906L4C006R01800849613	chr1	931422	50M	140	931562	931423	931563	V350256906L4C006R01800849613_chr1_931422	73	0	CAAG	CCCA
V350256906L4C006R01800878461	chr1	993941	50M	171	994112	993942	994113	V350256906L4C006R01800878461_chr1_993941	52	51	GGCA	CCCA
V350256906L4C006R01800880675	chr1	585499	50M	164	585663	585500	585664	V350256906L4C006R01800880675_chr1_585499	59	73	taag	tctg
V350256906L4C006R01800936396	chr1	1252849	50M	168	1253017	1252850	1253018	V350256906L4C006R01800936396_chr1_1252849	0	0	catg	ggat
V350256906L4C006R02000211418	chr1	1298889	50M	107	1298996	1298890	1298997	V350256906L4C006R02000211418_chr1_1298889	79	0	accg	aaaa
V350256906L4C006R02000406172	chr1	557288	50M	266	557554	557289	557555	V350256906L4C006R02000406172_chr1_557288	351	85	CGCT	CTTA
V350256906L4C006R02000562569	chr1	858390	50M	201	858591	858391	858592	V350256906L4C006R02000562569_chr1_858390	46	111	CACC	ACTA
V350256906L4C006R02000595036	chr1	989620	50M	110	989730	989621	989731	V350256906L4C006R02000595036_chr1_989620	0	56	AAGC	CAGC
V350256906L4C006R02000633408	chr1	390267	50M	169	390436	390268	390437	V350256906L4C006R02000633408_chr1_390267	6	23	ccat	tgtg
V350256906L4C006R02000802883	chr1	234791	50M	173	234964	234792	234965	V350256906L4C006R02000802883_chr1_234791	9	93	CTAA	tgga
V350256906L4C006R02000881038	chr1	1340613	50M	171	1340784	1340614	1340785	V350256906L4C006R02000881038_chr1_1340613	62	94	ccaa	tgag
V350256906L4C006R02000914834	chr1	98250	50M	182	98432	98251	98433	V350256906L4C006R02000914834_chr1_98250	219	37	TGAC	CCTG
V350256906L4C006R02100071938	chr1	811088	50M	108	811196	811089	811197	V350256906L4C006R02100071938_chr1_811088	37	0	CCCC	CCCA
V350256906L4C006R02100181653	chr1	455046	50M	175	455221	455047	455222	V350256906L4C006R02100181653_chr1_455046	53	104	CCCA	AGAG
V350256906L4C006R02100492176	chr1	118460	50M	180	118640	118461	118641	V350256906L4C006R02100492176_chr1_118460	0	0	aggc	ccag
V350256906L4C006R02100679329	chr1	1387412	50M	176	1387588	1387413	1387589	V350256906L4C006R02100679329_chr1_1387412	0	7	CGGC	GGAG
V350256906L4C006R02100757797	chr1	973218	50M	171	973389	973219	973390	V350256906L4C006R02100757797_chr1_973218	196	99	CGGG	CGCT
V350256906L4C006R02100762718	chr1	644923	50M	147	645070	644924	645071	V350256906L4C006R02100762718_chr1_644923	101	248	taca	ctca
V350256906L4C006R02100769123	chr1	740774	50M	170	740944	740775	740945	V350256906L4C006R02100769123_chr1_740774	141	189	CCTC	CCTG
V350256906L4C006R02100808930	chr1	1208056	50M	178	1208234	1208057	1208235	V350256906L4C006R02100808930_chr1_1208056	0	0	CAAG	CGTG
V350256906L4C006R02100834250	chr1	564947	50M	217	565164	564948	565165	V350256906L4C006R02100834250_chr1_564947	6	0	ccta	TATT
V350256906L4C006R02101112782	chr1	1043201	50M	167	1043368	1043202	1043369	V350256906L4C006R02101112782_chr1_1043201	0	39	cact	ctcg
V350256906L4C006R02200089658	chr1	831595	50M	157	831752	831596	831753	V350256906L4C006R02200089658_chr1_831595	0	92	ctat	cctt
V350256906L4C006R02200184321	chr1	529021	50M	162	529183	529022	529184	V350256906L4C006R02200184321_chr1_529021	0	31	CCCC	CCTG
V350256906L4C006R02200425519	chr1	684399	50M	207	684606	684400	684607	V350256906L4C006R02200425519_chr1_684399	13	0	ctga	cata
V350256906L4C006R02200648895	chr1	1369498	50M	148	1369646	1369499	1369647	V350256906L4C006R02200648895_chr1_1369498	0	0	CCAC	CCGT
V350256906L4C006R02200941464	chr1	811049	50M	174	811223	811050	811224	V350256906L4C006R02200941464_chr1_811049	0	0	GCCC	gggg
V350256906L4C006R02201056345	chr1	771365	50M	161	771526	771366	771527	V350256906L4C006R02201056345_chr1_771365	56	48	GGAG	AAAC
V350256906L4C006R02300130597	chr1	17414	50M	143	17557	17415	17558	V350256906L4C006R02300130597_chr1_17414	31	79	TGAG	GCTT
V350256906L4C006R02300278511	chr1	603759	50M	148	603907	603760	603908	V350256906L4C006R02300278511_chr1_603759	526	378	ctca	cctg
V350256906L4C006R02300515256	chr1	871627	50M	156	871783	871628	871784	V350256906L4C006R02300515256_chr1_871627	57	0	TAGG	GGAG
V350256906L4C006R02300596873	chr1	1324065	50M	151	1324216	1324066	1324217	V350256906L4C006R02300596873_chr1_1324065	15	166	cacc	ccaa
V350256906L4C006R02300632329	chr1	27260	50M	157	27417	27261	27418	V350256906L4C006R02300632329_chr1_27260	63	38	GGCA	tttt
V350256906L4C006R02301328022	chr1	620140	50M	187	620327	620141	620328	V350256906L4C006R02301328022_chr1_620140	90	60	CAGA	ttta
V350256906L4C006R02400097703	chr1	162486	50M	174	162660	162487	162661	V350256906L4C006R02400097703_chr1_162486	66	19	ccca	caat
V350256906L4C006R02400375490	chr1	803640	50M	172	803812	803641	803813	V350256906L4C006R02400375490_chr1_803640	0	50	aaaa	TGAG
V350256906L4C006R02400565982	chr1	741350	50M	182	741532	741351	741533	V350256906L4C006R02400565982_chr1_741350	20	0	TAAA	TTAA
V350256906L4C006R02400594837	chr1	243927	50M	155	244082	243928	244083	V350256906L4C006R02400594837_chr1_243927	33	11	TATC	CCTG
V350256906L4C006R02400961553	chr1	842329	50M	164	842493	842330	842494	V350256906L4C006R02400961553_chr1_842329	0	8	GCTT	GACA
V350256906L4C006R02500106947	chr1	806577	50M	240	806817	806578	806818	V350256906L4C006R02500106947_chr1_806577	47	21	ctga	atgt
V350256906L4C006R02500248697	chr1	1201176	50M	177	1201353	1201177	1201354	V350256906L4C006R02500248697_chr1_1201176	36	16	ggct	GATT
V350256906L4C006R02500401276	chr1	833403	50M	143	833546	833404	833547	V350256906L4C006R02500401276_chr1_833403	0	61	cgaa	cgaa
V350256906L4C006R02500480624	chr1	909392	50M	167	909559	909393	909560	V350256906L4C006R02500480624_chr1_909392	3	6	CAAG	CCCT
V350256906L4C006R02500617724	chr1	100446	50M	190	100636	100447	100637	V350256906L4C006R02500617724_chr1_100446	27	118	CTAA	TTTT
V350256906L4C006R02501159754	chr1	117516	50M	185	117701	117517	117702	V350256906L4C006R02501159754_chr1_117516	0	0	caat	gata
V350256906L4C006R02600199853	chr1	15004	50M	216	15220	15005	15221	V350256906L4C006R02600199853_chr1_15004	170	0	CGAC	CCTC
V350256906L4C006R02601009641	chr1	1144968	50M	183	1145151	1144969	1145152	V350256906L4C006R02601009641_chr1_1144968	68	64	caag	cgcc
V350256906L4C006R02601346408	chr1	874646	50M	180	874826	874647	874827	V350256906L4C006R02601346408_chr1_874646	63	77	CCCC	GATG
V350256906L4C006R02700106510	chr1	328528	50M	173	328701	328529	328702	V350256906L4C006R02700106510_chr1_328528	0	137	GGTT	CGAC
V350256906L4C006R02700414873	chr1	1216334	50M	194	1216528	1216335	1216529	V350256906L4C006R02700414873_chr1_1216334	158	18	TGCA	GTGA
V350256906L4C006R02700430893	chr1	895138	50M	210	895348	895139	895349	V350256906L4C006R02700430893_chr1_895138	58	0	CCAC	CGCC
V350256906L4C006R02700464439	chr1	258994	50M	174	259168	258995	259169	V350256906L4C006R02700464439_chr1_258994	40	52	CTAC	TGTT
V350256906L4C006R02700547116	chr1	124997	50M	168	125165	124998	125166	V350256906L4C006R02700547116_chr1_124997	57	14	TAGA	GGAT
V350256906L4C006R02701038430	chr1	1113115	50M	172	1113287	1113116	1113288	V350256906L4C006R02701038430_chr1_1113115	38	92	CTGA	CCTA
V350256906L4C006R02701107670	chr1	1197494	50M	184	1197678	1197495	1197679	V350256906L4C006R02701107670_chr1_1197494	67	51	ccca	ACCA
V350256906L4C006R02701282876	chr1	854993	50M	135	855128	854994	855129	V350256906L4C006R02701282876_chr1_854993	27	1	CCAC	CCCC
V350256906L4C006R02701324092	chr1	1271533	50M	174	1271707	1271534	1271708	V350256906L4C006R02701324092_chr1_1271533	53	37	CCAC	CGGC
V350256906L4C006R02701406468	chr1	1172593	50M	177	1172770	1172594	1172771	V350256906L4C006R02701406468_chr1_1172593	40	42	TGGG	GGTG
V350256906L4C006R02800102808	chr1	128717	50M	157	128874	128718	128875	V350256906L4C006R02800102808_chr1_128717	11	37	ccca	cctg
V350256906L4C006R02800105636	chr1	1215576	50M	149	1215725	1215577	1215726	V350256906L4C006R02800105636_chr1_1215576	244	95	ggct	ctac
V350256906L4C006R02800155257	chr1	146781	50M	159	146940	146782	146941	V350256906L4C006R02800155257_chr1_146781	16	38	ggca	caat
V350256906L4C006R02800282754	chr1	646144	50M	157	646301	646145	646302	V350256906L4C006R02800282754_chr1_646144	234	77	ccat	cttt
V350256906L4C006R02800700387	chr1	787395	50M	170	787565	787396	787566	V350256906L4C006R02800700387_chr1_787395	64	60	GTAC	CTAT
V350256906L4C006R02900335965	chr1	1038719	50M	170	1038889	1038720	1038890	V350256906L4C006R02900335965_chr1_1038719	58	6	ccct	gttt
V350256906L4C006R02900405209	chr1	873422	50M	182	873604	873423	873605	V350256906L4C006R02900405209_chr1_873422	196	204	CCCT	CCAG
V350256906L4C006R02900885855	chr1	949137	50M	124	949261	949138	949262	V350256906L4C006R02900885855_chr1_949137	19	63	GGCA	CCTC
V350256906L4C006R02900927707	chr1	641415	50M	160	641575	641416	641576	V350256906L4C006R02900927707_chr1_641415	25	37	GACC	CTTT
V350256906L4C006R02900933481	chr1	134201	50M	175	134376	134202	134377	V350256906L4C006R02900933481_chr1_134201	0	152	cggg	Tggc
V350256906L4C006R02901257069	chr1	742811	50M	185	742996	742812	742997	V350256906L4C006R02901257069_chr1_742811	25	5	CCCA	CACT
V350256906L4C006R03000637968	chr1	541960	36M14S	203	542163	541961	542164	V350256906L4C006R03000637968_chr1_541960	0	0	CCCA	CCTT
V350256906L4C006R03000728573	chr1	363282	50M	174	363456	363283	363457	V350256906L4C006R03000728573_chr1_363282	60	47	taca	tagg
V350256906L4C006R03000876398	chr1	1083065	50M	139	1083204	1083066	1083205	V350256906L4C006R03000876398_chr1_1083065	64	22	TGTA	cctc
V350256906L4C006R03000882197	chr1	931063	50M	168	931231	931064	931232	V350256906L4C006R03000882197_chr1_931063	65	75	GGGT	CGGC
V350256906L4C006R03000882946	chr1	362684	50M	166	362850	362685	362851	V350256906L4C006R03000882946_chr1_362684	71	63	CCCA	GGAA
V350256906L4C006R03100771377	chr1	845868	50M	174	846042	845869	846043	V350256906L4C006R03100771377_chr1_845868	174	112	GGGG	CCTG
V350256906L4C006R03101084400	chr1	988130	50M	139	988269	988131	988270	V350256906L4C006R03101084400_chr1_988130	103	28	tgca	caca
V350256906L4C006R03101086388	chr1	228194	50M	179	228373	228195	228374	V350256906L4C006R03101086388_chr1_228194	94	76	taaa	TATG
V350256906L4C006R03200338478	chr1	972332	50M	182	972514	972333	972515	V350256906L4C006R03200338478_chr1_972332	39	40	CAGG	ACCT
V350256906L4C006R03201092013	chr1	823377	50M	170	823547	823378	823548	V350256906L4C006R03201092013_chr1_823377	61	33	CCCA	agga
V350256906L4C006R03201184141	chr1	907488	50M	140	907628	907489	907629	V350256906L4C006R03201184141_chr1_907488	76	24	CTGG	CCCC
V350256906L4C006R03201374516	chr1	726825	23S22M5S	147	726972	726826	726973	V350256906L4C006R03201374516_chr1_726825	0	23	gaat	tcca
V350256906L4C006R03300709690	chr1	1141177	50M	197	1141374	1141178	1141375	V350256906L4C006R03300709690_chr1_1141177	92	50	CCCC	CCTG
V350256906L4C006R03300768802	chr1	42334	50M	138	42472	42335	42473	V350256906L4C006R03300768802_chr1_42334	214	76	AGAT	gcac
V350256906L4C006R03300869407	chr1	234144	50M	174	234318	234145	234319	V350256906L4C006R03300869407_chr1_234144	44	33	TCTC	AGGA
V350256906L4C006R03301032451	chr1	1399878	9S41M	169	1400047	1399879	1400048	V350256906L4C006R03301032451_chr1_1399878	15	0	cggt	cctg
V350256906L4C006R03400120398	chr1	464363	50M	174	464537	464364	464538	V350256906L4C006R03400120398_chr1_464363	135	42	TCTT	ccct
V350256906L4C006R03400464877	chr1	669491	50M	160	669651	669492	669652	V350256906L4C006R03400464877_chr1_669491	33	193	gcta	cctc
V350256906L4C006R03400692711	chr1	1237171	50M	150	1237321	1237172	1237322	V350256906L4C006R03400692711_chr1_1237171	21	45	CCCC	TCCC
V350256906L4C006R03400735785	chr1	432081	50M	160	432241	432082	432242	V350256906L4C006R03400735785_chr1_432081	73	131	cccc	AGAC
V350256906L4C006R03401375172	chr1	1138995	50M	177	1139172	1138996	1139173	V350256906L4C006R03401375172_chr1_1138995	36	21	AGCA	CCCC
V350256906L4C006R03500404109	chr1	231344	50M	191	231535	231345	231536	V350256906L4C006R03500404109_chr1_231344	72	263	ggga	cctc
V350256906L4C006R03500467016	chr1	801415	50M	169	801584	801416	801585	V350256906L4C006R03500467016_chr1_801415	0	73	GGAA	GAAG
V350256906L4C006R03500566801	chr1	410254	50M	190	410444	410255	410445	V350256906L4C006R03500566801_chr1_410254	142	332	ATGA	CCAT
V350256906L4C006R03500589569	chr1	125590	50M	163	125753	125591	125754	V350256906L4C006R03500589569_chr1_125590	325	202	GTAT	CCAT
V350256906L4C006R03500925057	chr1	765987	50M	172	766159	765988	766160	V350256906L4C006R03500925057_chr1_765987	0	158	actt	ccag
V350256906L4C006R03600155666	chr1	881188	50M	190	881378	881189	881379	V350256906L4C006R03600155666_chr1_881188	35	27	CATC	CGTT
V350256906L4C006R03600657007	chr1	855682	50M	151	855833	855683	855834	V350256906L4C006R03600657007_chr1_855682	0	106	CCCA	ATGG
V350256906L4C006R03600786788	chr1	1365463	50M	132	1365595	1365464	1365596	V350256906L4C006R03600786788_chr1_1365463	0	86	ccta	tcca
V350256906L4C006R03601246052	chr1	146727	50M	175	146902	146728	146903	V350256906L4C006R03601246052_chr1_146727	6	76	GCTA	cagg
V350256906L4C006R03700022277	chr1	1330405	50M	183	1330588	1330406	1330589	V350256906L4C006R03700022277_chr1_1330405	70	63	ctgc	ATTT
V350256906L4C006R03700132152	chr1	63101	50M	188	63289	63102	63290	V350256906L4C006R03700132152_chr1_63101	0	109	TGAT	GCAC
V350256906L4C006R03700212944	chr1	781757	50M	165	781922	781758	781923	V350256906L4C006R03700212944_chr1_781757	5	0	ctat	cccc
V350256906L4C006R03700316974	chr1	973073	50M	207	973280	973074	973281	V350256906L4C006R03700316974_chr1_973073	51	208	CTAG	CGTG
V350256906L4C006R03700570947	chr1	1226484	50M	161	1226645	1226485	1226646	V350256906L4C006R03700570947_chr1_1226484	42	63	CAAC	AGCT
V350256906L4C006R03700701826	chr1	107743	50M	162	107905	107744	107906	V350256906L4C006R03700701826_chr1_107743	22	0	ctta	tgct
V350256906L4C006R03700757869	chr1	1379773	50M	194	1379967	1379774	1379968	V350256906L4C006R03700757869_chr1_1379773	0	19	CGAG	CACC
V350256906L4C006R03700873303	chr1	906761	50M	137	906898	906762	906899	V350256906L4C006R03700873303_chr1_906761	34	60	GAGC	CCTG
V350256906L4C006R03700929736	chr1	726816	50M	177	726993	726817	726994	V350256906L4C006R03700929736_chr1_726816	0	2	aatg	ttcc
V350256906L4C006R03700937725	chr1	1062639	50M	196	1062835	1062640	1062836	V350256906L4C006R03700937725_chr1_1062639	67	61	GCAG	AGAC
V350256906L4C006R03700986534	chr1	34157	50M	221	34378	34158	34379	V350256906L4C006R03700986534_chr1_34157	35	42	CCCA	CCCT
V350256906L4C006R03701246838	chr1	980304	50M	207	980511	980305	980512	V350256906L4C006R03701246838_chr1_980304	80	69	CGTG	ATGC
V350256906L4C006R03701271664	chr1	812733	50M	171	812904	812734	812905	V350256906L4C006R03701271664_chr1_812733	44	30	CTGT	GGTG
V350256906L4C006R03800009384	chr1	634597	50M	168	634765	634598	634766	V350256906L4C006R03800009384_chr1_634597	0	168	cagg	ccca
V350256906L4C006R03800135683	chr1	1348686	50M	178	1348864	1348687	1348865	V350256906L4C006R03800135683_chr1_1348686	5	16	cccc	tgaa
V350256906L4C006R03800326491	chr1	1355330	50M	185	1355515	1355331	1355516	V350256906L4C006R03800326491_chr1_1355330	63	38	ACAC	TGGC
V350256906L4C006R03800353828	chr1	555659	50M	131	555790	555660	555791	V350256906L4C006R03800353828_chr1_555659	80	9	cgtg	ccaa
V350256906L4C006R03800514048	chr1	640764	50M	178	640942	640765	640943	V350256906L4C006R03800514048_chr1_640764	65	44	ccaa	CCAT
V350256906L4C006R03800723765	chr1	1160776	50M	167	1160943	1160777	1160944	V350256906L4C006R03800723765_chr1_1160776	70	60	CCTC	GAGG
V350256906L4C006R03800767922	chr1	1274802	50M	187	1274989	1274803	1274990	V350256906L4C006R03800767922_chr1_1274802	52	59	TGGG	CCCG
V350256906L4C006R03801126922	chr1	852276	50M	180	852456	852277	852457	V350256906L4C006R03801126922_chr1_852276	39	54	TTGT	TATG
V350256906L4C006R03801248418	chr1	1379142	50M	175	1379317	1379143	1379318	V350256906L4C006R03801248418_chr1_1379142	41	69	aatg	ctcg
V350256906L4C006R03801284291	chr1	236937	50M	161	237098	236938	237099	V350256906L4C006R03801284291_chr1_236937	0	139	TGTT	CCCG
V350256906L4C006R03900781766	chr1	464909	50M	213	465122	464910	465123	V350256906L4C006R03900781766_chr1_464909	278	72	TCCT	ccct
V350256906L4C006R03901028588	chr1	775921	50M	176	776097	775922	776098	V350256906L4C006R03901028588_chr1_775921	24	49	atcc	TCAA
V350256906L4C006R03901197770	chr1	1002524	50M	129	1002653	1002525	1002654	V350256906L4C006R03901197770_chr1_1002524	20	41	CATA	CAAG
V350256906L4C006R04000762178	chr1	707024	50M	181	707205	707025	707206	V350256906L4C006R04000762178_chr1_707024	24	12	ctgt	CCCA
V350256906L4C006R04001286708	chr1	1032110	50M	179	1032289	1032111	1032290	V350256906L4C006R04001286708_chr1_1032110	55	73	ctcc	ctac
V350256906L4C006R04100038168	chr1	328063	50M	190	328253	328064	328254	V350256906L4C006R04100038168_chr1_328063	0	0	CCCA	CAGG
V350256906L4C006R04100043970	chr1	261922	50M	156	262078	261923	262079	V350256906L4C006R04100043970_chr1_261922	13	7	ctta	CACC
V350256906L4C006R04100047281	chr1	136822	50M	146	136968	136823	136969	V350256906L4C006R04100047281_chr1_136822	338	192	GGGG	CCCA
V350256906L4C006R04100276891	chr1	732220	50M	169	732389	732221	732390	V350256906L4C006R04100276891_chr1_732220	50	62	TATC	tgaa
V350256906L4C006R04100334146	chr1	354205	50M	174	354379	354206	354380	V350256906L4C006R04100334146_chr1_354205	215	301	gtaa	cctg
V350256906L4C006R04100416610	chr1	128825	50M	171	128996	128826	128997	V350256906L4C006R04100416610_chr1_128825	72	39	cctc	cctg
V350256906L4C006R04101141075	chr1	994681	50M	168	994849	994682	994850	V350256906L4C006R04101141075_chr1_994681	50	0	CGAC	TTCC
V350256906L4C006R04200596345	chr1	1399208	50M	169	1399377	1399209	1399378	V350256906L4C006R04200596345_chr1_1399208	56	68	cttg	ctgg
V350256906L4C006R04200659548	chr1	1109941	50M	213	1110154	1109942	1110155	V350256906L4C006R04200659548_chr1_1109941	29	2	CCAC	AGGT
V350256906L4C006R04201157904	chr1	785776	50M	179	785955	785777	785956	V350256906L4C006R04201157904_chr1_785776	0	1	GCAA	GGAA
V350256906L4C006R04300333392	chr1	329236	50M	174	329410	329237	329411	V350256906L4C006R04300333392_chr1_329236	125	15	ggcg	CAGG
V350256906L4C006R04300396979	chr1	1004101	50M	184	1004285	1004102	1004286	V350256906L4C006R04300396979_chr1_1004101	16	28	GTGC	CGGC
V350256906L4C006R04300522884	chr1	414510	50M	178	414688	414511	414689	V350256906L4C006R04300522884_chr1_414510	127	212	TGGT	ggtc
V350256906L4C006R04300608219	chr1	1335944	50M	163	1336107	1335945	1336108	V350256906L4C006R04300608219_chr1_1335944	7	12	CACG	TGGG
V350256906L4C006R04300676516	chr1	1272063	50M	94	1272157	1272064	1272158	V350256906L4C006R04300676516_chr1_1272063	50	16	GGGG	AGCA
V350256906L4C006R04300984533	chr1	358663	50M	161	358824	358664	358825	V350256906L4C006R04300984533_chr1_358663	82	36	caat	GGAG
V350256906L4C006R04400302941	chr1	1158576	50M	193	1158769	1158577	1158770	V350256906L4C006R04400302941_chr1_1158576	5	134	caca	AGGC
V350256906L4C006R04400388639	chr1	136834	50M	199	137033	136835	137034	V350256906L4C006R04400388639_chr1_136834	326	127	AGGC	CCTC
V350256906L4C006R04400643597	chr1	999738	50M	175	999913	999739	999914	V350256906L4C006R04400643597_chr1_999738	67	67	CAGG	CCGG
V350256906L4C006R04401043237	chr1	541050	50M	271	541321	541051	541322	V350256906L4C006R04401043237_chr1_541050	31	20	aatg	CCAG
V350256906L4C006R04500251127	chr1	564140	50M	165	564305	564141	564306	V350256906L4C006R04500251127_chr1_564140	0	5	CCCT	GATC
V350256906L4C006R04500414848	chr1	1422293	50M	270	1422563	1422294	1422564	V350256906L4C006R04500414848_chr1_1422293	47	0	TGGG	GTCA
V350256906L4C006R04500574677	chr1	650833	30M1D20M	170	651003	650834	651004	V350256906L4C006R04500574677_chr1_650833	19	116	CTAA	gggc
V350256906L4C006R04500706075	chr1	814271	50M	185	814456	814272	814457	V350256906L4C006R04500706075_chr1_814271	2	11	CAAG	GCCA
V350256906L4C006R04500712451	chr1	129565	50M	151	129716	129566	129717	V350256906L4C006R04500712451_chr1_129565	208	161	ccac	tact
V350256906L4C006R04501393480	chr1	231542	50M	119	231661	231543	231662	V350256906L4C006R04501393480_chr1_231542	270	353	taca	agat
V350256906L4C006R04600047631	chr1	362462	50M	171	362633	362463	362634	V350256906L4C006R04600047631_chr1_362462	68	48	TCTT	TGAA
V350256906L4C006R04600274000	chr1	1153825	50M	147	1153972	1153826	1153973	V350256906L4C006R04600274000_chr1_1153825	63	63	CGCC	CCCT
V350256906L4C006R04600572487	chr1	1084649	50M	175	1084824	1084650	1084825	V350256906L4C006R04600572487_chr1_1084649	38	74	AGTG	CGGG
V350256906L4C006R04600620720	chr1	1067196	50M	150	1067346	1067197	1067347	V350256906L4C006R04600620720_chr1_1067196	38	92	TTCA	ACCA
V350256906L4C006R04700075148	chr1	365608	50M	168	365776	365609	365777	V350256906L4C006R04700075148_chr1_365608	63	21	CCAG	actg
V350256906L4C006R04700614430	chr1	729956	50M	159	730115	729957	730116	V350256906L4C006R04700614430_chr1_729956	16	35	ctat	TAAT
V350256906L4C006R04700980542	chr1	1369183	50M	193	1369376	1369184	1369377	V350256906L4C006R04700980542_chr1_1369183	24	44	GAGT	CTCA
V350256906L4C006R04701048385	chr1	1110752	50M	160	1110912	1110753	1110913	V350256906L4C006R04701048385_chr1_1110752	0	55	CCTG	GAGG
V350256906L4C006R04701127477	chr1	243790	50M	131	243921	243791	243922	V350256906L4C006R04701127477_chr1_243790	61	27	TGCA	TGAG
V350256906L4C006R04800938370	chr1	577040	50M	200	577240	577041	577241	V350256906L4C006R04800938370_chr1_577040	0	0	AAGA	tgga
V350256906L4C006R04801040074	chr1	739012	50M	187	739199	739013	739200	V350256906L4C006R04801040074_chr1_739012	55	173	TAGT	CCCT
V350256906L4C006R04801077521	chr1	1251233	50M	171	1251404	1251234	1251405	V350256906L4C006R04801077521_chr1_1251233	0	121	ggga	GTCT
V350256906L4C006R04900022378	chr1	792546	50M	176	792722	792547	792723	V350256906L4C006R04900022378_chr1_792546	72	69	CTTC	TCAT
V350256906L4C006R04900191557	chr1	1236192	50M	168	1236360	1236193	1236361	V350256906L4C006R04900191557_chr1_1236192	118	31	ccca	gcct
V350256906L4C006R04900315221	chr1	552049	50M	133	552182	552050	552183	V350256906L4C006R04900315221_chr1_552049	9	0	ccag	catt
V350256906L4C006R04900424316	chr1	667581	16M1I33M	178	667759	667582	667760	V350256906L4C006R04900424316_chr1_667581	0	23	ggag	CTTT
V350256906L4C006R04900767739	chr1	1029586	50M	182	1029768	1029587	1029769	V350256906L4C006R04900767739_chr1_1029586	30	18	tcct	gaag
V350256906L4C006R04900781188	chr1	812772	50M	206	812978	812773	812979	V350256906L4C006R04900781188_chr1_812772	41	0	ACCT	ACTC
V350256906L4C006R04900993851	chr1	373946	50M	184	374130	373947	374131	V350256906L4C006R04900993851_chr1_373946	123	41	gatt	ctca
V350256906L4C006R04901156952	chr1	1253699	50M	172	1253871	1253700	1253872	V350256906L4C006R04901156952_chr1_1253699	26	30	ggtg	taga
V350256906L4C006R05000171837	chr1	730307	50M	162	730469	730308	730470	V350256906L4C006R05000171837_chr1_730307	33	39	TCAA	ccag
V350256906L4C006R05000372471	chr1	331544	50M	151	331695	331545	331696	V350256906L4C006R05000372471_chr1_331544	0	10	CAGG	CAAA
V350256906L4C006R05000739454	chr1	1001204	50M	170	1001374	1001205	1001375	V350256906L4C006R05000739454_chr1_1001204	80	0	tctt	acgt
V350256906L4C006R05000870155	chr1	1301647	50M	195	1301842	1301648	1301843	V350256906L4C006R05000870155_chr1_1301647	0	0	aatg	ccat
V350256906L4C006R05000886993	chr1	724642	50M	239	724881	724643	724882	V350256906L4C006R05000886993_chr1_724642	74	44	gaat	ATTC
V350256906L4C006R05001271842	chr1	786474	50M	164	786638	786475	786639	V350256906L4C006R05001271842_chr1_786474	230	66	ccgc	TGAT
V350256906L4C006R05100470940	chr1	782294	50M	137	782431	782295	782432	V350256906L4C006R05100470940_chr1_782294	0	50	CCAG	tgag
V350256906L4C006R05100761475	chr1	256740	50M	175	256915	256741	256916	V350256906L4C006R05100761475_chr1_256740	229	65	ccag	ccat
V350256906L4C006R05100829234	chr1	802227	50M	190	802417	802228	802418	V350256906L4C006R05100829234_chr1_802227	207	17	CCCG	TCAG
V350256906L4C006R05101200293	chr1	318132	50M	195	318327	318133	318328	V350256906L4C006R05101200293_chr1_318132	206	11	ACCT	caaa
V350256906L4C006R05101213422	chr1	13665	50M	203	13868	13666	13869	V350256906L4C006R05101213422_chr1_13665	194	0	CCCG	AGTT
V350256906L4C006R05101358957	chr1	1034515	50M	172	1034687	1034516	1034688	V350256906L4C006R05101358957_chr1_1034515	4	0	ctat	agac
V350256906L4C006R05200012590	chr1	461360	50M	182	461542	461361	461543	V350256906L4C006R05200012590_chr1_461360	240	93	cagg	catg
V350256906L4C006R05200177001	chr1	676650	50M	157	676807	676651	676808	V350256906L4C006R05200177001_chr1_676650	12	46	tggg	cccc
V350256906L4C006R05200645251	chr1	853130	50M	152	853282	853131	853283	V350256906L4C006R05200645251_chr1_853130	36	8	GCCT	TGGG
V350256906L4C006R05200970217	chr1	1308806	50M	180	1308986	1308807	1308987	V350256906L4C006R05200970217_chr1_1308806	0	0	CCCT	GGCT
V350256906L4C006R05201199415	chr1	1204710	50M	112	1204822	1204711	1204823	V350256906L4C006R05201199415_chr1_1204710	184	72	TGAT	AGTC
V350256906L4C006R05300654778	chr1	167909	50M	178	168087	167910	168088	V350256906L4C006R05300654778_chr1_167909	37	114	CTCA	GGAA
V350256906L4C006R05300753786	chr1	1025116	50M	209	1025325	1025117	1025326	V350256906L4C006R05300753786_chr1_1025116	55	37	GCCA	GGAA
V350256906L4C006R05300811986	chr1	689587	50M	172	689759	689588	689760	V350256906L4C006R05300811986_chr1_689587	104	36	taac	cctc
V350256906L4C006R05301323531	chr1	601982	50M	174	602156	601983	602157	V350256906L4C006R05301323531_chr1_601982	45	213	agct	cccg
V350256906L4C006R05400003183	chr1	1221490	50M	181	1221671	1221491	1221672	V350256906L4C006R05400003183_chr1_1221490	27	33	AGAC	CCTG
V350256906L4C006R05400016044	chr1	533709	50M	186	533895	533710	533896	V350256906L4C006R05400016044_chr1_533709	35	221	CTCA	TCGC
V350256906L4C006R05400562593	chr1	263704	50M	172	263876	263705	263877	V350256906L4C006R05400562593_chr1_263704	57	38	gaag	CTAA
V350256906L4C006R05400584557	chr1	1013398	50M	193	1013591	1013399	1013592	V350256906L4C006R05400584557_chr1_1013398	70	94	TGCC	CAGC
V350256906L4C006R05400724565	chr1	825853	50M	178	826031	825854	826032	V350256906L4C006R05400724565_chr1_825853	136	236	TGAA	ctag
V350256906L4C006R05401171301	chr1	137651	50M	177	137828	137652	137829	V350256906L4C006R05401171301_chr1_137651	54	66	CCTG	GGCG
V350256906L4C006R05401174803	chr1	702596	50M	175	702771	702597	702772	V350256906L4C006R05401174803_chr1_702596	7	0	AAGT	CCTA
V350256906L4C006R05500294074	chr1	1087136	50M	171	1087307	1087137	1087308	V350256906L4C006R05500294074_chr1_1087136	60	54	TCCA	CTTT
V350256906L4C006R05500325152	chr1	760699	50M	181	760880	760700	760881	V350256906L4C006R05500325152_chr1_760699	0	4	CTAA	AAAG
V350256906L4C006R05500401806	chr1	729268	50M	174	729442	729269	729443	V350256906L4C006R05500401806_chr1_729268	0	9	tata	aaca
V350256906L4C006R05500473056	chr1	1378120	50M	158	1378278	1378121	1378279	V350256906L4C006R05500473056_chr1_1378120	51	65	CCAG	CTTG
V350256906L4C006R05500983503	chr1	247623	50M	185	247808	247624	247809	V350256906L4C006R05500983503_chr1_247623	28	33	ccag	ccct
V350256906L4C006R05501041049	chr1	437448	50M	172	437620	437449	437621	V350256906L4C006R05501041049_chr1_437448	0	0	CAGA	GGCC
V350256906L4C006R05501047031	chr1	625203	50M	179	625382	625204	625383	V350256906L4C006R05501047031_chr1_625203	68	14	GATT	GAAA
V350256906L4C006R05600019814	chr1	1331563	50M	183	1331746	1331564	1331747	V350256906L4C006R05600019814_chr1_1331563	29	50	cgtc	gaac
V350256906L4C006R05600074835	chr1	161398	50M	186	161584	161399	161585	V350256906L4C006R05600074835_chr1_161398	56	37	ggaa	ccag
V350256906L4C006R05600199916	chr1	830542	50M	151	830693	830543	830694	V350256906L4C006R05600199916_chr1_830542	32	24	ccac	cgtg
V350256906L4C006R05600510927	chr1	834761	50M	123	834884	834762	834885	V350256906L4C006R05600510927_chr1_834761	0	42	CCTG	CGTG
V350256906L4C006R05600620125	chr1	357508	50M	169	357677	357509	357678	V350256906L4C006R05600620125_chr1_357508	0	31	TTCC	gaga
V350256906L4C006R05600648195	chr1	242042	50M	178	242220	242043	242221	V350256906L4C006R05600648195_chr1_242042	24	97	ACCC	TGAT
V350256906L4C006R05600770083	chr1	644695	50M	165	644860	644696	644861	V350256906L4C006R05600770083_chr1_644695	59	38	gaca	tcat
V350256906L4C006R05601110973	chr1	585326	50M	162	585488	585327	585489	V350256906L4C006R05601110973_chr1_585326	51	70	cctg	ccag
V350256906L4C006R05601142395	chr1	803870	50M	165	804035	803871	804036	V350256906L4C006R05601142395_chr1_803870	0	10	TGCA	CATG
V350256906L4C006R05700104097	chr1	464300	50M	145	464445	464301	464446	V350256906L4C006R05700104097_chr1_464300	72	134	CTTG	agat
V350256906L4C006R05700152742	chr1	335458	50M	243	335701	335459	335702	V350256906L4C006R05700152742_chr1_335458	0	197	cctg	ccat
V350256906L4C006R05700322375	chr1	258773	50M	171	258944	258774	258945	V350256906L4C006R05700322375_chr1_258773	44	43	cact	AGTA
V350256906L4C006R05701289068	chr1	1145945	50M	156	1146101	1145946	1146102	V350256906L4C006R05701289068_chr1_1145945	49	68	CCCA	CGAG
V350256906L4C006R05800146398	chr1	565054	50M	155	565209	565055	565210	V350256906L4C006R05800146398_chr1_565054	108	20	CCAT	TTGC
V350256906L4C006R05800538515	chr1	990698	50M	140	990838	990699	990839	V350256906L4C006R05800538515_chr1_990698	29	64	CCCA	CACA
V350256906L4C006R05800632691	chr1	603703	50M	160	603863	603704	603864	V350256906L4C006R05800632691_chr1_603703	578	422	gaac	gatg
V350256906L4C006R05800736393	chr1	1150697	50M	267	1150964	1150698	1150965	V350256906L4C006R05800736393_chr1_1150697	97	53	TGGG	CACT
V350256906L4C006R05800742645	chr1	414473	50M	193	414666	414474	414667	V350256906L4C006R05800742645_chr1_414473	90	234	cAGC	cttc
V350256906L4C006R05800806222	chr1	42965	50M	176	43141	42966	43142	V350256906L4C006R05800806222_chr1_42965	3	0	TCAA	TATT
V350256906L4C006R05801004029	chr1	15830	50M	171	16001	15831	16002	V350256906L4C006R05801004029_chr1_15830	392	221	CTTT	CCCT
V350256906L4C006R05801303959	chr1	726825	23S22M5S	147	726972	726826	726973	V350256906L4C006R05801303959_chr1_726825	0	23	gaat	tcca
V350256906L4C006R05900030183	chr1	820989	45M5S	198	821187	820990	821188	V350256906L4C006R05900030183_chr1_820989	5	7	actg	aact
V350256906L4C006R05900138501	chr1	247213	50M	167	247380	247214	247381	V350256906L4C006R05900138501_chr1_247213	62	28	GTAC	cccg
V350256906L4C006R05900315527	chr1	735496	50M	178	735674	735497	735675	V350256906L4C006R05900315527_chr1_735496	0	0	agtc	cgcc
V350256906L4C006R05900328905	chr1	748441	50M	147	748588	748442	748589	V350256906L4C006R05900328905_chr1_748441	58	43	ATGC	ACAT
V350256906L4C006R05900670117	chr1	553960	50M	178	554138	553961	554139	V350256906L4C006R05900670117_chr1_553960	36	33	ccca	ccat
V350256906L4C006R05900957701	chr1	556904	50M	177	557081	556905	557082	V350256906L4C006R05900957701_chr1_556904	9	154	CAGG	TGTG
V350256906L4C006R05901071495	chr1	169271	50M	168	169439	169272	169440	V350256906L4C006R05901071495_chr1_169271	74	242	ggga	agtg
V350256906L4C006R05901341487	chr1	346338	50M	176	346514	346339	346515	V350256906L4C006R05901341487_chr1_346338	59	10	aaca	ttac
V350256906L4C006R06000641024	chr1	724962	20S30M	140	725102	724963	725103	V350256906L4C006R06000641024_chr1_724962	0	132	gaat	catt
V350256906L4C006R06000767602	chr1	725582	50M	237	725819	725583	725820	V350256906L4C006R06000767602_chr1_725582	66	64	gact	tcca
V350256906L4C006R06000858868	chr1	323609	50M	121	323730	323610	323731	V350256906L4C006R06000858868_chr1_323609	21	142	agtt	tcca
V350256906L4C006R06000897822	chr1	1072846	50M	165	1073011	1072847	1073012	V350256906L4C006R06000897822_chr1_1072846	41	24	CGCA	cagc
V350256906L4C006R06001063086	chr1	1117547	33M17S	208	1117755	1117548	1117756	V350256906L4C006R06001063086_chr1_1117547	0	180	GCCA	CCAT
V350256906L4C006R06001251393	chr1	1215760	50M	159	1215919	1215761	1215920	V350256906L4C006R06001251393_chr1_1215760	60	66	cgtg	cctt
V350256906L4C006R06100061790	chr1	139792	50M	168	139960	139793	139961	V350256906L4C006R06100061790_chr1_139792	58	37	taat	ctca
V350256906L4C006R06100279975	chr1	11744	50M	188	11932	11745	11933	V350256906L4C006R06100279975_chr1_11744	39	15	gatg	AGAG
V350256906L4C006R06100328474	chr1	672122	50M	186	672308	672123	672309	V350256906L4C006R06100328474_chr1_672122	99	131	cttg	tccc
V350256906L4C006R06100871985	chr1	639799	50M	203	640002	639800	640003	V350256906L4C006R06100871985_chr1_639799	0	41	ATAA	TGGT
V350256906L4C006R06100875792	chr1	254072	50M	160	254232	254073	254233	V350256906L4C006R06100875792_chr1_254072	31	0	ccta	CCTT
V350256906L4C006R06200358425	chr1	140128	50M	159	140287	140129	140288	V350256906L4C006R06200358425_chr1_140128	12	171	CTCA	GGTG
V350256906L4C006R06200795550	chr1	236705	1S45M4S	269	236974	236706	236975	V350256906L4C006R06200795550_chr1_236705	23	34	GTCC	GCAG
V350256906L4C006R06200908970	chr1	56761	50M	170	56931	56762	56932	V350256906L4C006R06200908970_chr1_56761	25	36	CCAT	AATC
V350256906L4C006R06201164410	chr1	1370215	50M	179	1370394	1370216	1370395	V350256906L4C006R06201164410_chr1_1370215	1	0	CTGT	CCAC
V350256906L4C006R06300046230	chr1	1079523	50M	157	1079680	1079524	1079681	V350256906L4C006R06300046230_chr1_1079523	13	40	CCCC	TGGG
V350256906L4C006R06300237772	chr1	240655	50M	176	240831	240656	240832	V350256906L4C006R06300237772_chr1_240655	13	26	tcac	AAAA
V350256906L4C006R06300259759	chr1	1300417	3S47M	149	1300566	1300418	1300567	V350256906L4C006R06300259759_chr1_1300417	172	321	aaaa	cccg
V350256906L4C006R06301043530	chr1	262281	50M	173	262454	262282	262455	V350256906L4C006R06301043530_chr1_262281	35	18	caac	tctg
V350256906L4C006R06301079670	chr1	423373	50M	191	423564	423374	423565	V350256906L4C006R06301079670_chr1_423373	61	75	aagg	tgat
V350256906L4C006R06301269753	chr1	1197388	50M	153	1197541	1197389	1197542	V350256906L4C006R06301269753_chr1_1197388	12	29	ctac	GGTC
V350256906L4C006R06400065717	chr1	1429677	50M	149	1429826	1429678	1429827	V350256906L4C006R06400065717_chr1_1429677	139	22	CTCT	TGAC
V350256906L4C006R06400808689	chr1	950274	50M	165	950439	950275	950440	V350256906L4C006R06400808689_chr1_950274	62	65	CCCT	TCAG
V350256906L4C006R06500499616	chr1	1259521	19S25M6S	160	1259681	1259522	1259682	V350256906L4C006R06500499616_chr1_1259521	320	219	gggc	CGTC
V350256906L4C006R06500744759	chr1	1305532	50M	166	1305698	1305533	1305699	V350256906L4C006R06500744759_chr1_1305532	13	3	CACA	ccca
V350256906L4C006R06500768492	chr1	1043065	50M	131	1043196	1043066	1043197	V350256906L4C006R06500768492_chr1_1043065	0	0	tggg	ccaa
V350256906L4C006R06500986641	chr1	787732	50M	177	787909	787733	787910	V350256906L4C006R06500986641_chr1_787732	29	20	GGCT	CTAA
V350256906L4C006R06501048445	chr1	162794	50M	179	162973	162795	162974	V350256906L4C006R06501048445_chr1_162794	35	111	CATA	TCCC
V350256906L4C006R06501294476	chr1	454755	50M	160	454915	454756	454916	V350256906L4C006R06501294476_chr1_454755	163	3	TAGG	acaA
V350256906L4C006R06501342303	chr1	533177	50M	192	533369	533178	533370	V350256906L4C006R06501342303_chr1_533177	0	0	gtag	CCAC
V350256906L4C006R06600023417	chr1	334129	50M	190	334319	334130	334320	V350256906L4C006R06600023417_chr1_334129	52	39	CTGC	AGAG
V350256906L4C006R06600390328	chr1	258491	50M	173	258664	258492	258665	V350256906L4C006R06600390328_chr1_258491	0	47	cttt	cttc
V350256906L4C006R06600892489	chr1	132925	50M	192	133117	132926	133118	V350256906L4C006R06600892489_chr1_132925	24	11	GGGC	AGCT
V350256906L4C006R06600959657	chr1	928984	50M	176	929160	928985	929161	V350256906L4C006R06600959657_chr1_928984	43	52	CAAG	taca
V350256906L4C006R06601194356	chr1	1210257	50M	122	1210379	1210258	1210380	V350256906L4C006R06601194356_chr1_1210257	58	24	CGTC	CATA
V350256906L4C006R06700329524	chr1	559648	50M	153	559801	559649	559802	V350256906L4C006R06700329524_chr1_559648	132	0	AAGC	attg
V350256906L4C006R06700342198	chr1	416205	50M	215	416420	416206	416421	V350256906L4C006R06700342198_chr1_416205	0	17	tttt	tacc
V350256906L4C006R06700397799	chr1	1305708	50M	162	1305870	1305709	1305871	V350256906L4C006R06700397799_chr1_1305708	0	13	gggc	tcca
V350256906L4C006R06700406141	chr1	1248089	50M	210	1248299	1248090	1248300	V350256906L4C006R06700406141_chr1_1248089	43	77	CGGG	CATT
V350256906L4C006R06700469882	chr1	1251393	50M	189	1251582	1251394	1251583	V350256906L4C006R06700469882_chr1_1251393	110	299	AGAG	caag
V350256906L4C006R06700632155	chr1	1046391	50M	173	1046564	1046392	1046565	V350256906L4C006R06700632155_chr1_1046391	49	95	gtga	CTCA
V350256906L4C006R06700847982	chr1	1325903	50M	209	1326112	1325904	1326113	V350256906L4C006R06700847982_chr1_1325903	0	32	CCAA	TGAT
V350256906L4C006R06701037863	chr1	857757	50M	169	857926	857758	857927	V350256906L4C006R06701037863_chr1_857757	4	0	ACAT	GGCC
V350256906L4C006R06701075200	chr1	33231	50M	157	33388	33232	33389	V350256906L4C006R06701075200_chr1_33231	31	27	agaa	catt
V350256906L4C006R06800121241	chr1	1365827	50M	159	1365986	1365828	1365987	V350256906L4C006R06800121241_chr1_1365827	56	72	CCAT	CAGG
V350256906L4C006R06800160842	chr1	337338	50M	145	337483	337339	337484	V350256906L4C006R06800160842_chr1_337338	0	9	GAAA	AGGG
V350256906L4C006R06800314400	chr1	850968	50M	168	851136	850969	851137	V350256906L4C006R06800314400_chr1_850968	50	62	TGGG	ctca
V350256906L4C006R06800408143	chr1	579454	50M	142	579596	579455	579597	V350256906L4C006R06800408143_chr1_579454	116	0	atga	ctca
V350256906L4C006R06800535362	chr1	757235	50M	164	757399	757236	757400	V350256906L4C006R06800535362_chr1_757235	13	177	GTCT	GCTC
V350256906L4C006R06800660911	chr1	883047	50M	162	883209	883048	883210	V350256906L4C006R06800660911_chr1_883047	52	65	TGGG	CCTG
V350256906L4C006R06800663291	chr1	1303245	50M	171	1303416	1303246	1303417	V350256906L4C006R06800663291_chr1_1303245	91	17	cctg	aaaa
V350256906L4C006R06800845782	chr1	67022	50M	156	67178	67023	67179	V350256906L4C006R06800845782_chr1_67022	120	0	TGTG	ATTT
V350256906L4C006R06801012859	chr1	61264	50M	177	61441	61265	61442	V350256906L4C006R06801012859_chr1_61264	53	0	GTTT	TTTG
V350256906L4C006R06801184666	chr1	707270	50M	183	707453	707271	707454	V350256906L4C006R06801184666_chr1_707270	6	9	GGGC	GTCT
V350256906L4C006R06900382257	chr1	972942	50M	158	973100	972943	973101	V350256906L4C006R06900382257_chr1_972942	49	78	CCCG	CCTC
V350256906L4C006R06900444659	chr1	814271	50M	167	814438	814272	814439	V350256906L4C006R06900444659_chr1_814271	2	0	CAAG	TATG
V350256906L4C006R06900829343	chr1	386515	50M	146	386661	386516	386662	V350256906L4C006R06900829343_chr1_386515	287	141	cacg	gagg
V350256906L4C006R06900941982	chr1	241682	50M	140	241822	241683	241823	V350256906L4C006R06900941982_chr1_241682	30	79	TGCT	ACCT
V350256906L4C006R06901004651	chr1	1035733	50M	167	1035900	1035734	1035901	V350256906L4C006R06901004651_chr1_1035733	44	73	GCCc	ccat
V350256906L4C006R06901274834	chr1	662781	50M	148	662929	662782	662930	V350256906L4C006R06901274834_chr1_662781	35	61	GGGC	CCCA
V350256906L4C006R06901287440	chr1	176818	50M	191	177009	176819	177010	V350256906L4C006R06901287440_chr1_176818	58	66	AGAC	CAGC
V350256906L4C006R07000189061	chr1	109080	50M	195	109275	109081	109276	V350256906L4C006R07000189061_chr1_109080	67	89	GAAG	TTCT
V350256906L4C006R07000400219	chr1	360102	50M	192	360294	360103	360295	V350256906L4C006R07000400219_chr1_360102	45	47	GCAG	CAGA
V350256906L4C006R07000434523	chr1	827544	50M	151	827695	827545	827696	V350256906L4C006R07000434523_chr1_827544	34	0	taac	ccat
V350256906L4C006R07000495051	chr1	123725	50M	170	123895	123726	123896	V350256906L4C006R07000495051_chr1_123725	22	134	acag	tctt
V350256906L4C006R07000582030	chr1	27646	50M	169	27815	27647	27816	V350256906L4C006R07000582030_chr1_27646	90	84	AAGC	GTTC
V350256906L4C006R07000588699	chr1	1299240	50M	171	1299411	1299241	1299412	V350256906L4C006R07000588699_chr1_1299240	50	63	ccca	tact
V350256906L4C006R07000621414	chr1	62577	50M	145	62722	62578	62723	V350256906L4C006R07000621414_chr1_62577	0	135	TGTT	CAAT
V350256906L4C006R07000662439	chr1	161163	50M	184	161347	161164	161348	V350256906L4C006R07000662439_chr1_161163	35	107	GGCA	ggag
V350256906L4C006R07000888695	chr1	232512	50M	161	232673	232513	232674	V350256906L4C006R07000888695_chr1_232512	40	61	CACT	TACT
V350256906L4C006R07001042974	chr1	1326162	50M	177	1326339	1326163	1326340	V350256906L4C006R07001042974_chr1_1326162	65	57	GCAA	AGTA
V350256906L4C006R07001108934	chr1	454612	50M	153	454765	454613	454766	V350256906L4C006R07001108934_chr1_454612	306	153	CCCA	GGGT
V350256906L4C006R07100060248	chr1	827405	50M	143	827548	827406	827549	V350256906L4C006R07100060248_chr1_827405	70	38	gacc	gtta
V350256906L4C006R07100683639	chr1	31642	50M	161	31803	31643	31804	V350256906L4C006R07100683639_chr1_31642	92	205	tggg	CACA
V350256906L4C006R07100998962	chr1	726769	50M	164	726933	726770	726934	V350256906L4C006R07100998962_chr1_726769	44	62	cgaa	ttcc
V350256906L4C006R07101109913	chr1	1097822	50M	181	1098003	1097823	1098004	V350256906L4C006R07101109913_chr1_1097822	28	32	ACCA	CGTG
V350256906L4C006R07200090931	chr1	995614	50M	173	995787	995615	995788	V350256906L4C006R07200090931_chr1_995614	68	49	acag	cctc
V350256906L4C006R07200435350	chr1	158413	50M	163	158576	158414	158577	V350256906L4C006R07200435350_chr1_158413	140	215	ATAT	CCCA
V350256906L4C006R07200639266	chr1	1214247	50M	162	1214409	1214248	1214410	V350256906L4C006R07200639266_chr1_1214247	28	4	gttt	cctc
V350256906L4C006R07200844932	chr1	634211	50M	165	634376	634212	634377	V350256906L4C006R07200844932_chr1_634211	93	3	cctc	atct
V350256906L4C006R07201019046	chr1	110464	50M	187	110651	110465	110652	V350256906L4C006R07201019046_chr1_110464	20	9	aaac	ccat
V350256906L4C006R07201038451	chr1	706326	50M	183	706509	706327	706510	V350256906L4C006R07201038451_chr1_706326	65	213	CCTG	CCCC
V350256906L4C006R07201170757	chr1	115687	50M	174	115861	115688	115862	V350256906L4C006R07201170757_chr1_115687	59	42	caag	ggca
